district,neighborhood,registered,voted,valid,yes,no
ATASEHIR,FERHATPASA MAH.,415,339,332,228,104
ATASEHIR,FERHATPASA MAH.,414,332,329,219,110
ATASEHIR,FERHATPASA MAH.,414,323,308,206,102
ATASEHIR,FERHATPASA MAH.,415,374,369,268,101
ATASEHIR,FERHATPASA MAH.,415,362,350,256,94
ATASEHIR,FERHATPASA MAH.,414,375,371,261,110
ATASEHIR,FERHATPASA MAH.,414,366,356,249,107
ATASEHIR,FERHATPASA MAH.,414,357,347,219,128
ATASEHIR,FERHATPASA MAH.,414,360,355,243,112
ATASEHIR,FERHATPASA MAH.,415,341,335,236,99
ATASEHIR,FERHATPASA MAH.,414,386,383,270,113
ATASEHIR,FERHATPASA MAH.,415,369,366,264,102
ATASEHIR,FERHATPASA MAH.,415,367,361,276,85
ATASEHIR,FERHATPASA MAH.,413,354,349,256,93
ATASEHIR,FERHATPASA MAH.,409,385,384,282,102
ATASEHIR,FERHATPASA MAH.,415,359,352,260,92
ATASEHIR,FERHATPASA MAH.,414,365,362,268,94
ATASEHIR,FERHATPASA MAH.,415,366,360,261,99
ATASEHIR,FERHATPASA MAH.,415,355,349,269,80
ATASEHIR,FERHATPASA MAH.,414,366,365,251,114
ATASEHIR,FERHATPASA MAH.,415,364,356,271,85
ATASEHIR,FERHATPASA MAH.,415,359,357,263,94
ATASEHIR,FERHATPASA MAH.,415,364,361,247,114
ATASEHIR,FERHATPASA MAH.,414,372,360,250,110
ATASEHIR,FERHATPASA MAH.,415,362,355,261,94
ATASEHIR,FERHATPASA MAH.,414,374,365,270,95
ATASEHIR,FERHATPASA MAH.,414,373,372,278,94
ATASEHIR,FERHATPASA MAH.,414,374,366,256,110
ATASEHIR,FERHATPASA MAH.,415,372,365,254,111
ATASEHIR,FERHATPASA MAH.,413,367,364,244,120
ATASEHIR,FERHATPASA MAH.,414,367,365,249,116
ATASEHIR,FERHATPASA MAH.,415,366,365,276,89
ATASEHIR,FERHATPASA MAH.,414,376,373,275,98
ATASEHIR,FERHATPASA MAH.,414,377,368,268,100
ATASEHIR,FERHATPASA MAH.,413,378,374,283,91
ATASEHIR,FERHATPASA MAH.,414,383,379,260,119
ATASEHIR,ICERENKOY MAH.,404,340,332,141,191
ATASEHIR,ICERENKOY MAH.,403,335,330,99,231
ATASEHIR,ICERENKOY MAH.,403,340,333,123,210
ATASEHIR,ICERENKOY MAH.,404,354,352,145,207
ATASEHIR,ICERENKOY MAH.,404,352,348,141,207
ATASEHIR,ICERENKOY MAH.,404,375,369,142,227
ATASEHIR,ICERENKOY MAH.,404,367,363,141,222
ATASEHIR,ICERENKOY MAH.,405,359,356,117,239
ATASEHIR,ICERENKOY MAH.,405,380,376,135,241
ATASEHIR,ICERENKOY MAH.,404,366,363,149,214
ATASEHIR,ICERENKOY MAH.,404,367,365,121,244
ATASEHIR,ICERENKOY MAH.,405,378,369,137,232
ATASEHIR,ICERENKOY MAH.,404,363,358,152,206
ATASEHIR,ICERENKOY MAH.,405,376,371,141,230
ATASEHIR,ICERENKOY MAH.,403,360,357,160,197
ATASEHIR,ICERENKOY MAH.,405,371,370,172,198
ATASEHIR,ICERENKOY MAH.,404,369,365,153,212
ATASEHIR,ICERENKOY MAH.,405,365,362,160,202
ATASEHIR,ICERENKOY MAH.,404,364,361,142,219
ATASEHIR,ICERENKOY MAH.,405,367,361,145,216
ATASEHIR,ICERENKOY MAH.,404,356,353,142,211
ATASEHIR,ICERENKOY MAH.,404,379,373,160,213
ATASEHIR,ICERENKOY MAH.,403,373,369,151,218
ATASEHIR,ICERENKOY MAH.,404,364,359,128,231
ATASEHIR,ICERENKOY MAH.,404,367,365,150,215
ATASEHIR,ICERENKOY MAH.,403,369,364,157,207
ATASEHIR,ICERENKOY MAH.,405,358,352,125,227
ATASEHIR,ICERENKOY MAH.,404,375,368,142,226
ATASEHIR,ICERENKOY MAH.,415,351,345,126,219
ATASEHIR,ICERENKOY MAH.,409,349,342,127,215
ATASEHIR,ICERENKOY MAH.,411,367,358,136,222
ATASEHIR,ICERENKOY MAH.,410,376,375,147,228
ATASEHIR,ICERENKOY MAH.,410,389,387,155,232
ATASEHIR,ICERENKOY MAH.,411,369,364,136,228
ATASEHIR,ICERENKOY MAH.,411,371,366,143,223
ATASEHIR,ICERENKOY MAH.,411,372,365,155,210
ATASEHIR,ICERENKOY MAH.,411,380,377,152,225
ATASEHIR,ICERENKOY MAH.,411,378,374,129,245
ATASEHIR,ICERENKOY MAH.,410,383,380,144,236
ATASEHIR,ICERENKOY MAH.,410,378,374,179,195
ATASEHIR,ICERENKOY MAH.,409,361,357,174,183
ATASEHIR,ICERENKOY MAH.,409,374,370,149,221
ATASEHIR,ICERENKOY MAH.,410,373,368,162,206
ATASEHIR,ICERENKOY MAH.,409,376,372,145,227
ATASEHIR,ICERENKOY MAH.,410,368,366,132,234
ATASEHIR,ICERENKOY MAH.,410,381,380,131,249
ATASEHIR,ICERENKOY MAH.,412,326,321,134,187
ATASEHIR,ICERENKOY MAH.,412,360,352,142,210
ATASEHIR,ICERENKOY MAH.,411,376,375,191,184
ATASEHIR,ICERENKOY MAH.,411,370,365,155,210
ATASEHIR,ICERENKOY MAH.,410,393,388,170,218
ATASEHIR,ICERENKOY MAH.,412,380,375,171,204
ATASEHIR,ICERENKOY MAH.,412,360,356,172,184
ATASEHIR,ICERENKOY MAH.,411,362,357,166,191
ATASEHIR,ICERENKOY MAH.,410,378,376,155,221
ATASEHIR,ICERENKOY MAH.,412,368,365,171,194
ATASEHIR,ICERENKOY MAH.,410,375,374,163,211
ATASEHIR,ICERENKOY MAH.,412,375,371,177,194
ATASEHIR,ICERENKOY MAH.,410,380,374,175,199
ATASEHIR,ICERENKOY MAH.,415,366,362,157,205
ATASEHIR,ICERENKOY MAH.,412,365,359,151,208
ATASEHIR,ICERENKOY MAH.,412,378,376,183,193
ATASEHIR,ICERENKOY MAH.,411,350,347,116,231
ATASEHIR,ICERENKOY MAH.,415,340,336,122,214
ATASEHIR,ICERENKOY MAH.,415,369,364,132,232
ATASEHIR,ICERENKOY MAH.,415,388,383,145,238
ATASEHIR,ICERENKOY MAH.,415,389,387,133,254
ATASEHIR,ICERENKOY MAH.,415,390,388,139,249
ATASEHIR,ICERENKOY MAH.,415,381,380,136,244
ATASEHIR,ICERENKOY MAH.,415,393,390,128,262
ATASEHIR,ICERENKOY MAH.,415,392,386,141,245
ATASEHIR,ICERENKOY MAH.,413,374,368,114,254
ATASEHIR,ICERENKOY MAH.,411,371,366,126,240
ATASEHIR,ICERENKOY MAH.,412,388,388,118,270
ATASEHIR,ICERENKOY MAH.,412,385,381,111,270
ATASEHIR,ICERENKOY MAH.,415,384,382,131,251
ATASEHIR,ICERENKOY MAH.,412,379,374,144,230
ATASEHIR,ICERENKOY MAH.,415,377,374,126,248
ATASEHIR,ICERENKOY MAH.,412,387,380,133,247
ATASEHIR,ICERENKOY MAH.,415,380,377,128,249
ATASEHIR,ICERENKOY MAH.,412,372,370,112,258
ATASEHIR,ICERENKOY MAH.,415,378,374,123,251
ATASEHIR,ICERENKOY MAH.,412,373,371,104,267
ATASEHIR,ICERENKOY MAH.,411,382,374,126,248
ATASEHIR,ICERENKOY MAH.,412,370,362,141,221
ATASEHIR,ICERENKOY MAH.,411,391,385,162,223
ATASEHIR,ICERENKOY MAH.,415,375,373,129,244
ATASEHIR,ICERENKOY MAH.,415,355,352,105,247
ATASEHIR,ICERENKOY MAH.,415,351,342,136,206
ATASEHIR,ICERENKOY MAH.,415,356,346,158,188
ATASEHIR,ICERENKOY MAH.,415,352,347,137,210
ATASEHIR,ICERENKOY MAH.,415,368,365,120,245
ATASEHIR,ICERENKOY MAH.,415,384,380,148,232
ATASEHIR,ICERENKOY MAH.,415,388,378,160,218
ATASEHIR,ICERENKOY MAH.,415,386,380,156,224
ATASEHIR,ICERENKOY MAH.,415,378,369,124,245
ATASEHIR,ICERENKOY MAH.,412,387,385,155,230
ATASEHIR,ICERENKOY MAH.,415,370,367,116,251
ATASEHIR,ICERENKOY MAH.,415,380,376,154,222
ATASEHIR,ICERENKOY MAH.,416,392,389,169,220
ATASEHIR,ICERENKOY MAH.,416,383,380,148,232
ATASEHIR,ICERENKOY MAH.,415,383,380,134,246
ATASEHIR,ICERENKOY MAH.,415,371,369,139,230
ATASEHIR,ICERENKOY MAH.,415,368,365,145,220
ATASEHIR,ICERENKOY MAH.,415,368,360,150,210
ATASEHIR,ICERENKOY MAH.,415,378,374,143,231
ATASEHIR,ICERENKOY MAH.,415,374,368,140,228
ATASEHIR,ICERENKOY MAH.,416,373,369,142,227
ATASEHIR,ICERENKOY MAH.,415,385,380,142,238
ATASEHIR,ICERENKOY MAH.,415,386,380,161,219
ATASEHIR,ICERENKOY MAH.,416,372,365,146,219
ATASEHIR,ICERENKOY MAH.,415,373,371,149,222
ATASEHIR,ICERENKOY MAH.,413,375,372,178,194
ATASEHIR,ICERENKOY MAH.,415,378,375,143,232
ATASEHIR,ICERENKOY MAH.,415,386,381,163,218
ATASEHIR,ICERENKOY MAH.,415,386,381,150,231
ATASEHIR,ICERENKOY MAH.,408,330,322,124,198
ATASEHIR,ICERENKOY MAH.,408,352,341,134,207
ATASEHIR,ICERENKOY MAH.,409,356,348,137,211
ATASEHIR,ICERENKOY MAH.,409,373,370,151,219
ATASEHIR,ICERENKOY MAH.,409,362,360,155,205
ATASEHIR,ICERENKOY MAH.,409,373,370,144,226
ATASEHIR,ICERENKOY MAH.,409,368,365,133,232
ATASEHIR,ICERENKOY MAH.,408,381,379,144,235
ATASEHIR,ICERENKOY MAH.,409,383,377,173,204
ATASEHIR,ICERENKOY MAH.,415,380,371,134,237
ATASEHIR,ICERENKOY MAH.,409,371,365,143,222
ATASEHIR,ICERENKOY MAH.,408,359,352,142,210
ATASEHIR,ICERENKOY MAH.,408,368,363,151,212
ATASEHIR,ICERENKOY MAH.,409,371,367,133,234
ATASEHIR,ICERENKOY MAH.,409,365,362,143,219
ATASEHIR,ICERENKOY MAH.,407,369,366,122,244
ATASEHIR,ICERENKOY MAH.,408,387,385,148,237
ATASEHIR,ICERENKOY MAH.,408,374,371,160,211
ATASEHIR,ICERENKOY MAH.,407,378,371,131,240
ATASEHIR,ICERENKOY MAH.,408,382,379,157,222
ATASEHIR,ICERENKOY MAH.,409,373,369,157,212
ATASEHIR,ICERENKOY MAH.,407,374,372,153,219
ATASEHIR,ICERENKOY MAH.,409,376,375,155,220
ATASEHIR,ICERENKOY MAH.,408,377,375,165,210
ATASEHIR,ICERENKOY MAH.,407,388,385,134,251
ATASEHIR,ICERENKOY MAH.,408,385,377,151,226
ATASEHIR,ICERENKOY MAH.,408,367,366,153,213
ATASEHIR,INONU MAH.,415,347,340,173,167
ATASEHIR,INONU MAH.,415,344,329,174,155
ATASEHIR,INONU MAH.,415,378,372,171,201
ATASEHIR,INONU MAH.,415,366,360,182,178
ATASEHIR,INONU MAH.,414,373,368,181,187
ATASEHIR,INONU MAH.,414,386,383,205,178
ATASEHIR,INONU MAH.,414,360,356,174,182
ATASEHIR,INONU MAH.,413,365,359,189,170
ATASEHIR,INONU MAH.,411,360,355,202,153
ATASEHIR,INONU MAH.,415,369,367,170,197
ATASEHIR,INONU MAH.,415,381,373,185,188
ATASEHIR,INONU MAH.,414,373,369,188,181
ATASEHIR,INONU MAH.,414,369,363,187,176
ATASEHIR,INONU MAH.,415,360,355,152,203
ATASEHIR,INONU MAH.,414,378,372,190,182
ATASEHIR,INONU MAH.,414,378,377,220,157
ATASEHIR,INONU MAH.,415,391,389,230,159
ATASEHIR,INONU MAH.,414,371,367,192,175
ATASEHIR,INONU MAH.,414,374,369,185,184
ATASEHIR,INONU MAH.,414,379,373,183,190
ATASEHIR,INONU MAH.,414,361,352,156,196
ATASEHIR,INONU MAH.,415,373,371,193,178
ATASEHIR,INONU MAH.,414,372,369,169,200
ATASEHIR,INONU MAH.,412,365,356,185,171
ATASEHIR,INONU MAH.,414,370,362,177,185
ATASEHIR,INONU MAH.,415,383,380,185,195
ATASEHIR,INONU MAH.,397,314,305,156,149
ATASEHIR,INONU MAH.,397,346,344,194,150
ATASEHIR,INONU MAH.,398,367,360,190,170
ATASEHIR,INONU MAH.,397,367,363,187,176
ATASEHIR,INONU MAH.,396,351,347,172,175
ATASEHIR,INONU MAH.,398,353,346,159,187
ATASEHIR,INONU MAH.,396,363,358,180,178
ATASEHIR,INONU MAH.,397,351,344,180,164
ATASEHIR,INONU MAH.,396,358,356,197,159
ATASEHIR,INONU MAH.,397,365,359,148,211
ATASEHIR,INONU MAH.,397,355,354,162,192
ATASEHIR,INONU MAH.,397,359,356,156,200
ATASEHIR,INONU MAH.,396,348,344,166,178
ATASEHIR,INONU MAH.,397,368,366,195,171
ATASEHIR,INONU MAH.,396,349,344,177,167
ATASEHIR,INONU MAH.,397,352,348,168,180
ATASEHIR,INONU MAH.,397,359,353,167,186
ATASEHIR,INONU MAH.,397,352,349,187,162
ATASEHIR,INONU MAH.,397,375,372,194,178
ATASEHIR,INONU MAH.,395,343,337,187,150
ATASEHIR,INONU MAH.,397,370,360,157,203
ATASEHIR,KAYISDAGI MAH.,415,360,353,163,190
ATASEHIR,KAYISDAGI MAH.,415,349,338,180,158
ATASEHIR,KAYISDAGI MAH.,415,380,373,215,158
ATASEHIR,KAYISDAGI MAH.,415,374,368,187,181
ATASEHIR,KAYISDAGI MAH.,415,374,365,212,153
ATASEHIR,KAYISDAGI MAH.,411,366,363,203,160
ATASEHIR,KAYISDAGI MAH.,415,375,365,187,178
ATASEHIR,KAYISDAGI MAH.,412,374,370,198,172
ATASEHIR,KAYISDAGI MAH.,412,373,364,185,179
ATASEHIR,KAYISDAGI MAH.,412,370,363,196,167
ATASEHIR,KAYISDAGI MAH.,415,374,369,190,179
ATASEHIR,KAYISDAGI MAH.,412,364,361,208,153
ATASEHIR,KAYISDAGI MAH.,412,362,359,145,214
ATASEHIR,KAYISDAGI MAH.,413,349,349,169,180
ATASEHIR,KAYISDAGI MAH.,413,362,358,216,142
ATASEHIR,KAYISDAGI MAH.,411,389,380,198,182
ATASEHIR,KAYISDAGI MAH.,412,375,371,184,187
ATASEHIR,KAYISDAGI MAH.,412,364,360,205,155
ATASEHIR,KAYISDAGI MAH.,412,364,360,196,164
ATASEHIR,KAYISDAGI MAH.,413,365,362,167,195
ATASEHIR,KAYISDAGI MAH.,415,376,371,206,165
ATASEHIR,KAYISDAGI MAH.,395,337,326,208,118
ATASEHIR,KAYISDAGI MAH.,397,352,347,216,131
ATASEHIR,KAYISDAGI MAH.,394,360,357,234,123
ATASEHIR,KAYISDAGI MAH.,398,371,368,233,135
ATASEHIR,KAYISDAGI MAH.,398,361,358,219,139
ATASEHIR,KAYISDAGI MAH.,395,349,345,200,145
ATASEHIR,KAYISDAGI MAH.,394,361,359,201,158
ATASEHIR,KAYISDAGI MAH.,394,358,352,228,124
ATASEHIR,KAYISDAGI MAH.,394,349,347,204,143
ATASEHIR,KAYISDAGI MAH.,394,358,355,235,120
ATASEHIR,KAYISDAGI MAH.,395,342,339,215,124
ATASEHIR,KAYISDAGI MAH.,395,340,335,208,127
ATASEHIR,KAYISDAGI MAH.,394,342,333,217,116
ATASEHIR,KAYISDAGI MAH.,412,330,318,161,157
ATASEHIR,KAYISDAGI MAH.,415,370,367,203,164
ATASEHIR,KAYISDAGI MAH.,411,357,355,206,149
ATASEHIR,KAYISDAGI MAH.,415,367,360,205,155
ATASEHIR,KAYISDAGI MAH.,411,359,353,191,162
ATASEHIR,KAYISDAGI MAH.,411,371,364,218,146
ATASEHIR,KAYISDAGI MAH.,412,369,366,219,147
ATASEHIR,KAYISDAGI MAH.,412,370,367,226,141
ATASEHIR,KAYISDAGI MAH.,412,366,357,206,151
ATASEHIR,KAYISDAGI MAH.,415,374,369,209,160
ATASEHIR,KAYISDAGI MAH.,415,357,355,198,157
ATASEHIR,KAYISDAGI MAH.,414,377,372,196,176
ATASEHIR,KAYISDAGI MAH.,412,367,364,192,172
ATASEHIR,KAYISDAGI MAH.,403,355,345,188,157
ATASEHIR,KAYISDAGI MAH.,402,321,313,176,137
ATASEHIR,KAYISDAGI MAH.,402,359,354,195,159
ATASEHIR,KAYISDAGI MAH.,404,362,360,226,134
ATASEHIR,KAYISDAGI MAH.,402,357,351,211,140
ATASEHIR,KAYISDAGI MAH.,402,355,351,209,142
ATASEHIR,KAYISDAGI MAH.,402,361,356,206,150
ATASEHIR,KAYISDAGI MAH.,402,361,360,230,130
ATASEHIR,KAYISDAGI MAH.,402,356,353,200,153
ATASEHIR,KAYISDAGI MAH.,403,362,357,213,144
ATASEHIR,KAYISDAGI MAH.,401,359,353,193,160
ATASEHIR,KAYISDAGI MAH.,401,349,342,173,169
ATASEHIR,KAYISDAGI MAH.,401,362,360,220,140
ATASEHIR,KAYISDAGI MAH.,401,355,349,202,147
ATASEHIR,KAYISDAGI MAH.,402,363,359,208,151
ATASEHIR,KAYISDAGI MAH.,402,357,352,204,148
ATASEHIR,KAYISDAGI MAH.,401,361,359,212,147
ATASEHIR,KAYISDAGI MAH.,401,367,362,192,170
ATASEHIR,KAYISDAGI MAH.,402,368,362,215,147
ATASEHIR,KAYISDAGI MAH.,401,355,349,219,130
ATASEHIR,KAYISDAGI MAH.,401,343,338,221,117
ATASEHIR,KAYISDAGI MAH.,400,369,367,215,152
ATASEHIR,KAYISDAGI MAH.,400,353,348,191,157
ATASEHIR,KAYISDAGI MAH.,400,365,358,230,128
ATASEHIR,KAYISDAGI MAH.,374,299,287,175,112
ATASEHIR,KAYISDAGI MAH.,372,329,327,194,133
ATASEHIR,KAYISDAGI MAH.,373,335,330,188,142
ATASEHIR,KAYISDAGI MAH.,373,333,331,183,148
ATASEHIR,MEVLANA MAH.,405,335,327,218,109
ATASEHIR,MEVLANA MAH.,405,345,342,215,127
ATASEHIR,MEVLANA MAH.,405,365,362,271,91
ATASEHIR,MEVLANA MAH.,406,361,354,221,133
ATASEHIR,MEVLANA MAH.,408,357,349,228,121
ATASEHIR,MEVLANA MAH.,404,365,360,234,126
ATASEHIR,MEVLANA MAH.,404,362,357,241,116
ATASEHIR,MEVLANA MAH.,405,359,355,259,96
ATASEHIR,MEVLANA MAH.,405,349,346,243,103
ATASEHIR,MEVLANA MAH.,404,352,344,240,104
ATASEHIR,MEVLANA MAH.,405,359,355,226,129
ATASEHIR,MEVLANA MAH.,405,369,365,266,99
ATASEHIR,MEVLANA MAH.,404,351,347,222,125
ATASEHIR,MEVLANA MAH.,404,358,355,256,99
ATASEHIR,MEVLANA MAH.,405,367,363,254,109
ATASEHIR,MEVLANA MAH.,404,362,357,223,134
ATASEHIR,MEVLANA MAH.,404,378,375,238,137
ATASEHIR,MEVLANA MAH.,404,357,350,203,147
ATASEHIR,MEVLANA MAH.,405,366,359,229,130
ATASEHIR,MEVLANA MAH.,408,346,342,125,217
ATASEHIR,MEVLANA MAH.,408,350,343,127,216
ATASEHIR,MEVLANA MAH.,408,373,360,135,225
ATASEHIR,MEVLANA MAH.,408,375,372,140,232
ATASEHIR,MEVLANA MAH.,409,376,373,120,253
ATASEHIR,MEVLANA MAH.,408,381,377,144,233
ATASEHIR,MEVLANA MAH.,408,367,361,119,242
ATASEHIR,MEVLANA MAH.,409,378,374,139,235
ATASEHIR,MEVLANA MAH.,408,374,369,112,257
ATASEHIR,MEVLANA MAH.,408,366,362,157,205
ATASEHIR,MEVLANA MAH.,410,377,373,112,261
ATASEHIR,MEVLANA MAH.,408,382,379,141,238
ATASEHIR,MEVLANA MAH.,408,385,382,140,242
ATASEHIR,MEVLANA MAH.,409,373,367,119,248
ATASEHIR,MEVLANA MAH.,408,387,378,175,203
ATASEHIR,MEVLANA MAH.,408,380,371,120,251
ATASEHIR,MIMAR SINAN MAH.,404,351,344,247,97
ATASEHIR,MIMAR SINAN MAH.,403,356,352,220,132
ATASEHIR,MIMAR SINAN MAH.,404,347,341,229,112
ATASEHIR,MIMAR SINAN MAH.,403,365,361,265,96
ATASEHIR,MIMAR SINAN MAH.,403,353,345,251,94
ATASEHIR,MIMAR SINAN MAH.,403,374,372,291,81
ATASEHIR,MIMAR SINAN MAH.,405,354,349,273,76
ATASEHIR,MIMAR SINAN MAH.,404,362,358,241,117
ATASEHIR,MIMAR SINAN MAH.,407,370,366,260,106
ATASEHIR,MIMAR SINAN MAH.,403,340,331,215,116
ATASEHIR,MIMAR SINAN MAH.,404,353,346,249,97
ATASEHIR,MIMAR SINAN MAH.,404,369,366,272,94
ATASEHIR,MIMAR SINAN MAH.,403,373,368,252,116
ATASEHIR,MIMAR SINAN MAH.,404,356,351,254,97
ATASEHIR,MIMAR SINAN MAH.,404,359,355,232,123
ATASEHIR,MIMAR SINAN MAH.,404,364,359,257,102
ATASEHIR,MIMAR SINAN MAH.,404,372,365,261,104
ATASEHIR,MIMAR SINAN MAH.,403,373,365,254,111
ATASEHIR,YENI CAMLICA MAH.,399,336,326,168,158
ATASEHIR,YENI CAMLICA MAH.,399,360,349,198,151
ATASEHIR,YENI CAMLICA MAH.,400,361,355,227,128
ATASEHIR,YENI CAMLICA MAH.,400,367,364,219,145
ATASEHIR,YENI CAMLICA MAH.,399,356,349,216,133
ATASEHIR,YENI CAMLICA MAH.,402,362,359,222,137
ATASEHIR,YENI CAMLICA MAH.,399,379,376,245,131
ATASEHIR,YENI CAMLICA MAH.,400,359,354,221,133
ATASEHIR,YENI CAMLICA MAH.,399,363,358,211,147
ATASEHIR,YENI CAMLICA MAH.,400,356,350,231,119
ATASEHIR,YENI CAMLICA MAH.,400,361,357,238,119
ATASEHIR,YENI CAMLICA MAH.,399,363,353,215,138
ATASEHIR,YENI CAMLICA MAH.,400,362,358,204,154
ATASEHIR,YENI CAMLICA MAH.,399,366,363,227,136
ATASEHIR,YENI CAMLICA MAH.,400,366,359,209,150
ATASEHIR,YENI CAMLICA MAH.,401,360,358,225,133
ATASEHIR,YENI CAMLICA MAH.,399,350,347,238,109
ATASEHIR,YENI CAMLICA MAH.,398,363,361,215,146
ATASEHIR,YENI CAMLICA MAH.,400,358,354,211,143
ATASEHIR,YENI CAMLICA MAH.,399,356,348,230,118
ATASEHIR,YENI CAMLICA MAH.,400,354,348,219,129
ATASEHIR,YENI CAMLICA MAH.,400,343,332,188,144
ATASEHIR,YENI CAMLICA MAH.,356,331,325,136,189
ATASEHIR,YENI CAMLICA MAH.,356,334,330,125,205
ATASEHIR,YENI CAMLICA MAH.,356,332,330,103,227
ATASEHIR,YENI CAMLICA MAH.,355,334,330,129,201
ATASEHIR,YENISEHIR MAH.,399,342,339,64,275
ATASEHIR,YENISEHIR MAH.,398,360,349,93,256
ATASEHIR,YENISEHIR MAH.,400,365,360,108,252
ATASEHIR,YENISEHIR MAH.,398,369,365,79,286
ATASEHIR,YENISEHIR MAH.,399,369,364,72,292
ATASEHIR,YENISEHIR MAH.,399,366,362,76,286
ATASEHIR,YENISEHIR MAH.,398,352,351,69,282
ATASEHIR,YENISEHIR MAH.,398,352,347,77,270
ATASEHIR,YENISEHIR MAH.,398,381,380,85,295
ATASEHIR,YENISEHIR MAH.,398,364,361,85,276
ATASEHIR,YENISEHIR MAH.,398,371,368,84,284
ATASEHIR,YENISEHIR MAH.,397,360,356,101,255
ATASEHIR,YENISEHIR MAH.,398,373,370,70,300
ATASEHIR,YENISEHIR MAH.,399,365,364,95,269
ATASEHIR,YENISEHIR MAH.,398,368,365,76,289
ATASEHIR,YENISEHIR MAH.,398,362,361,71,290
ATASEHIR,YENISEHIR MAH.,399,362,350,69,281
ATASEHIR,YENISEHIR MAH.,401,366,366,89,277
ATASEHIR,YENISEHIR MAH.,398,367,364,92,272
ATASEHIR,YENISEHIR MAH.,398,371,369,80,289
ATASEHIR,YENISEHIR MAH.,400,370,364,86,278
ATASEHIR,YENISEHIR MAH.,398,370,368,81,287
ATASEHIR,YENISEHIR MAH.,397,371,369,96,273
ATASEHIR,YENISEHIR MAH.,398,373,372,90,282
ATASEHIR,ASIKVEYSEL MAH.,409,350,346,73,273
ATASEHIR,ASIKVEYSEL MAH.,407,358,352,65,287
ATASEHIR,ASIKVEYSEL MAH.,409,361,354,75,279
ATASEHIR,ASIKVEYSEL MAH.,409,358,352,80,272
ATASEHIR,ASIKVEYSEL MAH.,409,372,371,82,289
ATASEHIR,ASIKVEYSEL MAH.,415,365,359,89,270
ATASEHIR,ASIKVEYSEL MAH.,408,376,376,73,303
ATASEHIR,ASIKVEYSEL MAH.,409,373,372,82,290
ATASEHIR,ASIKVEYSEL MAH.,407,366,362,90,272
ATASEHIR,ASIKVEYSEL MAH.,407,371,366,84,282
ATASEHIR,ASIKVEYSEL MAH.,408,367,366,59,307
ATASEHIR,ASIKVEYSEL MAH.,409,375,372,77,295
ATASEHIR,ASIKVEYSEL MAH.,407,352,349,78,271
ATASEHIR,ASIKVEYSEL MAH.,408,376,375,79,296
ATASEHIR,ASIKVEYSEL MAH.,408,350,348,89,259
ATASEHIR,ASIKVEYSEL MAH.,409,370,367,77,290
ATASEHIR,ASIKVEYSEL MAH.,409,371,369,93,276
ATASEHIR,ASIKVEYSEL MAH.,407,379,373,61,312
ATASEHIR,ASIKVEYSEL MAH.,408,354,350,78,272
ATASEHIR,ASIKVEYSEL MAH.,407,371,367,85,282
ATASEHIR,ASIKVEYSEL MAH.,407,370,364,81,283
ATASEHIR,ASIKVEYSEL MAH.,408,374,373,87,286
ATASEHIR,ASIKVEYSEL MAH.,407,374,369,71,298
ATASEHIR,ASIKVEYSEL MAH.,407,370,363,73,290
ATASEHIR,ATATURK MAH.,412,357,350,43,307
ATASEHIR,ATATURK MAH.,412,371,366,37,329
ATASEHIR,ATATURK MAH.,415,403,401,43,358
ATASEHIR,ATATURK MAH.,411,383,381,47,334
ATASEHIR,ATATURK MAH.,411,388,383,34,349
ATASEHIR,ATATURK MAH.,411,384,379,35,344
ATASEHIR,ATATURK MAH.,411,382,381,44,337
ATASEHIR,ATATURK MAH.,411,393,391,48,343
ATASEHIR,ATATURK MAH.,411,381,380,29,351
ATASEHIR,ATATURK MAH.,415,375,371,46,325
ATASEHIR,ATATURK MAH.,412,365,362,22,340
ATASEHIR,ATATURK MAH.,411,385,381,36,345
ATASEHIR,ATATURK MAH.,412,386,385,21,364
ATASEHIR,ATATURK MAH.,411,384,381,44,337
ATASEHIR,ATATURK MAH.,412,394,390,35,355
ATASEHIR,ATATURK MAH.,412,378,376,45,331
ATASEHIR,ATATURK MAH.,412,388,385,30,355
ATASEHIR,ATATURK MAH.,411,396,389,38,351
ATASEHIR,ATATURK MAH.,411,382,377,33,344
ATASEHIR,ATATURK MAH.,412,391,388,45,343
ATASEHIR,ATATURK MAH.,411,388,387,27,360
ATASEHIR,ATATURK MAH.,411,371,368,45,323
ATASEHIR,ATATURK MAH.,409,352,344,51,293
ATASEHIR,ATATURK MAH.,409,350,343,55,288
ATASEHIR,ATATURK MAH.,408,367,364,71,293
ATASEHIR,ATATURK MAH.,410,385,381,89,292
ATASEHIR,ATATURK MAH.,408,381,378,61,317
ATASEHIR,ATATURK MAH.,409,374,372,58,314
ATASEHIR,ATATURK MAH.,408,384,377,58,319
ATASEHIR,ATATURK MAH.,407,375,372,77,295
ATASEHIR,ATATURK MAH.,408,378,375,95,280
ATASEHIR,ATATURK MAH.,408,386,384,71,313
ATASEHIR,ATATURK MAH.,410,389,387,46,341
ATASEHIR,ATATURK MAH.,408,386,379,53,326
ATASEHIR,ATATURK MAH.,408,383,382,63,319
ATASEHIR,ATATURK MAH.,408,378,375,67,308
ATASEHIR,ATATURK MAH.,409,386,382,75,307
ATASEHIR,ATATURK MAH.,409,373,370,68,302
ATASEHIR,ATATURK MAH.,408,380,377,84,293
ATASEHIR,ATATURK MAH.,408,379,376,66,310
ATASEHIR,ATATURK MAH.,409,376,374,57,317
ATASEHIR,ATATURK MAH.,408,384,383,69,314
ATASEHIR,ATATURK MAH.,408,375,371,64,307
ATASEHIR,ATATURK MAH.,409,381,381,58,323
ATASEHIR,ATATURK MAH.,409,384,384,53,331
ATASEHIR,ATATURK MAH.,407,378,377,63,314
ATASEHIR,ATATURK MAH.,408,392,389,60,329
ATASEHIR,ATATURK MAH.,407,375,372,70,302
ATASEHIR,ATATURK MAH.,408,371,365,64,301
ATASEHIR,ATATURK MAH.,408,371,367,66,301
ATASEHIR,ATATURK MAH.,408,391,389,81,308
ATASEHIR,ATATURK MAH.,407,392,390,67,323
ATASEHIR,BARBAROS MAH.,408,359,353,50,303
ATASEHIR,BARBAROS MAH.,408,367,367,36,331
ATASEHIR,BARBAROS MAH.,411,385,384,49,335
ATASEHIR,BARBAROS MAH.,410,386,383,42,341
ATASEHIR,BARBAROS MAH.,408,386,385,41,344
ATASEHIR,BARBAROS MAH.,408,382,379,40,339
ATASEHIR,BARBAROS MAH.,408,385,384,39,345
ATASEHIR,BARBAROS MAH.,410,375,373,58,315
ATASEHIR,BARBAROS MAH.,408,382,375,42,333
ATASEHIR,BARBAROS MAH.,408,389,386,51,335
ATASEHIR,BARBAROS MAH.,408,393,391,49,342
ATASEHIR,BARBAROS MAH.,409,382,378,52,326
ATASEHIR,BARBAROS MAH.,409,371,365,34,331
ATASEHIR,BARBAROS MAH.,408,383,379,59,320
ATASEHIR,BARBAROS MAH.,408,374,373,51,322
ATASEHIR,BARBAROS MAH.,408,383,378,48,330
ATASEHIR,BARBAROS MAH.,408,388,385,37,348
ATASEHIR,BARBAROS MAH.,408,383,382,56,326
ATASEHIR,BARBAROS MAH.,408,372,370,45,325
ATASEHIR,BARBAROS MAH.,408,384,382,47,335
ATASEHIR,BARBAROS MAH.,408,384,381,47,334
ATASEHIR,BARBAROS MAH.,408,375,368,34,334
ATASEHIR,BARBAROS MAH.,408,390,387,52,335
ATASEHIR,BARBAROS MAH.,408,387,383,49,334
ATASEHIR,BARBAROS MAH.,408,386,383,49,334
ATASEHIR,BARBAROS MAH.,408,381,378,39,339
ATASEHIR,BARBAROS MAH.,383,322,311,236,75
ATASEHIR,BARBAROS MAH.,382,333,328,245,83
ATASEHIR,BARBAROS MAH.,382,334,325,227,98
ATASEHIR,BARBAROS MAH.,383,338,335,251,84
ATASEHIR,BARBAROS MAH.,383,339,333,234,99
ATASEHIR,BARBAROS MAH.,384,342,332,232,100
ATASEHIR,BARBAROS MAH.,383,337,335,221,114
ATASEHIR,BARBAROS MAH.,384,327,320,223,97
ATASEHIR,BARBAROS MAH.,382,328,320,222,98
ATASEHIR,BARBAROS MAH.,383,354,348,257,91
ATASEHIR,BARBAROS MAH.,382,333,327,226,101
ATASEHIR,BARBAROS MAH.,385,336,329,247,82
ATASEHIR,BARBAROS MAH.,415,331,327,162,165
ATASEHIR,BARBAROS MAH.,411,357,352,131,221
ATASEHIR,BARBAROS MAH.,415,380,377,123,254
ATASEHIR,BARBAROS MAH.,415,378,374,167,207
ATASEHIR,BARBAROS MAH.,412,374,369,151,218
ATASEHIR,BARBAROS MAH.,412,377,371,126,245
ATASEHIR,BARBAROS MAH.,415,377,367,160,207
ATASEHIR,BARBAROS MAH.,412,365,364,135,229
ATASEHIR,BARBAROS MAH.,412,375,372,171,201
ATASEHIR,BARBAROS MAH.,412,382,376,176,200
ATASEHIR,BARBAROS MAH.,412,374,368,124,244
ATASEHIR,BARBAROS MAH.,411,378,374,134,240
ATASEHIR,BARBAROS MAH.,411,377,372,163,209
ATASEHIR,BARBAROS MAH.,411,374,372,144,228
ATASEHIR,BARBAROS MAH.,412,367,365,137,228
ATASEHIR,BARBAROS MAH.,411,363,357,138,219
ATASEHIR,BARBAROS MAH.,411,374,367,162,205
ATASEHIR,BARBAROS MAH.,411,366,358,122,236
ATASEHIR,ESATPASA MAH.,409,345,342,153,189
ATASEHIR,ESATPASA MAH.,410,350,344,156,188
ATASEHIR,ESATPASA MAH.,408,361,349,181,168
ATASEHIR,ESATPASA MAH.,408,372,366,188,178
ATASEHIR,ESATPASA MAH.,415,368,365,190,175
ATASEHIR,ESATPASA MAH.,409,371,362,179,183
ATASEHIR,ESATPASA MAH.,409,364,361,165,196
ATASEHIR,ESATPASA MAH.,408,370,366,187,179
ATASEHIR,ESATPASA MAH.,410,354,348,192,156
ATASEHIR,ESATPASA MAH.,408,373,371,185,186
ATASEHIR,ESATPASA MAH.,408,360,353,176,177
ATASEHIR,ESATPASA MAH.,409,369,358,187,171
ATASEHIR,ESATPASA MAH.,408,367,360,155,205
ATASEHIR,ESATPASA MAH.,409,356,350,151,199
ATASEHIR,ESATPASA MAH.,408,369,367,182,185
ATASEHIR,ESATPASA MAH.,408,360,357,164,193
ATASEHIR,ESATPASA MAH.,409,357,352,159,193
ATASEHIR,ESATPASA MAH.,408,355,351,176,175
ATASEHIR,ESATPASA MAH.,409,383,378,194,184
ATASEHIR,ESATPASA MAH.,408,364,359,155,204
ATASEHIR,ESATPASA MAH.,409,371,362,199,163
ATASEHIR,ESATPASA MAH.,408,363,358,175,183
ATASEHIR,ESATPASA MAH.,411,356,352,181,171
ATASEHIR,ESATPASA MAH.,409,365,354,199,155
ATASEHIR,ESATPASA MAH.,408,369,366,187,179
ATASEHIR,ESATPASA MAH.,409,377,376,186,190
ATASEHIR,ESATPASA MAH.,410,348,344,195,149
ATASEHIR,ESATPASA MAH.,409,353,345,158,187
ATASEHIR,ESATPASA MAH.,409,362,354,168,186
ATASEHIR,ESATPASA MAH.,408,371,366,180,186
ATASEHIR,ESATPASA MAH.,409,376,373,181,192
ATASEHIR,ESATPASA MAH.,408,371,368,186,182
ATASEHIR,ESATPASA MAH.,409,369,368,200,168
ATASEHIR,ESATPASA MAH.,411,372,370,193,177
ATASEHIR,ESATPASA MAH.,409,371,368,176,192
ATASEHIR,ESATPASA MAH.,409,374,365,182,183
ATASEHIR,ESATPASA MAH.,410,363,355,158,197
ATASEHIR,ESATPASA MAH.,409,360,357,179,178
ATASEHIR,ESATPASA MAH.,409,353,347,190,157
ATASEHIR,ESATPASA MAH.,409,378,371,176,195
ATASEHIR,ESATPASA MAH.,409,367,362,182,180
ATASEHIR,ESATPASA MAH.,411,385,380,195,185
ATASEHIR,ESATPASA MAH.,411,369,364,152,212
ATASEHIR,ESATPASA MAH.,409,368,360,177,183
ATASEHIR,ESATPASA MAH.,409,384,381,216,165
ATASEHIR,ESATPASA MAH.,408,369,364,196,168
ATASEHIR,ESATPASA MAH.,409,367,363,191,172
ATASEHIR,ESATPASA MAH.,409,356,350,167,183
ATASEHIR,FETIH MAH.,403,347,344,110,234
ATASEHIR,FETIH MAH.,403,352,345,158,187
ATASEHIR,FETIH MAH.,402,363,357,181,176
ATASEHIR,FETIH MAH.,402,368,359,162,197
ATASEHIR,FETIH MAH.,402,365,354,165,189
ATASEHIR,FETIH MAH.,402,369,365,156,209
ATASEHIR,FETIH MAH.,402,355,352,152,200
ATASEHIR,FETIH MAH.,403,379,370,164,206
ATASEHIR,FETIH MAH.,402,363,356,142,214
ATASEHIR,FETIH MAH.,403,375,367,176,191
ATASEHIR,FETIH MAH.,403,377,374,145,229
ATASEHIR,FETIH MAH.,402,373,364,146,218
ATASEHIR,FETIH MAH.,402,373,369,151,218
ATASEHIR,FETIH MAH.,403,377,371,159,212
ATASEHIR,FETIH MAH.,403,377,373,166,207
ATASEHIR,FETIH MAH.,403,363,358,152,206
ATASEHIR,FETIH MAH.,403,367,362,178,184
ATASEHIR,FETIH MAH.,404,371,367,168,199
ATASEHIR,FETIH MAH.,402,376,371,162,209
ATASEHIR,FETIH MAH.,402,359,357,189,168
ATASEHIR,FETIH MAH.,403,376,370,157,213
ATASEHIR,FETIH MAH.,403,361,355,125,230
ATASEHIR,FETIH MAH.,405,381,376,158,218
ATASEHIR,KUCUKBAKKALKOY MAH.,408,342,340,94,246
ATASEHIR,KUCUKBAKKALKOY MAH.,407,375,372,109,263
ATASEHIR,KUCUKBAKKALKOY MAH.,409,367,360,90,270
ATASEHIR,KUCUKBAKKALKOY MAH.,408,394,392,92,300
ATASEHIR,KUCUKBAKKALKOY MAH.,408,386,384,85,299
ATASEHIR,KUCUKBAKKALKOY MAH.,408,371,367,89,278
ATASEHIR,KUCUKBAKKALKOY MAH.,408,377,375,103,272
ATASEHIR,KUCUKBAKKALKOY MAH.,411,392,390,78,312
ATASEHIR,KUCUKBAKKALKOY MAH.,408,384,379,107,272
ATASEHIR,KUCUKBAKKALKOY MAH.,408,390,386,109,277
ATASEHIR,KUCUKBAKKALKOY MAH.,407,377,373,104,269
ATASEHIR,KUCUKBAKKALKOY MAH.,408,385,377,112,265
ATASEHIR,KUCUKBAKKALKOY MAH.,408,378,372,94,278
ATASEHIR,KUCUKBAKKALKOY MAH.,410,370,365,105,260
ATASEHIR,KUCUKBAKKALKOY MAH.,409,371,369,122,247
ATASEHIR,KUCUKBAKKALKOY MAH.,409,371,367,80,287
ATASEHIR,KUCUKBAKKALKOY MAH.,408,381,375,113,262
ATASEHIR,KUCUKBAKKALKOY MAH.,409,373,365,119,246
ATASEHIR,KUCUKBAKKALKOY MAH.,408,386,381,82,299
ATASEHIR,KUCUKBAKKALKOY MAH.,408,373,368,86,282
ATASEHIR,KUCUKBAKKALKOY MAH.,408,377,375,102,273
ATASEHIR,KUCUKBAKKALKOY MAH.,408,378,376,99,277
ATASEHIR,KUCUKBAKKALKOY MAH.,408,382,375,104,271
ATASEHIR,KUCUKBAKKALKOY MAH.,409,386,381,83,298
ATASEHIR,KUCUKBAKKALKOY MAH.,408,390,383,98,285
ATASEHIR,KUCUKBAKKALKOY MAH.,405,335,331,146,185
ATASEHIR,KUCUKBAKKALKOY MAH.,406,343,336,127,209
ATASEHIR,KUCUKBAKKALKOY MAH.,406,376,368,160,208
ATASEHIR,KUCUKBAKKALKOY MAH.,405,366,363,140,223
ATASEHIR,KUCUKBAKKALKOY MAH.,405,364,361,147,214
ATASEHIR,KUCUKBAKKALKOY MAH.,405,366,362,161,201
ATASEHIR,KUCUKBAKKALKOY MAH.,405,368,360,156,204
ATASEHIR,KUCUKBAKKALKOY MAH.,405,364,354,134,220
ATASEHIR,KUCUKBAKKALKOY MAH.,408,365,359,126,233
ATASEHIR,KUCUKBAKKALKOY MAH.,405,376,372,162,210
ATASEHIR,KUCUKBAKKALKOY MAH.,405,363,358,145,213
ATASEHIR,KUCUKBAKKALKOY MAH.,404,359,354,159,195
ATASEHIR,KUCUKBAKKALKOY MAH.,405,370,364,133,231
ATASEHIR,KUCUKBAKKALKOY MAH.,404,367,360,137,223
ATASEHIR,KUCUKBAKKALKOY MAH.,389,321,317,130,187
ATASEHIR,KUCUKBAKKALKOY MAH.,388,336,332,111,221
ATASEHIR,KUCUKBAKKALKOY MAH.,392,353,351,114,237
ATASEHIR,KUCUKBAKKALKOY MAH.,389,361,358,122,236
ATASEHIR,KUCUKBAKKALKOY MAH.,388,350,348,108,240
ATASEHIR,KUCUKBAKKALKOY MAH.,388,355,353,127,226
ATASEHIR,KUCUKBAKKALKOY MAH.,388,362,354,117,237
ATASEHIR,KUCUKBAKKALKOY MAH.,387,349,345,120,225
ATASEHIR,KUCUKBAKKALKOY MAH.,387,354,350,111,239
ATASEHIR,KUCUKBAKKALKOY MAH.,389,350,342,111,231
ATASEHIR,KUCUKBAKKALKOY MAH.,388,350,345,116,229
ATASEHIR,KUCUKBAKKALKOY MAH.,390,362,359,128,231
ATASEHIR,KUCUKBAKKALKOY MAH.,388,353,349,121,228
ATASEHIR,KUCUKBAKKALKOY MAH.,388,358,352,131,221
ATASEHIR,KUCUKBAKKALKOY MAH.,388,354,349,120,229
ATASEHIR,MUSTAFA KEMAL MAH.,415,341,336,64,272
ATASEHIR,MUSTAFA KEMAL MAH.,410,342,333,59,274
ATASEHIR,MUSTAFA KEMAL MAH.,410,354,343,92,251
ATASEHIR,MUSTAFA KEMAL MAH.,409,362,358,84,274
ATASEHIR,MUSTAFA KEMAL MAH.,409,368,359,90,269
ATASEHIR,MUSTAFA KEMAL MAH.,410,365,359,98,261
ATASEHIR,MUSTAFA KEMAL MAH.,410,372,367,80,287
ATASEHIR,MUSTAFA KEMAL MAH.,411,362,356,95,261
ATASEHIR,MUSTAFA KEMAL MAH.,409,372,367,105,262
ATASEHIR,MUSTAFA KEMAL MAH.,409,358,354,106,248
ATASEHIR,MUSTAFA KEMAL MAH.,410,378,372,95,277
ATASEHIR,MUSTAFA KEMAL MAH.,409,363,358,94,264
ATASEHIR,MUSTAFA KEMAL MAH.,410,368,365,99,266
ATASEHIR,MUSTAFA KEMAL MAH.,410,374,372,113,259
ATASEHIR,MUSTAFA KEMAL MAH.,409,378,371,106,265
ATASEHIR,MUSTAFA KEMAL MAH.,415,362,358,103,255
ATASEHIR,MUSTAFA KEMAL MAH.,409,365,361,114,247
ATASEHIR,MUSTAFA KEMAL MAH.,415,343,339,103,236
ATASEHIR,MUSTAFA KEMAL MAH.,409,365,362,94,268
ATASEHIR,MUSTAFA KEMAL MAH.,411,360,353,98,255
ATASEHIR,MUSTAFA KEMAL MAH.,409,365,360,83,277
ATASEHIR,MUSTAFA KEMAL MAH.,409,364,358,105,253
ATASEHIR,MUSTAFA KEMAL MAH.,409,352,347,88,259
ATASEHIR,MUSTAFA KEMAL MAH.,411,367,365,110,255
ATASEHIR,MUSTAFA KEMAL MAH.,410,370,361,107,254
ATASEHIR,MUSTAFA KEMAL MAH.,410,370,361,104,257
ATASEHIR,MUSTAFA KEMAL MAH.,409,376,368,106,262
ATASEHIR,ORNEK MAH.,412,349,346,154,192
ATASEHIR,ORNEK MAH.,412,354,346,168,178
ATASEHIR,ORNEK MAH.,411,349,343,175,168
ATASEHIR,ORNEK MAH.,411,383,376,176,200
ATASEHIR,ORNEK MAH.,412,367,364,180,184
ATASEHIR,ORNEK MAH.,411,374,369,193,176
ATASEHIR,ORNEK MAH.,415,378,373,179,194
ATASEHIR,ORNEK MAH.,415,365,360,157,203
ATASEHIR,ORNEK MAH.,411,383,377,179,198
ATASEHIR,ORNEK MAH.,411,360,356,177,179
ATASEHIR,ORNEK MAH.,412,367,360,169,191
ATASEHIR,ORNEK MAH.,411,367,361,172,189
ATASEHIR,ORNEK MAH.,412,379,376,192,184
ATASEHIR,ORNEK MAH.,412,378,370,176,194
ATASEHIR,ORNEK MAH.,412,370,365,165,200
ATASEHIR,ORNEK MAH.,412,385,381,205,176
ATASEHIR,ORNEK MAH.,412,376,372,186,186
ATASEHIR,ORNEK MAH.,412,374,372,184,188
ATASEHIR,ORNEK MAH.,412,385,385,181,204
ATASEHIR,ORNEK MAH.,412,384,382,164,218
ATASEHIR,ORNEK MAH.,412,373,365,166,199
ATASEHIR,ORNEK MAH.,412,378,374,175,199
ATASEHIR,ORNEK MAH.,404,350,342,204,138
ATASEHIR,ORNEK MAH.,402,351,344,166,178
ATASEHIR,ORNEK MAH.,403,345,338,172,166
ATASEHIR,ORNEK MAH.,402,346,342,142,200
ATASEHIR,ORNEK MAH.,403,374,372,187,185
ATASEHIR,ORNEK MAH.,403,370,369,176,193
ATASEHIR,ORNEK MAH.,402,367,364,190,174
ATASEHIR,ORNEK MAH.,403,357,351,152,199
ATASEHIR,ORNEK MAH.,403,368,361,157,204
ATASEHIR,ORNEK MAH.,403,366,365,139,226
ATASEHIR,ORNEK MAH.,403,370,367,164,203
ATASEHIR,ORNEK MAH.,401,365,359,154,205
ATASEHIR,ORNEK MAH.,403,375,364,170,194
ATASEHIR,ORNEK MAH.,402,359,353,161,192
ATASEHIR,ORNEK MAH.,403,375,373,179,194
ATASEHIR,ORNEK MAH.,403,370,369,162,207
ATASEHIR,ORNEK MAH.,402,366,363,177,186
ATASEHIR,ORNEK MAH.,403,362,356,147,209
ATASEHIR,ORNEK MAH.,403,362,358,142,216
ATASEHIR,ORNEK MAH.,402,358,356,157,199
ATASEHIR,ORNEK MAH.,402,368,365,134,231
ATASEHIR,ORNEK MAH.,403,352,347,163,184
ATASEHIR,ORNEK MAH.,403,365,363,144,219
ATASEHIR,ORNEK MAH.,402,357,354,163,191
ATASEHIR,ORNEK MAH.,401,366,361,150,211
ATASEHIR,ORNEK MAH.,403,364,358,133,225
ATASEHIR,ORNEK MAH.,403,366,362,153,209
ATASEHIR,ORNEK MAH.,402,362,359,150,209
ATASEHIR,YENISAHRA MAH.,385,335,328,232,96
ATASEHIR,YENISAHRA MAH.,385,344,337,235,102
ATASEHIR,YENISAHRA MAH.,385,343,333,217,116
ATASEHIR,YENISAHRA MAH.,385,336,330,213,117
ATASEHIR,YENISAHRA MAH.,386,341,330,189,141
ATASEHIR,YENISAHRA MAH.,386,332,326,220,106
ATASEHIR,YENISAHRA MAH.,387,347,343,208,135
ATASEHIR,YENISAHRA MAH.,385,334,332,181,151
ATASEHIR,YENISAHRA MAH.,385,321,311,192,119
ATASEHIR,YENISAHRA MAH.,385,350,344,216,128
ATASEHIR,YENISAHRA MAH.,384,344,343,224,119
ATASEHIR,YENISAHRA MAH.,385,349,346,230,116
ATASEHIR,YENISAHRA MAH.,384,332,324,196,128
ATASEHIR,YENISAHRA MAH.,400,332,329,172,157
ATASEHIR,YENISAHRA MAH.,401,341,336,180,156
ATASEHIR,YENISAHRA MAH.,400,341,338,187,151
ATASEHIR,YENISAHRA MAH.,401,347,341,173,168
ATASEHIR,YENISAHRA MAH.,400,340,333,145,188
ATASEHIR,YENISAHRA MAH.,401,329,324,157,167
ATASEHIR,YENISAHRA MAH.,404,350,338,176,162
ATASEHIR,YENISAHRA MAH.,401,356,354,203,151
BESIKTAS,ABBASAGA MAH.,393,328,319,76,243
BESIKTAS,ABBASAGA MAH.,393,339,335,71,264
BESIKTAS,ABBASAGA MAH.,395,354,350,84,266
BESIKTAS,ABBASAGA MAH.,393,341,341,61,280
BESIKTAS,ABBASAGA MAH.,393,351,348,78,270
BESIKTAS,ABBASAGA MAH.,393,334,327,61,266
BESIKTAS,ABBASAGA MAH.,393,360,356,59,297
BESIKTAS,ABBASAGA MAH.,393,351,347,84,263
BESIKTAS,ABBASAGA MAH.,392,358,351,85,266
BESIKTAS,ABBASAGA MAH.,392,361,356,59,297
BESIKTAS,ABBASAGA MAH.,394,349,339,83,256
BESIKTAS,AKAT MAH.,415,358,353,22,331
BESIKTAS,AKAT MAH.,415,335,333,24,309
BESIKTAS,AKAT MAH.,415,379,377,23,354
BESIKTAS,AKAT MAH.,414,369,368,37,331
BESIKTAS,AKAT MAH.,414,373,372,27,345
BESIKTAS,AKAT MAH.,415,389,385,28,357
BESIKTAS,AKAT MAH.,413,373,371,17,354
BESIKTAS,AKAT MAH.,414,383,383,27,356
BESIKTAS,AKAT MAH.,414,386,382,31,351
BESIKTAS,AKAT MAH.,413,374,370,25,345
BESIKTAS,AKAT MAH.,413,389,384,44,340
BESIKTAS,AKAT MAH.,394,341,337,84,253
BESIKTAS,AKAT MAH.,394,332,331,64,267
BESIKTAS,AKAT MAH.,396,353,353,93,260
BESIKTAS,AKAT MAH.,394,356,356,105,251
BESIKTAS,AKAT MAH.,395,372,367,112,255
BESIKTAS,AKAT MAH.,394,364,360,95,265
BESIKTAS,AKAT MAH.,394,354,351,103,248
BESIKTAS,AKAT MAH.,395,372,368,90,278
BESIKTAS,AKAT MAH.,396,362,359,124,235
BESIKTAS,AKAT MAH.,394,361,357,99,258
BESIKTAS,AKAT MAH.,393,369,365,100,265
BESIKTAS,AKAT MAH.,394,360,357,86,271
BESIKTAS,AKAT MAH.,398,339,332,33,299
BESIKTAS,AKAT MAH.,399,346,338,27,311
BESIKTAS,AKAT MAH.,399,374,373,41,332
BESIKTAS,AKAT MAH.,400,369,366,39,327
BESIKTAS,AKAT MAH.,399,370,364,53,311
BESIKTAS,AKAT MAH.,399,366,362,41,321
BESIKTAS,AKAT MAH.,399,370,365,43,322
BESIKTAS,ARNAVUTKOY MAH.,415,331,331,75,256
BESIKTAS,ARNAVUTKOY MAH.,415,346,344,81,263
BESIKTAS,ARNAVUTKOY MAH.,415,345,342,69,273
BESIKTAS,ARNAVUTKOY MAH.,413,356,353,103,250
BESIKTAS,ARNAVUTKOY MAH.,410,352,351,96,255
BESIKTAS,ARNAVUTKOY MAH.,412,352,345,88,257
BESIKTAS,ARNAVUTKOY MAH.,411,365,364,91,273
BESIKTAS,ARNAVUTKOY MAH.,413,373,371,127,244
BESIKTAS,BALMUMCU MAH.,396,334,329,51,278
BESIKTAS,BALMUMCU MAH.,394,364,359,45,314
BESIKTAS,BALMUMCU MAH.,396,364,360,58,302
BESIKTAS,BALMUMCU MAH.,396,358,353,40,313
BESIKTAS,BALMUMCU MAH.,396,364,359,40,319
BESIKTAS,BALMUMCU MAH.,396,370,369,37,332
BESIKTAS,BEBEK MAH.,400,332,326,37,289
BESIKTAS,BEBEK MAH.,400,331,321,35,286
BESIKTAS,BEBEK MAH.,399,342,335,45,290
BESIKTAS,BEBEK MAH.,402,362,359,56,303
BESIKTAS,BEBEK MAH.,401,352,348,64,284
BESIKTAS,BEBEK MAH.,401,343,342,48,294
BESIKTAS,BEBEK MAH.,399,341,338,38,300
BESIKTAS,BEBEK MAH.,401,366,362,52,310
BESIKTAS,BEBEK MAH.,400,352,347,62,285
BESIKTAS,BEBEK MAH.,400,346,344,66,278
BESIKTAS,BEBEK MAH.,400,373,367,66,301
BESIKTAS,CIHANNUMA MAH.,401,329,325,49,276
BESIKTAS,CIHANNUMA MAH.,401,334,333,53,280
BESIKTAS,CIHANNUMA MAH.,402,368,367,54,313
BESIKTAS,CIHANNUMA MAH.,402,357,352,55,297
BESIKTAS,CIHANNUMA MAH.,401,351,349,56,293
BESIKTAS,CIHANNUMA MAH.,402,343,336,49,287
BESIKTAS,CIHANNUMA MAH.,401,352,350,47,303
BESIKTAS,CIHANNUMA MAH.,402,361,356,52,304
BESIKTAS,DIKILITAS MAH.,393,322,313,81,232
BESIKTAS,DIKILITAS MAH.,394,354,349,86,263
BESIKTAS,DIKILITAS MAH.,392,364,361,78,283
BESIKTAS,DIKILITAS MAH.,393,373,372,96,276
BESIKTAS,DIKILITAS MAH.,392,350,345,60,285
BESIKTAS,DIKILITAS MAH.,392,353,350,86,264
BESIKTAS,DIKILITAS MAH.,392,351,349,80,269
BESIKTAS,DIKILITAS MAH.,393,367,365,101,264
BESIKTAS,DIKILITAS MAH.,392,351,347,52,295
BESIKTAS,DIKILITAS MAH.,415,331,323,78,245
BESIKTAS,DIKILITAS MAH.,415,347,345,108,237
BESIKTAS,DIKILITAS MAH.,411,387,381,70,311
BESIKTAS,DIKILITAS MAH.,411,372,367,79,288
BESIKTAS,DIKILITAS MAH.,411,380,378,70,308
BESIKTAS,DIKILITAS MAH.,411,388,381,82,299
BESIKTAS,DIKILITAS MAH.,411,376,372,68,304
BESIKTAS,DIKILITAS MAH.,411,380,374,100,274
BESIKTAS,DIKILITAS MAH.,410,371,365,65,300
BESIKTAS,DIKILITAS MAH.,411,390,386,88,298
BESIKTAS,DIKILITAS MAH.,410,382,381,77,304
BESIKTAS,DIKILITAS MAH.,410,374,367,76,291
BESIKTAS,DIKILITAS MAH.,410,380,371,72,299
BESIKTAS,DIKILITAS MAH.,410,386,381,69,312
BESIKTAS,DIKILITAS MAH.,415,336,331,96,235
BESIKTAS,DIKILITAS MAH.,415,361,357,88,269
BESIKTAS,DIKILITAS MAH.,415,378,374,83,291
BESIKTAS,DIKILITAS MAH.,415,375,371,81,290
BESIKTAS,DIKILITAS MAH.,415,363,359,74,285
BESIKTAS,DIKILITAS MAH.,415,369,365,95,270
BESIKTAS,DIKILITAS MAH.,415,370,363,77,286
BESIKTAS,DIKILITAS MAH.,415,387,381,92,289
BESIKTAS,DIKILITAS MAH.,415,374,372,81,291
BESIKTAS,DIKILITAS MAH.,413,370,365,69,296
BESIKTAS,DIKILITAS MAH.,415,383,378,109,269
BESIKTAS,ETILER MAH.,399,350,341,55,286
BESIKTAS,ETILER MAH.,399,344,339,45,294
BESIKTAS,ETILER MAH.,398,367,365,62,303
BESIKTAS,ETILER MAH.,399,362,358,57,301
BESIKTAS,ETILER MAH.,398,378,378,63,315
BESIKTAS,ETILER MAH.,398,356,349,37,312
BESIKTAS,ETILER MAH.,399,372,370,43,327
BESIKTAS,ETILER MAH.,399,364,361,49,312
BESIKTAS,ETILER MAH.,398,375,371,49,322
BESIKTAS,ETILER MAH.,399,377,376,41,335
BESIKTAS,ETILER MAH.,399,333,330,40,290
BESIKTAS,ETILER MAH.,399,335,328,48,280
BESIKTAS,ETILER MAH.,400,357,354,64,290
BESIKTAS,ETILER MAH.,399,367,365,54,311
BESIKTAS,ETILER MAH.,400,365,364,52,312
BESIKTAS,ETILER MAH.,399,365,363,45,318
BESIKTAS,ETILER MAH.,398,366,357,30,327
BESIKTAS,ETILER MAH.,400,354,350,38,312
BESIKTAS,ETILER MAH.,399,360,356,49,307
BESIKTAS,ETILER MAH.,399,369,364,22,342
BESIKTAS,ETILER MAH.,399,364,362,43,319
BESIKTAS,ETILER MAH.,408,364,360,43,317
BESIKTAS,ETILER MAH.,408,380,370,40,330
BESIKTAS,GAYRETTEPE MAH.,364,300,294,67,227
BESIKTAS,GAYRETTEPE MAH.,364,334,331,69,262
BESIKTAS,GAYRETTEPE MAH.,364,345,341,58,283
BESIKTAS,GAYRETTEPE MAH.,365,341,336,66,270
BESIKTAS,GAYRETTEPE MAH.,364,334,331,50,281
BESIKTAS,GAYRETTEPE MAH.,365,337,336,60,276
BESIKTAS,GAYRETTEPE MAH.,365,331,327,60,267
BESIKTAS,GAYRETTEPE MAH.,365,346,338,53,285
BESIKTAS,GAYRETTEPE MAH.,408,338,330,42,288
BESIKTAS,GAYRETTEPE MAH.,409,343,341,45,296
BESIKTAS,GAYRETTEPE MAH.,408,360,355,55,300
BESIKTAS,GAYRETTEPE MAH.,408,343,341,33,308
BESIKTAS,GAYRETTEPE MAH.,409,374,370,41,329
BESIKTAS,GAYRETTEPE MAH.,408,386,383,53,330
BESIKTAS,GAYRETTEPE MAH.,408,371,368,41,327
BESIKTAS,GAYRETTEPE MAH.,408,382,379,56,323
BESIKTAS,GAYRETTEPE MAH.,408,379,375,56,319
BESIKTAS,GAYRETTEPE MAH.,408,380,376,59,317
BESIKTAS,GAYRETTEPE MAH.,407,384,379,56,323
BESIKTAS,GAYRETTEPE MAH.,408,374,372,53,319
BESIKTAS,GAYRETTEPE MAH.,407,383,383,67,316
BESIKTAS,GAYRETTEPE MAH.,408,377,374,74,300
BESIKTAS,GAYRETTEPE MAH.,407,361,361,41,320
BESIKTAS,GAYRETTEPE MAH.,408,376,372,46,326
BESIKTAS,GAYRETTEPE MAH.,408,384,382,57,325
BESIKTAS,GAYRETTEPE MAH.,407,379,376,56,320
BESIKTAS,GAYRETTEPE MAH.,407,379,378,76,302
BESIKTAS,GAYRETTEPE MAH.,408,390,384,58,326
BESIKTAS,KONAKLAR MAH.,388,339,337,31,306
BESIKTAS,KONAKLAR MAH.,391,356,356,46,310
BESIKTAS,KONAKLAR MAH.,388,357,354,54,300
BESIKTAS,KONAKLAR MAH.,387,352,349,56,293
BESIKTAS,KONAKLAR MAH.,387,364,362,42,320
BESIKTAS,KONAKLAR MAH.,388,374,370,65,305
BESIKTAS,KONAKLAR MAH.,415,353,347,63,284
BESIKTAS,KONAKLAR MAH.,415,371,367,69,298
BESIKTAS,KONAKLAR MAH.,414,373,369,87,282
BESIKTAS,KONAKLAR MAH.,415,387,383,71,312
BESIKTAS,KONAKLAR MAH.,414,373,369,52,317
BESIKTAS,KONAKLAR MAH.,413,375,372,79,293
BESIKTAS,KONAKLAR MAH.,414,392,388,104,284
BESIKTAS,KONAKLAR MAH.,413,371,366,71,295
BESIKTAS,KONAKLAR MAH.,415,389,385,62,323
BESIKTAS,KONAKLAR MAH.,413,392,389,81,308
BESIKTAS,KONAKLAR MAH.,406,369,365,36,329
BESIKTAS,KONAKLAR MAH.,408,352,349,34,315
BESIKTAS,KONAKLAR MAH.,407,378,373,31,342
BESIKTAS,KONAKLAR MAH.,405,379,373,45,328
BESIKTAS,KONAKLAR MAH.,406,387,382,49,333
BESIKTAS,KONAKLAR MAH.,409,376,373,35,338
BESIKTAS,KONAKLAR MAH.,406,377,371,36,335
BESIKTAS,KONAKLAR MAH.,405,383,378,35,343
BESIKTAS,KONAKLAR MAH.,406,377,377,32,345
BESIKTAS,KONAKLAR MAH.,406,385,384,45,339
BESIKTAS,KONAKLAR MAH.,408,385,384,41,343
BESIKTAS,KONAKLAR MAH.,405,395,390,50,340
BESIKTAS,KURUCESME MAH.,417,350,340,86,254
BESIKTAS,KURUCESME MAH.,416,358,349,92,257
BESIKTAS,KURUCESME MAH.,417,367,365,101,264
BESIKTAS,KURUCESME MAH.,417,366,360,97,263
BESIKTAS,KURUCESME MAH.,417,369,363,102,261
BESIKTAS,KURUCESME MAH.,417,377,376,113,263
BESIKTAS,KULTUR MAH.,392,340,337,47,290
BESIKTAS,KULTUR MAH.,392,334,332,57,275
BESIKTAS,KULTUR MAH.,392,350,346,47,299
BESIKTAS,KULTUR MAH.,393,347,345,42,303
BESIKTAS,KULTUR MAH.,392,357,350,43,307
BESIKTAS,KULTUR MAH.,392,343,338,71,267
BESIKTAS,KULTUR MAH.,394,364,360,54,306
BESIKTAS,KULTUR MAH.,391,359,357,55,302
BESIKTAS,KULTUR MAH.,392,349,348,50,298
BESIKTAS,KULTUR MAH.,392,368,361,69,292
BESIKTAS,LEVAZIM MAH.,386,332,330,39,291
BESIKTAS,LEVAZIM MAH.,385,344,337,41,296
BESIKTAS,LEVAZIM MAH.,390,375,373,27,346
BESIKTAS,LEVAZIM MAH.,385,365,363,49,314
BESIKTAS,LEVAZIM MAH.,385,358,356,56,300
BESIKTAS,LEVAZIM MAH.,384,355,352,31,321
BESIKTAS,LEVAZIM MAH.,384,359,357,38,319
BESIKTAS,LEVAZIM MAH.,384,357,355,64,291
BESIKTAS,LEVAZIM MAH.,385,357,355,40,315
BESIKTAS,LEVAZIM MAH.,385,357,357,42,315
BESIKTAS,LEVAZIM MAH.,385,360,357,39,318
BESIKTAS,LEVAZIM MAH.,386,369,367,53,314
BESIKTAS,LEVENT MAH.,409,362,360,49,311
BESIKTAS,LEVENT MAH.,409,353,345,42,303
BESIKTAS,LEVENT MAH.,409,376,375,46,329
BESIKTAS,LEVENT MAH.,409,362,359,56,303
BESIKTAS,LEVENT MAH.,408,358,356,57,299
BESIKTAS,LEVENT MAH.,410,380,375,50,325
BESIKTAS,MECIDIYE MAH.,416,333,328,71,257
BESIKTAS,MECIDIYE MAH.,416,361,356,71,285
BESIKTAS,MECIDIYE MAH.,416,360,356,90,266
BESIKTAS,MECIDIYE MAH.,415,379,375,67,308
BESIKTAS,MECIDIYE MAH.,416,372,370,80,290
BESIKTAS,MECIDIYE MAH.,416,361,359,77,282
BESIKTAS,MECIDIYE MAH.,416,382,381,92,289
BESIKTAS,MECIDIYE MAH.,391,309,302,75,227
BESIKTAS,MECIDIYE MAH.,393,321,317,89,228
BESIKTAS,MECIDIYE MAH.,393,341,338,80,258
BESIKTAS,MECIDIYE MAH.,391,345,344,83,261
BESIKTAS,MECIDIYE MAH.,391,340,332,75,257
BESIKTAS,MECIDIYE MAH.,391,357,356,68,288
BESIKTAS,MECIDIYE MAH.,390,344,343,81,262
BESIKTAS,MECIDIYE MAH.,391,349,346,79,267
BESIKTAS,MECIDIYE MAH.,369,308,302,67,235
BESIKTAS,MECIDIYE MAH.,367,321,318,52,266
BESIKTAS,MECIDIYE MAH.,366,318,313,78,235
BESIKTAS,MECIDIYE MAH.,366,325,322,63,259
BESIKTAS,MECIDIYE MAH.,365,327,325,70,255
BESIKTAS,MECIDIYE MAH.,365,306,297,64,233
BESIKTAS,MECIDIYE MAH.,365,332,328,63,265
BESIKTAS,MURADIYE MAH.,397,319,313,53,260
BESIKTAS,MURADIYE MAH.,395,325,319,45,274
BESIKTAS,MURADIYE MAH.,395,350,347,56,291
BESIKTAS,MURADIYE MAH.,395,361,360,64,296
BESIKTAS,MURADIYE MAH.,395,352,348,55,293
BESIKTAS,MURADIYE MAH.,395,360,358,39,319
BESIKTAS,MURADIYE MAH.,395,355,351,47,304
BESIKTAS,MURADIYE MAH.,394,360,356,47,309
BESIKTAS,MURADIYE MAH.,395,360,357,39,318
BESIKTAS,MURADIYE MAH.,394,351,348,53,295
BESIKTAS,MURADIYE MAH.,394,362,360,56,304
BESIKTAS,NISBETIYE MAH.,383,320,317,34,283
BESIKTAS,NISBETIYE MAH.,382,305,302,27,275
BESIKTAS,NISBETIYE MAH.,384,343,338,32,306
BESIKTAS,NISBETIYE MAH.,383,349,349,22,327
BESIKTAS,NISBETIYE MAH.,382,354,350,32,318
BESIKTAS,NISBETIYE MAH.,382,341,340,58,282
BESIKTAS,NISBETIYE MAH.,383,349,347,48,299
BESIKTAS,NISBETIYE MAH.,384,354,352,57,295
BESIKTAS,NISBETIYE MAH.,383,359,350,35,315
BESIKTAS,NISBETIYE MAH.,383,349,347,42,305
BESIKTAS,NISBETIYE MAH.,382,357,356,44,312
BESIKTAS,NISBETIYE MAH.,382,367,364,45,319
BESIKTAS,NISBETIYE MAH.,406,370,368,36,332
BESIKTAS,NISBETIYE MAH.,404,377,374,33,341
BESIKTAS,NISBETIYE MAH.,405,388,382,40,342
BESIKTAS,NISBETIYE MAH.,405,368,367,23,344
BESIKTAS,NISBETIYE MAH.,405,382,380,26,354
BESIKTAS,NISBETIYE MAH.,405,386,384,34,350
BESIKTAS,NISBETIYE MAH.,372,312,311,29,282
BESIKTAS,NISBETIYE MAH.,374,310,303,47,256
BESIKTAS,NISBETIYE MAH.,372,352,348,49,299
BESIKTAS,NISBETIYE MAH.,372,334,332,52,280
BESIKTAS,NISBETIYE MAH.,372,335,332,33,299
BESIKTAS,NISBETIYE MAH.,372,345,343,56,287
BESIKTAS,NISBETIYE MAH.,372,354,351,57,294
BESIKTAS,NISBETIYE MAH.,371,342,338,67,271
BESIKTAS,ORTAKOY MAH.,404,340,336,63,273
BESIKTAS,ORTAKOY MAH.,404,330,323,70,253
BESIKTAS,ORTAKOY MAH.,405,343,335,59,276
BESIKTAS,ORTAKOY MAH.,403,361,357,55,302
BESIKTAS,ORTAKOY MAH.,402,357,352,60,292
BESIKTAS,ORTAKOY MAH.,403,361,359,62,297
BESIKTAS,ORTAKOY MAH.,404,365,363,59,304
BESIKTAS,ORTAKOY MAH.,404,360,358,66,292
BESIKTAS,ORTAKOY MAH.,403,351,346,83,263
BESIKTAS,ORTAKOY MAH.,403,357,350,88,262
BESIKTAS,ORTAKOY MAH.,403,359,353,64,289
BESIKTAS,ORTAKOY MAH.,404,343,335,62,273
BESIKTAS,ORTAKOY MAH.,403,359,353,66,287
BESIKTAS,ORTAKOY MAH.,404,363,360,62,298
BESIKTAS,ORTAKOY MAH.,403,345,343,57,286
BESIKTAS,ORTAKOY MAH.,404,348,346,53,293
BESIKTAS,ORTAKOY MAH.,403,363,361,47,314
BESIKTAS,ORTAKOY MAH.,404,362,359,62,297
BESIKTAS,SINANPASA MAH.,407,324,318,79,239
BESIKTAS,SINANPASA MAH.,407,343,338,79,259
BESIKTAS,SINANPASA MAH.,406,299,295,51,244
BESIKTAS,SINANPASA MAH.,406,345,343,49,294
BESIKTAS,SINANPASA MAH.,406,356,352,62,290
BESIKTAS,TURKALI MAH.,397,331,325,81,244
BESIKTAS,TURKALI MAH.,397,329,324,79,245
BESIKTAS,TURKALI MAH.,397,317,309,54,255
BESIKTAS,TURKALI MAH.,397,317,314,85,229
BESIKTAS,TURKALI MAH.,397,364,360,77,283
BESIKTAS,TURKALI MAH.,401,363,362,51,311
BESIKTAS,TURKALI MAH.,397,344,344,73,271
BESIKTAS,TURKALI MAH.,397,362,355,70,285
BESIKTAS,TURKALI MAH.,397,360,357,61,296
BESIKTAS,TURKALI MAH.,397,363,362,73,289
BESIKTAS,TURKALI MAH.,397,349,349,59,290
BESIKTAS,TURKALI MAH.,397,352,348,77,271
BESIKTAS,TURKALI MAH.,396,361,358,62,296
BESIKTAS,TURKALI MAH.,398,348,345,87,258
BESIKTAS,TURKALI MAH.,397,346,343,60,283
BESIKTAS,TURKALI MAH.,400,352,348,59,289
BESIKTAS,TURKALI MAH.,397,365,362,58,304
BESIKTAS,TURKALI MAH.,396,357,355,57,298
BESIKTAS,TURKALI MAH.,397,365,363,76,287
BESIKTAS,TURKALI MAH.,397,351,349,67,282
BESIKTAS,TURKALI MAH.,398,357,351,73,278
BESIKTAS,TURKALI MAH.,398,364,354,74,280
BESIKTAS,ULUS MAH.,410,343,340,44,296
BESIKTAS,ULUS MAH.,410,355,350,54,296
BESIKTAS,ULUS MAH.,410,391,387,76,311
BESIKTAS,ULUS MAH.,410,361,357,63,294
BESIKTAS,ULUS MAH.,410,367,362,94,268
BESIKTAS,ULUS MAH.,410,371,367,89,278
BESIKTAS,ULUS MAH.,409,369,366,85,281
BESIKTAS,ULUS MAH.,409,375,371,96,275
BESIKTAS,ULUS MAH.,410,376,372,95,277
BESIKTAS,ULUS MAH.,409,371,369,100,269
BESIKTAS,ULUS MAH.,410,373,370,76,294
BESIKTAS,ULUS MAH.,409,362,358,67,291
BESIKTAS,ULUS MAH.,410,386,384,98,286
BESIKTAS,VISNEZADE MAH.,360,297,293,49,244
BESIKTAS,VISNEZADE MAH.,356,313,309,44,265
BESIKTAS,VISNEZADE MAH.,358,330,324,49,275
BESIKTAS,VISNEZADE MAH.,357,331,329,48,281
BESIKTAS,VISNEZADE MAH.,356,331,326,66,260
BESIKTAS,VISNEZADE MAH.,403,347,341,53,288
BESIKTAS,VISNEZADE MAH.,404,357,352,50,302
BESIKTAS,VISNEZADE MAH.,403,357,350,67,283
BESIKTAS,VISNEZADE MAH.,404,372,367,50,317
BESIKTAS,VISNEZADE MAH.,404,352,349,43,306
BESIKTAS,VISNEZADE MAH.,404,369,368,49,319
BESIKTAS,VISNEZADE MAH.,404,364,359,57,302
BESIKTAS,VISNEZADE MAH.,404,360,358,46,312
BESIKTAS,VISNEZADE MAH.,406,380,378,74,304
BESIKTAS,YILDIZ MAH.,402,324,319,50,269
BESIKTAS,YILDIZ MAH.,402,339,334,45,289
BESIKTAS,YILDIZ MAH.,402,352,345,56,289
BESIKTAS,YILDIZ MAH.,402,365,365,46,319
BESIKTAS,YILDIZ MAH.,402,361,358,55,303
BESIKTAS,YILDIZ MAH.,402,366,361,46,315
BESIKTAS,YILDIZ MAH.,403,360,357,61,296
BESIKTAS,YILDIZ MAH.,403,363,362,55,307
BESIKTAS,YILDIZ MAH.,402,367,363,60,303
BESIKTAS,YILDIZ MAH.,405,348,346,44,302
BESIKTAS,YILDIZ MAH.,402,359,356,60,296
GAZIOSMANPASA,BAGLARBASI MAH.,406,316,311,123,188
GAZIOSMANPASA,BAGLARBASI MAH.,406,313,310,126,184
GAZIOSMANPASA,BAGLARBASI MAH.,408,312,298,132,166
GAZIOSMANPASA,BAGLARBASI MAH.,405,341,339,162,177
GAZIOSMANPASA,BAGLARBASI MAH.,406,355,351,170,181
GAZIOSMANPASA,BAGLARBASI MAH.,406,360,358,143,215
GAZIOSMANPASA,BAGLARBASI MAH.,407,379,373,145,228
GAZIOSMANPASA,BAGLARBASI MAH.,405,346,342,140,202
GAZIOSMANPASA,BAGLARBASI MAH.,406,354,352,154,198
GAZIOSMANPASA,BAGLARBASI MAH.,407,347,342,157,185
GAZIOSMANPASA,BAGLARBASI MAH.,407,349,344,126,218
GAZIOSMANPASA,BAGLARBASI MAH.,405,357,353,148,205
GAZIOSMANPASA,BAGLARBASI MAH.,405,358,354,165,189
GAZIOSMANPASA,BAGLARBASI MAH.,405,366,362,121,241
GAZIOSMANPASA,BAGLARBASI MAH.,405,359,354,186,168
GAZIOSMANPASA,BAGLARBASI MAH.,406,352,343,148,195
GAZIOSMANPASA,BAGLARBASI MAH.,405,345,338,151,187
GAZIOSMANPASA,BAGLARBASI MAH.,406,367,364,149,215
GAZIOSMANPASA,BAGLARBASI MAH.,406,349,344,182,162
GAZIOSMANPASA,BAGLARBASI MAH.,405,358,354,158,196
GAZIOSMANPASA,BAGLARBASI MAH.,406,360,356,203,153
GAZIOSMANPASA,BAGLARBASI MAH.,405,361,358,161,197
GAZIOSMANPASA,BAGLARBASI MAH.,405,359,357,167,190
GAZIOSMANPASA,BAGLARBASI MAH.,406,360,352,148,204
GAZIOSMANPASA,BAGLARBASI MAH.,405,352,350,179,171
GAZIOSMANPASA,BAGLARBASI MAH.,406,359,355,174,181
GAZIOSMANPASA,BAGLARBASI MAH.,404,342,337,154,183
GAZIOSMANPASA,BAGLARBASI MAH.,406,359,358,161,197
GAZIOSMANPASA,BAGLARBASI MAH.,406,364,361,147,214
GAZIOSMANPASA,BAGLARBASI MAH.,404,355,351,160,191
GAZIOSMANPASA,BAGLARBASI MAH.,406,361,353,152,201
GAZIOSMANPASA,BAGLARBASI MAH.,402,299,293,137,156
GAZIOSMANPASA,BAGLARBASI MAH.,402,301,286,114,172
GAZIOSMANPASA,BAGLARBASI MAH.,402,348,343,172,171
GAZIOSMANPASA,BAGLARBASI MAH.,401,358,354,151,203
GAZIOSMANPASA,BAGLARBASI MAH.,404,366,364,166,198
GAZIOSMANPASA,BAGLARBASI MAH.,401,343,339,142,197
GAZIOSMANPASA,BAGLARBASI MAH.,401,342,341,157,184
GAZIOSMANPASA,BAGLARBASI MAH.,401,351,349,146,203
GAZIOSMANPASA,BAGLARBASI MAH.,400,355,352,153,199
GAZIOSMANPASA,BAGLARBASI MAH.,403,333,328,146,182
GAZIOSMANPASA,BAGLARBASI MAH.,401,368,364,216,148
GAZIOSMANPASA,BAGLARBASI MAH.,400,352,348,170,178
GAZIOSMANPASA,BAGLARBASI MAH.,400,323,319,159,160
GAZIOSMANPASA,BAGLARBASI MAH.,400,351,347,158,189
GAZIOSMANPASA,BAGLARBASI MAH.,401,350,343,159,184
GAZIOSMANPASA,BAGLARBASI MAH.,401,351,345,146,199
GAZIOSMANPASA,BAGLARBASI MAH.,400,352,348,144,204
GAZIOSMANPASA,BAGLARBASI MAH.,401,368,367,163,204
GAZIOSMANPASA,BAGLARBASI MAH.,401,351,348,144,204
GAZIOSMANPASA,BAGLARBASI MAH.,400,355,352,136,216
GAZIOSMANPASA,BAGLARBASI MAH.,401,339,331,159,172
GAZIOSMANPASA,BAGLARBASI MAH.,400,348,344,155,189
GAZIOSMANPASA,BAGLARBASI MAH.,401,367,361,164,197
GAZIOSMANPASA,BAGLARBASI MAH.,401,356,353,144,209
GAZIOSMANPASA,KARLITEPE MAH.,411,336,334,127,207
GAZIOSMANPASA,KARLITEPE MAH.,415,337,333,125,208
GAZIOSMANPASA,KARLITEPE MAH.,415,312,307,127,180
GAZIOSMANPASA,KARLITEPE MAH.,408,346,343,137,206
GAZIOSMANPASA,KARLITEPE MAH.,408,375,373,145,228
GAZIOSMANPASA,KARLITEPE MAH.,408,364,358,157,201
GAZIOSMANPASA,KARLITEPE MAH.,409,368,363,165,198
GAZIOSMANPASA,KARLITEPE MAH.,409,366,363,155,208
GAZIOSMANPASA,KARLITEPE MAH.,409,362,358,145,213
GAZIOSMANPASA,KARLITEPE MAH.,409,360,352,142,210
GAZIOSMANPASA,KARLITEPE MAH.,408,365,362,157,205
GAZIOSMANPASA,KARLITEPE MAH.,408,362,356,166,190
GAZIOSMANPASA,KARLITEPE MAH.,410,360,357,174,183
GAZIOSMANPASA,KARLITEPE MAH.,408,373,369,164,205
GAZIOSMANPASA,KARLITEPE MAH.,408,370,364,161,203
GAZIOSMANPASA,KARLITEPE MAH.,408,374,367,160,207
GAZIOSMANPASA,KARLITEPE MAH.,407,371,368,171,197
GAZIOSMANPASA,KARLITEPE MAH.,408,358,354,151,203
GAZIOSMANPASA,KARLITEPE MAH.,408,379,373,147,226
GAZIOSMANPASA,KARLITEPE MAH.,408,375,371,170,201
GAZIOSMANPASA,KARLITEPE MAH.,408,372,367,147,220
GAZIOSMANPASA,KARLITEPE MAH.,408,364,360,151,209
GAZIOSMANPASA,KARLITEPE MAH.,407,357,349,169,180
GAZIOSMANPASA,KARLITEPE MAH.,408,362,358,134,224
GAZIOSMANPASA,KARLITEPE MAH.,409,360,357,154,203
GAZIOSMANPASA,KARLITEPE MAH.,407,365,360,161,199
GAZIOSMANPASA,KARLITEPE MAH.,407,371,369,175,194
GAZIOSMANPASA,KARLITEPE MAH.,408,365,362,154,208
GAZIOSMANPASA,KARLITEPE MAH.,408,364,358,142,216
GAZIOSMANPASA,KARLITEPE MAH.,407,357,351,146,205
GAZIOSMANPASA,KARLITEPE MAH.,407,364,359,162,197
GAZIOSMANPASA,KARLITEPE MAH.,408,356,350,137,213
GAZIOSMANPASA,KARLITEPE MAH.,408,348,343,158,185
GAZIOSMANPASA,KARLITEPE MAH.,407,367,363,167,196
GAZIOSMANPASA,KARLITEPE MAH.,408,370,366,160,206
GAZIOSMANPASA,KARLITEPE MAH.,408,376,371,152,219
GAZIOSMANPASA,MERKEZ MAH.,395,289,286,104,182
GAZIOSMANPASA,MERKEZ MAH.,392,326,321,110,211
GAZIOSMANPASA,MERKEZ MAH.,391,338,336,121,215
GAZIOSMANPASA,MERKEZ MAH.,392,335,331,147,184
GAZIOSMANPASA,MERKEZ MAH.,391,339,334,136,198
GAZIOSMANPASA,MERKEZ MAH.,391,332,325,115,210
GAZIOSMANPASA,MERKEZ MAH.,391,333,325,140,185
GAZIOSMANPASA,MERKEZ MAH.,392,328,325,120,205
GAZIOSMANPASA,MERKEZ MAH.,394,338,334,141,193
GAZIOSMANPASA,MERKEZ MAH.,391,343,338,125,213
GAZIOSMANPASA,MERKEZ MAH.,392,339,331,128,203
GAZIOSMANPASA,MERKEZ MAH.,392,335,331,132,199
GAZIOSMANPASA,MERKEZ MAH.,392,341,340,135,205
GAZIOSMANPASA,MERKEZ MAH.,392,340,336,139,197
GAZIOSMANPASA,MERKEZ MAH.,392,328,323,126,197
GAZIOSMANPASA,MERKEZ MAH.,391,301,298,139,159
GAZIOSMANPASA,MERKEZ MAH.,391,330,326,122,204
GAZIOSMANPASA,MERKEZ MAH.,391,342,341,172,169
GAZIOSMANPASA,MERKEZ MAH.,391,347,341,127,214
GAZIOSMANPASA,MERKEZ MAH.,391,336,327,141,186
GAZIOSMANPASA,MERKEZ MAH.,391,332,328,139,189
GAZIOSMANPASA,MERKEZ MAH.,391,338,335,164,171
GAZIOSMANPASA,MERKEZ MAH.,391,337,333,160,173
GAZIOSMANPASA,MERKEZ MAH.,391,337,334,148,186
GAZIOSMANPASA,MERKEZ MAH.,390,343,337,153,184
GAZIOSMANPASA,MERKEZ MAH.,391,345,342,152,190
GAZIOSMANPASA,MERKEZ MAH.,391,325,323,137,186
GAZIOSMANPASA,MERKEZ MAH.,392,333,332,119,213
GAZIOSMANPASA,MERKEZ MAH.,391,346,343,157,186
GAZIOSMANPASA,MERKEZ MAH.,390,343,337,145,192
GAZIOSMANPASA,MERKEZ MAH.,403,308,306,130,176
GAZIOSMANPASA,MERKEZ MAH.,403,317,309,126,183
GAZIOSMANPASA,MERKEZ MAH.,402,315,310,129,181
GAZIOSMANPASA,MERKEZ MAH.,403,348,344,143,201
GAZIOSMANPASA,MERKEZ MAH.,402,367,362,138,224
GAZIOSMANPASA,MERKEZ MAH.,402,358,353,146,207
GAZIOSMANPASA,MERKEZ MAH.,404,355,351,159,192
GAZIOSMANPASA,MERKEZ MAH.,402,348,344,141,203
GAZIOSMANPASA,MERKEZ MAH.,401,351,346,145,201
GAZIOSMANPASA,MERKEZ MAH.,402,359,358,155,203
GAZIOSMANPASA,MERKEZ MAH.,402,362,359,155,204
GAZIOSMANPASA,MERKEZ MAH.,402,363,360,141,219
GAZIOSMANPASA,MERKEZ MAH.,403,354,350,142,208
GAZIOSMANPASA,MERKEZ MAH.,401,352,349,139,210
GAZIOSMANPASA,MERKEZ MAH.,402,353,352,128,224
GAZIOSMANPASA,MERKEZ MAH.,404,366,361,144,217
GAZIOSMANPASA,MERKEZ MAH.,401,340,339,127,212
GAZIOSMANPASA,MERKEZ MAH.,402,354,350,161,189
GAZIOSMANPASA,MERKEZ MAH.,403,358,355,180,175
GAZIOSMANPASA,MERKEZ MAH.,401,358,353,160,193
GAZIOSMANPASA,MERKEZ MAH.,401,334,328,132,196
GAZIOSMANPASA,MERKEZ MAH.,402,357,353,144,209
GAZIOSMANPASA,MERKEZ MAH.,402,357,353,125,228
GAZIOSMANPASA,MERKEZ MAH.,404,358,353,131,222
GAZIOSMANPASA,MERKEZ MAH.,402,365,357,152,205
GAZIOSMANPASA,PAZARICI MAH.,405,333,329,143,186
GAZIOSMANPASA,PAZARICI MAH.,405,311,302,100,202
GAZIOSMANPASA,PAZARICI MAH.,405,312,305,106,199
GAZIOSMANPASA,PAZARICI MAH.,405,370,366,169,197
GAZIOSMANPASA,PAZARICI MAH.,405,344,339,144,195
GAZIOSMANPASA,PAZARICI MAH.,406,365,359,155,204
GAZIOSMANPASA,PAZARICI MAH.,404,370,368,174,194
GAZIOSMANPASA,PAZARICI MAH.,405,357,354,131,223
GAZIOSMANPASA,PAZARICI MAH.,405,375,367,162,205
GAZIOSMANPASA,PAZARICI MAH.,405,363,353,142,211
GAZIOSMANPASA,PAZARICI MAH.,404,356,349,154,195
GAZIOSMANPASA,PAZARICI MAH.,405,364,363,145,218
GAZIOSMANPASA,PAZARICI MAH.,405,356,352,151,201
GAZIOSMANPASA,PAZARICI MAH.,407,369,363,161,202
GAZIOSMANPASA,PAZARICI MAH.,405,348,343,157,186
GAZIOSMANPASA,PAZARICI MAH.,404,351,348,141,207
GAZIOSMANPASA,PAZARICI MAH.,405,350,346,152,194
GAZIOSMANPASA,PAZARICI MAH.,405,354,351,153,198
GAZIOSMANPASA,PAZARICI MAH.,405,359,352,145,207
GAZIOSMANPASA,PAZARICI MAH.,405,352,344,134,210
GAZIOSMANPASA,PAZARICI MAH.,404,352,349,135,214
GAZIOSMANPASA,PAZARICI MAH.,405,356,351,136,215
GAZIOSMANPASA,PAZARICI MAH.,404,359,351,150,201
GAZIOSMANPASA,PAZARICI MAH.,405,363,360,172,188
GAZIOSMANPASA,SARIGOL MAH.,415,322,315,144,171
GAZIOSMANPASA,SARIGOL MAH.,415,329,320,144,176
GAZIOSMANPASA,SARIGOL MAH.,415,317,312,147,165
GAZIOSMANPASA,SARIGOL MAH.,415,330,327,149,178
GAZIOSMANPASA,SARIGOL MAH.,415,330,325,127,198
GAZIOSMANPASA,SARIGOL MAH.,415,357,352,141,211
GAZIOSMANPASA,SARIGOL MAH.,415,364,360,158,202
GAZIOSMANPASA,SARIGOL MAH.,415,363,358,169,189
GAZIOSMANPASA,SARIGOL MAH.,415,358,352,184,168
GAZIOSMANPASA,SARIGOL MAH.,415,366,359,159,200
GAZIOSMANPASA,SARIGOL MAH.,415,351,345,180,165
GAZIOSMANPASA,SARIGOL MAH.,415,358,353,167,186
GAZIOSMANPASA,SARIGOL MAH.,415,359,351,177,174
GAZIOSMANPASA,SARIGOL MAH.,412,357,354,147,207
GAZIOSMANPASA,SARIGOL MAH.,412,353,343,178,165
GAZIOSMANPASA,SARIGOL MAH.,412,354,347,168,179
GAZIOSMANPASA,SARIGOL MAH.,412,352,341,160,181
GAZIOSMANPASA,SARIGOL MAH.,411,365,363,152,211
GAZIOSMANPASA,SARIGOL MAH.,415,352,350,153,197
GAZIOSMANPASA,SARIGOL MAH.,412,361,361,157,204
GAZIOSMANPASA,SARIGOL MAH.,412,377,371,189,182
GAZIOSMANPASA,SARIGOL MAH.,412,355,353,135,218
GAZIOSMANPASA,SARIGOL MAH.,410,346,338,160,178
GAZIOSMANPASA,SARIGOL MAH.,415,338,331,149,182
GAZIOSMANPASA,SARIGOL MAH.,415,362,355,163,192
GAZIOSMANPASA,SARIGOL MAH.,415,365,359,193,166
GAZIOSMANPASA,SARIGOL MAH.,415,371,369,169,200
GAZIOSMANPASA,SARIGOL MAH.,412,358,355,157,198
GAZIOSMANPASA,SARIGOL MAH.,410,354,352,152,200
GAZIOSMANPASA,SARIGOL MAH.,412,355,352,158,194
GAZIOSMANPASA,SARIGOL MAH.,412,349,344,156,188
GAZIOSMANPASA,SARIGOL MAH.,415,368,364,160,204
GAZIOSMANPASA,SARIGOL MAH.,411,340,334,160,174
GAZIOSMANPASA,SARIGOL MAH.,415,339,335,137,198
GAZIOSMANPASA,SARIGOL MAH.,415,342,339,132,207
GAZIOSMANPASA,SARIGOL MAH.,415,365,359,216,143
GAZIOSMANPASA,SARIGOL MAH.,413,368,366,191,175
GAZIOSMANPASA,SARIGOL MAH.,412,346,339,137,202
GAZIOSMANPASA,SARIGOL MAH.,413,353,351,178,173
GAZIOSMANPASA,SARIGOL MAH.,413,369,365,191,174
GAZIOSMANPASA,SARIGOL MAH.,413,351,348,161,187
GAZIOSMANPASA,SARIGOL MAH.,409,341,336,145,191
GAZIOSMANPASA,SARIGOL MAH.,412,346,343,166,177
GAZIOSMANPASA,SARIGOL MAH.,412,354,346,191,155
GAZIOSMANPASA,SARIGOL MAH.,410,358,354,172,182
GAZIOSMANPASA,YENIDOGAN MAH.,404,294,291,120,171
GAZIOSMANPASA,YENIDOGAN MAH.,406,299,295,119,176
GAZIOSMANPASA,YENIDOGAN MAH.,405,332,328,154,174
GAZIOSMANPASA,YENIDOGAN MAH.,407,350,348,159,189
GAZIOSMANPASA,YENIDOGAN MAH.,404,366,362,147,215
GAZIOSMANPASA,YENIDOGAN MAH.,405,344,340,135,205
GAZIOSMANPASA,YENIDOGAN MAH.,405,355,353,149,204
GAZIOSMANPASA,YENIDOGAN MAH.,404,355,353,164,189
GAZIOSMANPASA,YENIDOGAN MAH.,405,350,347,145,202
GAZIOSMANPASA,YENIDOGAN MAH.,404,351,344,160,184
GAZIOSMANPASA,YENIDOGAN MAH.,405,360,353,173,180
GAZIOSMANPASA,YENIDOGAN MAH.,405,358,356,146,210
GAZIOSMANPASA,YENIDOGAN MAH.,405,355,345,140,205
GAZIOSMANPASA,YENIDOGAN MAH.,404,347,344,152,192
GAZIOSMANPASA,YENIDOGAN MAH.,405,352,341,156,185
GAZIOSMANPASA,YENIDOGAN MAH.,405,365,363,166,197
GAZIOSMANPASA,YENIDOGAN MAH.,404,350,346,159,187
GAZIOSMANPASA,YILDIZTABYA MAH.,391,295,289,135,154
GAZIOSMANPASA,YILDIZTABYA MAH.,390,321,317,174,143
GAZIOSMANPASA,YILDIZTABYA MAH.,390,349,344,209,135
GAZIOSMANPASA,YILDIZTABYA MAH.,389,336,333,173,160
GAZIOSMANPASA,YILDIZTABYA MAH.,391,350,347,189,158
GAZIOSMANPASA,YILDIZTABYA MAH.,391,349,347,190,157
GAZIOSMANPASA,YILDIZTABYA MAH.,393,336,335,169,166
GAZIOSMANPASA,YILDIZTABYA MAH.,391,332,326,182,144
GAZIOSMANPASA,YILDIZTABYA MAH.,391,323,320,175,145
GAZIOSMANPASA,YILDIZTABYA MAH.,390,329,328,173,155
GAZIOSMANPASA,YILDIZTABYA MAH.,390,327,327,158,169
GAZIOSMANPASA,YILDIZTABYA MAH.,389,308,302,148,154
GAZIOSMANPASA,YILDIZTABYA MAH.,389,325,321,148,173
GAZIOSMANPASA,YILDIZTABYA MAH.,390,358,355,171,184
GAZIOSMANPASA,YILDIZTABYA MAH.,390,349,346,155,191
GAZIOSMANPASA,YILDIZTABYA MAH.,388,349,343,193,150
GAZIOSMANPASA,YILDIZTABYA MAH.,389,345,343,162,181
GAZIOSMANPASA,YILDIZTABYA MAH.,389,347,347,178,169
GAZIOSMANPASA,YILDIZTABYA MAH.,388,355,352,166,186
GAZIOSMANPASA,YILDIZTABYA MAH.,389,348,343,171,172
GAZIOSMANPASA,YILDIZTABYA MAH.,388,352,343,181,162
GAZIOSMANPASA,YILDIZTABYA MAH.,390,352,345,197,148
GAZIOSMANPASA,YILDIZTABYA MAH.,389,338,337,163,174
GAZIOSMANPASA,YILDIZTABYA MAH.,389,338,333,173,160
GAZIOSMANPASA,YILDIZTABYA MAH.,388,352,350,175,175
GAZIOSMANPASA,YILDIZTABYA MAH.,389,342,339,193,146
GAZIOSMANPASA,YILDIZTABYA MAH.,415,316,310,144,166
GAZIOSMANPASA,YILDIZTABYA MAH.,410,327,320,135,185
GAZIOSMANPASA,YILDIZTABYA MAH.,410,372,367,211,156
GAZIOSMANPASA,YILDIZTABYA MAH.,415,376,365,211,154
GAZIOSMANPASA,YILDIZTABYA MAH.,409,364,360,190,170
GAZIOSMANPASA,YILDIZTABYA MAH.,414,372,366,181,185
GAZIOSMANPASA,YILDIZTABYA MAH.,411,368,362,207,155
GAZIOSMANPASA,YILDIZTABYA MAH.,410,354,351,192,159
GAZIOSMANPASA,YILDIZTABYA MAH.,410,373,370,210,160
GAZIOSMANPASA,YILDIZTABYA MAH.,409,371,368,181,187
GAZIOSMANPASA,YILDIZTABYA MAH.,410,365,362,159,203
GAZIOSMANPASA,YILDIZTABYA MAH.,410,378,374,198,176
GAZIOSMANPASA,YILDIZTABYA MAH.,410,366,362,179,183
GAZIOSMANPASA,YILDIZTABYA MAH.,410,378,377,195,182
GAZIOSMANPASA,YILDIZTABYA MAH.,410,356,354,159,195
GAZIOSMANPASA,YILDIZTABYA MAH.,410,363,357,167,190
GAZIOSMANPASA,YILDIZTABYA MAH.,410,349,342,181,161
GAZIOSMANPASA,YILDIZTABYA MAH.,409,362,359,188,171
GAZIOSMANPASA,YILDIZTABYA MAH.,410,343,340,190,150
GAZIOSMANPASA,YILDIZTABYA MAH.,410,369,367,200,167
GAZIOSMANPASA,YILDIZTABYA MAH.,409,357,352,181,171
GAZIOSMANPASA,YILDIZTABYA MAH.,409,367,362,179,183
GAZIOSMANPASA,BARBAROS HAYRETTIN PASA MAH.,409,349,341,225,116
GAZIOSMANPASA,BARBAROS HAYRETTIN PASA MAH.,409,330,321,189,132
GAZIOSMANPASA,BARBAROS HAYRETTIN PASA MAH.,415,365,360,250,110
GAZIOSMANPASA,BARBAROS HAYRETTIN PASA MAH.,409,364,360,246,114
GAZIOSMANPASA,BARBAROS HAYRETTIN PASA MAH.,408,374,366,242,124
GAZIOSMANPASA,BARBAROS HAYRETTIN PASA MAH.,409,370,367,232,135
GAZIOSMANPASA,BARBAROS HAYRETTIN PASA MAH.,409,368,367,231,136
GAZIOSMANPASA,BARBAROS HAYRETTIN PASA MAH.,410,369,365,262,103
GAZIOSMANPASA,BARBAROS HAYRETTIN PASA MAH.,409,361,360,270,90
GAZIOSMANPASA,BARBAROS HAYRETTIN PASA MAH.,411,362,358,261,97
GAZIOSMANPASA,BARBAROS HAYRETTIN PASA MAH.,408,358,355,251,104
GAZIOSMANPASA,BARBAROS HAYRETTIN PASA MAH.,409,356,353,227,126
GAZIOSMANPASA,BARBAROS HAYRETTIN PASA MAH.,409,370,365,225,140
GAZIOSMANPASA,BARBAROS HAYRETTIN PASA MAH.,409,371,368,235,133
GAZIOSMANPASA,BARBAROS HAYRETTIN PASA MAH.,409,356,354,261,93
GAZIOSMANPASA,BARBAROS HAYRETTIN PASA MAH.,409,365,357,229,128
GAZIOSMANPASA,BARBAROS HAYRETTIN PASA MAH.,409,364,359,258,101
GAZIOSMANPASA,BARBAROS HAYRETTIN PASA MAH.,409,373,371,267,104
GAZIOSMANPASA,BARBAROS HAYRETTIN PASA MAH.,409,369,366,248,118
GAZIOSMANPASA,BARBAROS HAYRETTIN PASA MAH.,409,377,366,254,112
GAZIOSMANPASA,BARBAROS HAYRETTIN PASA MAH.,411,339,332,247,85
GAZIOSMANPASA,BARBAROS HAYRETTIN PASA MAH.,411,329,324,237,87
GAZIOSMANPASA,BARBAROS HAYRETTIN PASA MAH.,415,363,359,246,113
GAZIOSMANPASA,BARBAROS HAYRETTIN PASA MAH.,411,372,369,257,112
GAZIOSMANPASA,BARBAROS HAYRETTIN PASA MAH.,411,364,360,273,87
GAZIOSMANPASA,BARBAROS HAYRETTIN PASA MAH.,411,372,370,251,119
GAZIOSMANPASA,BARBAROS HAYRETTIN PASA MAH.,412,378,374,281,93
GAZIOSMANPASA,BARBAROS HAYRETTIN PASA MAH.,411,381,378,252,126
GAZIOSMANPASA,BARBAROS HAYRETTIN PASA MAH.,411,364,360,244,116
GAZIOSMANPASA,BARBAROS HAYRETTIN PASA MAH.,411,374,369,281,88
GAZIOSMANPASA,BARBAROS HAYRETTIN PASA MAH.,411,361,357,271,86
GAZIOSMANPASA,BARBAROS HAYRETTIN PASA MAH.,411,357,354,272,82
GAZIOSMANPASA,BARBAROS HAYRETTIN PASA MAH.,410,365,360,276,84
GAZIOSMANPASA,BARBAROS HAYRETTIN PASA MAH.,410,349,345,265,80
GAZIOSMANPASA,BARBAROS HAYRETTIN PASA MAH.,411,368,366,253,113
GAZIOSMANPASA,BARBAROS HAYRETTIN PASA MAH.,410,366,358,257,101
GAZIOSMANPASA,BARBAROS HAYRETTIN PASA MAH.,410,366,360,263,97
GAZIOSMANPASA,BARBAROS HAYRETTIN PASA MAH.,411,354,350,244,106
GAZIOSMANPASA,BARBAROS HAYRETTIN PASA MAH.,411,355,353,262,91
GAZIOSMANPASA,BARBAROS HAYRETTIN PASA MAH.,410,360,360,254,106
GAZIOSMANPASA,BARBAROS HAYRETTIN PASA MAH.,411,366,363,260,103
GAZIOSMANPASA,BARBAROS HAYRETTIN PASA MAH.,415,327,320,229,91
GAZIOSMANPASA,BARBAROS HAYRETTIN PASA MAH.,409,340,332,256,76
GAZIOSMANPASA,BARBAROS HAYRETTIN PASA MAH.,415,368,364,248,116
GAZIOSMANPASA,BARBAROS HAYRETTIN PASA MAH.,409,367,365,263,102
GAZIOSMANPASA,BARBAROS HAYRETTIN PASA MAH.,409,371,363,272,91
GAZIOSMANPASA,BARBAROS HAYRETTIN PASA MAH.,408,366,363,281,82
GAZIOSMANPASA,BARBAROS HAYRETTIN PASA MAH.,409,374,367,274,93
GAZIOSMANPASA,BARBAROS HAYRETTIN PASA MAH.,408,377,375,288,87
GAZIOSMANPASA,BARBAROS HAYRETTIN PASA MAH.,409,367,361,270,91
GAZIOSMANPASA,BARBAROS HAYRETTIN PASA MAH.,410,350,342,261,81
GAZIOSMANPASA,BARBAROS HAYRETTIN PASA MAH.,409,366,362,255,107
GAZIOSMANPASA,BARBAROS HAYRETTIN PASA MAH.,408,376,374,260,114
GAZIOSMANPASA,BARBAROS HAYRETTIN PASA MAH.,409,367,364,259,105
GAZIOSMANPASA,BARBAROS HAYRETTIN PASA MAH.,409,359,357,262,95
GAZIOSMANPASA,BARBAROS HAYRETTIN PASA MAH.,408,352,347,247,100
GAZIOSMANPASA,BARBAROS HAYRETTIN PASA MAH.,408,362,361,264,97
GAZIOSMANPASA,BARBAROS HAYRETTIN PASA MAH.,408,358,348,262,86
GAZIOSMANPASA,BARBAROS HAYRETTIN PASA MAH.,409,353,348,248,100
GAZIOSMANPASA,BARBAROS HAYRETTIN PASA MAH.,407,373,368,261,107
GAZIOSMANPASA,BARBAROS HAYRETTIN PASA MAH.,409,371,367,297,70
GAZIOSMANPASA,BARBAROS HAYRETTIN PASA MAH.,409,364,357,251,106
GAZIOSMANPASA,BARBAROS HAYRETTIN PASA MAH.,409,367,363,275,88
GAZIOSMANPASA,BARBAROS HAYRETTIN PASA MAH.,415,327,325,234,91
GAZIOSMANPASA,BARBAROS HAYRETTIN PASA MAH.,412,331,324,203,121
GAZIOSMANPASA,BARBAROS HAYRETTIN PASA MAH.,411,361,352,226,126
GAZIOSMANPASA,BARBAROS HAYRETTIN PASA MAH.,415,360,354,230,124
GAZIOSMANPASA,BARBAROS HAYRETTIN PASA MAH.,415,365,362,237,125
GAZIOSMANPASA,BARBAROS HAYRETTIN PASA MAH.,410,369,363,229,134
GAZIOSMANPASA,BARBAROS HAYRETTIN PASA MAH.,415,371,368,244,124
GAZIOSMANPASA,BARBAROS HAYRETTIN PASA MAH.,415,375,370,258,112
GAZIOSMANPASA,BARBAROS HAYRETTIN PASA MAH.,411,362,358,247,111
GAZIOSMANPASA,BARBAROS HAYRETTIN PASA MAH.,411,374,367,225,142
GAZIOSMANPASA,BARBAROS HAYRETTIN PASA MAH.,412,376,371,236,135
GAZIOSMANPASA,BARBAROS HAYRETTIN PASA MAH.,412,371,365,236,129
GAZIOSMANPASA,BARBAROS HAYRETTIN PASA MAH.,410,369,361,210,151
GAZIOSMANPASA,BARBAROS HAYRETTIN PASA MAH.,412,364,358,248,110
GAZIOSMANPASA,BARBAROS HAYRETTIN PASA MAH.,412,362,360,241,119
GAZIOSMANPASA,BARBAROS HAYRETTIN PASA MAH.,410,364,361,235,126
GAZIOSMANPASA,BARBAROS HAYRETTIN PASA MAH.,411,362,359,234,125
GAZIOSMANPASA,BARBAROS HAYRETTIN PASA MAH.,410,364,357,245,112
GAZIOSMANPASA,BARBAROS HAYRETTIN PASA MAH.,411,364,356,238,118
GAZIOSMANPASA,BARBAROS HAYRETTIN PASA MAH.,411,342,338,217,121
GAZIOSMANPASA,BARBAROS HAYRETTIN PASA MAH.,410,369,365,235,130
GAZIOSMANPASA,BARBAROS HAYRETTIN PASA MAH.,412,356,349,239,110
GAZIOSMANPASA,BARBAROS HAYRETTIN PASA MAH.,410,359,354,216,138
GAZIOSMANPASA,BARBAROS HAYRETTIN PASA MAH.,411,379,374,227,147
GAZIOSMANPASA,FEVZI CAKMAK MAH.,403,332,326,200,126
GAZIOSMANPASA,FEVZI CAKMAK MAH.,403,356,352,189,163
GAZIOSMANPASA,FEVZI CAKMAK MAH.,403,355,350,199,151
GAZIOSMANPASA,FEVZI CAKMAK MAH.,407,366,355,212,143
GAZIOSMANPASA,FEVZI CAKMAK MAH.,403,373,367,246,121
GAZIOSMANPASA,FEVZI CAKMAK MAH.,403,365,364,206,158
GAZIOSMANPASA,FEVZI CAKMAK MAH.,401,362,361,229,132
GAZIOSMANPASA,FEVZI CAKMAK MAH.,401,358,350,220,130
GAZIOSMANPASA,FEVZI CAKMAK MAH.,401,361,359,224,135
GAZIOSMANPASA,FEVZI CAKMAK MAH.,403,356,353,214,139
GAZIOSMANPASA,FEVZI CAKMAK MAH.,402,360,349,211,138
GAZIOSMANPASA,FEVZI CAKMAK MAH.,403,360,357,203,154
GAZIOSMANPASA,FEVZI CAKMAK MAH.,402,371,369,231,138
GAZIOSMANPASA,FEVZI CAKMAK MAH.,403,364,362,224,138
GAZIOSMANPASA,FEVZI CAKMAK MAH.,402,370,365,216,149
GAZIOSMANPASA,FEVZI CAKMAK MAH.,403,352,343,205,138
GAZIOSMANPASA,FEVZI CAKMAK MAH.,408,346,337,241,96
GAZIOSMANPASA,FEVZI CAKMAK MAH.,408,346,339,233,106
GAZIOSMANPASA,FEVZI CAKMAK MAH.,408,370,365,227,138
GAZIOSMANPASA,FEVZI CAKMAK MAH.,410,376,372,248,124
GAZIOSMANPASA,FEVZI CAKMAK MAH.,408,374,372,245,127
GAZIOSMANPASA,FEVZI CAKMAK MAH.,410,369,361,258,103
GAZIOSMANPASA,FEVZI CAKMAK MAH.,408,373,367,267,100
GAZIOSMANPASA,FEVZI CAKMAK MAH.,407,378,371,251,120
GAZIOSMANPASA,FEVZI CAKMAK MAH.,407,383,375,247,128
GAZIOSMANPASA,FEVZI CAKMAK MAH.,407,359,357,231,126
GAZIOSMANPASA,FEVZI CAKMAK MAH.,407,356,351,233,118
GAZIOSMANPASA,FEVZI CAKMAK MAH.,407,372,366,240,126
GAZIOSMANPASA,FEVZI CAKMAK MAH.,407,368,362,243,119
GAZIOSMANPASA,FEVZI CAKMAK MAH.,407,370,366,237,129
GAZIOSMANPASA,FEVZI CAKMAK MAH.,408,369,363,258,105
GAZIOSMANPASA,FEVZI CAKMAK MAH.,407,372,370,257,113
GAZIOSMANPASA,FEVZI CAKMAK MAH.,408,370,367,215,152
GAZIOSMANPASA,FEVZI CAKMAK MAH.,408,382,378,271,107
GAZIOSMANPASA,FEVZI CAKMAK MAH.,407,365,361,228,133
GAZIOSMANPASA,FEVZI CAKMAK MAH.,408,366,361,239,122
GAZIOSMANPASA,FEVZI CAKMAK MAH.,407,377,371,250,121
GAZIOSMANPASA,FEVZI CAKMAK MAH.,410,356,346,219,127
GAZIOSMANPASA,FEVZI CAKMAK MAH.,408,372,366,229,137
GAZIOSMANPASA,HURRIYET MAH.,406,337,329,191,138
GAZIOSMANPASA,HURRIYET MAH.,405,348,343,189,154
GAZIOSMANPASA,HURRIYET MAH.,405,368,362,218,144
GAZIOSMANPASA,HURRIYET MAH.,405,371,366,196,170
GAZIOSMANPASA,HURRIYET MAH.,405,362,355,202,153
GAZIOSMANPASA,HURRIYET MAH.,405,352,350,214,136
GAZIOSMANPASA,HURRIYET MAH.,405,360,355,208,147
GAZIOSMANPASA,HURRIYET MAH.,407,360,358,203,155
GAZIOSMANPASA,HURRIYET MAH.,405,373,371,220,151
GAZIOSMANPASA,HURRIYET MAH.,406,375,369,230,139
GAZIOSMANPASA,HURRIYET MAH.,405,373,366,214,152
GAZIOSMANPASA,HURRIYET MAH.,408,370,368,242,126
GAZIOSMANPASA,HURRIYET MAH.,404,351,349,201,148
GAZIOSMANPASA,HURRIYET MAH.,405,357,351,191,160
GAZIOSMANPASA,HURRIYET MAH.,404,369,362,200,162
GAZIOSMANPASA,HURRIYET MAH.,402,331,325,196,129
GAZIOSMANPASA,HURRIYET MAH.,403,331,327,151,176
GAZIOSMANPASA,HURRIYET MAH.,402,375,369,229,140
GAZIOSMANPASA,HURRIYET MAH.,402,360,357,192,165
GAZIOSMANPASA,HURRIYET MAH.,403,367,364,196,168
GAZIOSMANPASA,HURRIYET MAH.,403,364,357,182,175
GAZIOSMANPASA,HURRIYET MAH.,403,370,368,189,179
GAZIOSMANPASA,HURRIYET MAH.,403,368,364,191,173
GAZIOSMANPASA,HURRIYET MAH.,403,363,358,216,142
GAZIOSMANPASA,HURRIYET MAH.,403,376,374,205,169
GAZIOSMANPASA,HURRIYET MAH.,404,376,374,215,159
GAZIOSMANPASA,HURRIYET MAH.,405,362,361,202,159
GAZIOSMANPASA,HURRIYET MAH.,403,353,345,194,151
GAZIOSMANPASA,HURRIYET MAH.,404,360,357,174,183
GAZIOSMANPASA,HURRIYET MAH.,403,356,352,185,167
GAZIOSMANPASA,HURRIYET MAH.,402,379,374,184,190
GAZIOSMANPASA,HURRIYET MAH.,402,374,371,187,184
GAZIOSMANPASA,HURRIYET MAH.,402,366,360,165,195
GAZIOSMANPASA,HURRIYET MAH.,402,368,361,190,171
GAZIOSMANPASA,HURRIYET MAH.,402,364,357,205,152
GAZIOSMANPASA,HURRIYET MAH.,411,357,352,223,129
GAZIOSMANPASA,HURRIYET MAH.,415,345,337,211,126
GAZIOSMANPASA,HURRIYET MAH.,415,369,364,213,151
GAZIOSMANPASA,HURRIYET MAH.,412,376,369,192,177
GAZIOSMANPASA,HURRIYET MAH.,415,375,373,222,151
GAZIOSMANPASA,HURRIYET MAH.,411,373,370,206,164
GAZIOSMANPASA,HURRIYET MAH.,412,368,364,224,140
GAZIOSMANPASA,HURRIYET MAH.,411,372,367,235,132
GAZIOSMANPASA,HURRIYET MAH.,412,367,365,210,155
GAZIOSMANPASA,HURRIYET MAH.,412,376,372,221,151
GAZIOSMANPASA,HURRIYET MAH.,411,369,366,219,147
GAZIOSMANPASA,HURRIYET MAH.,412,364,359,223,136
GAZIOSMANPASA,HURRIYET MAH.,412,377,372,216,156
GAZIOSMANPASA,HURRIYET MAH.,412,377,372,223,149
GAZIOSMANPASA,HURRIYET MAH.,415,376,373,221,152
GAZIOSMANPASA,HURRIYET MAH.,415,372,368,232,136
GAZIOSMANPASA,HURRIYET MAH.,411,359,355,192,163
GAZIOSMANPASA,SEMSIPASA MAH.,409,333,324,173,151
GAZIOSMANPASA,SEMSIPASA MAH.,409,322,314,144,170
GAZIOSMANPASA,SEMSIPASA MAH.,409,368,363,155,208
GAZIOSMANPASA,SEMSIPASA MAH.,412,354,347,193,154
GAZIOSMANPASA,SEMSIPASA MAH.,409,369,369,177,192
GAZIOSMANPASA,SEMSIPASA MAH.,409,368,365,185,180
GAZIOSMANPASA,SEMSIPASA MAH.,409,373,371,177,194
GAZIOSMANPASA,SEMSIPASA MAH.,409,354,351,164,187
GAZIOSMANPASA,SEMSIPASA MAH.,410,364,359,188,171
GAZIOSMANPASA,SEMSIPASA MAH.,409,342,337,146,191
GAZIOSMANPASA,SEMSIPASA MAH.,408,365,363,173,190
GAZIOSMANPASA,SEMSIPASA MAH.,409,351,347,170,177
GAZIOSMANPASA,SEMSIPASA MAH.,408,369,368,180,188
GAZIOSMANPASA,SEMSIPASA MAH.,409,373,368,185,183
GAZIOSMANPASA,SEMSIPASA MAH.,409,366,363,177,186
GAZIOSMANPASA,SEMSIPASA MAH.,408,362,355,184,171
GAZIOSMANPASA,SEMSIPASA MAH.,409,349,343,146,197
GAZIOSMANPASA,SEMSIPASA MAH.,409,354,348,154,194
GAZIOSMANPASA,SEMSIPASA MAH.,409,358,353,189,164
GAZIOSMANPASA,SEMSIPASA MAH.,409,357,352,162,190
GAZIOSMANPASA,SEMSIPASA MAH.,410,351,345,212,133
GAZIOSMANPASA,SEMSIPASA MAH.,410,329,318,200,118
GAZIOSMANPASA,SEMSIPASA MAH.,415,351,347,189,158
GAZIOSMANPASA,SEMSIPASA MAH.,410,356,351,221,130
GAZIOSMANPASA,SEMSIPASA MAH.,409,353,351,209,142
GAZIOSMANPASA,SEMSIPASA MAH.,410,364,359,224,135
GAZIOSMANPASA,SEMSIPASA MAH.,409,360,354,232,122
GAZIOSMANPASA,SEMSIPASA MAH.,410,379,371,230,141
GAZIOSMANPASA,SEMSIPASA MAH.,408,363,360,245,115
GAZIOSMANPASA,SEMSIPASA MAH.,409,368,367,214,153
GAZIOSMANPASA,SEMSIPASA MAH.,409,379,375,233,142
GAZIOSMANPASA,SEMSIPASA MAH.,408,357,355,220,135
GAZIOSMANPASA,SEMSIPASA MAH.,408,371,369,221,148
GAZIOSMANPASA,SEMSIPASA MAH.,409,356,353,219,134
GAZIOSMANPASA,SEMSIPASA MAH.,408,357,353,190,163
GAZIOSMANPASA,SEMSIPASA MAH.,408,353,347,231,116
GAZIOSMANPASA,SEMSIPASA MAH.,409,367,360,231,129
GAZIOSMANPASA,SEMSIPASA MAH.,408,380,373,242,131
GAZIOSMANPASA,SEMSIPASA MAH.,408,369,365,225,140
GAZIOSMANPASA,SEMSIPASA MAH.,408,378,371,255,116
GAZIOSMANPASA,SEMSIPASA MAH.,408,368,367,237,130
GAZIOSMANPASA,SEMSIPASA MAH.,409,358,355,214,141
GAZIOSMANPASA,SEMSIPASA MAH.,408,351,348,216,132
GAZIOSMANPASA,SEMSIPASA MAH.,409,381,372,234,138
GAZIOSMANPASA,YENI MAHALLE MAH.,403,336,330,214,116
GAZIOSMANPASA,YENI MAHALLE MAH.,406,338,329,168,161
GAZIOSMANPASA,YENI MAHALLE MAH.,403,328,323,169,154
GAZIOSMANPASA,YENI MAHALLE MAH.,403,361,357,201,156
GAZIOSMANPASA,YENI MAHALLE MAH.,403,350,346,189,157
GAZIOSMANPASA,YENI MAHALLE MAH.,403,360,353,184,169
GAZIOSMANPASA,YENI MAHALLE MAH.,404,350,344,190,154
GAZIOSMANPASA,YENI MAHALLE MAH.,403,361,360,210,150
GAZIOSMANPASA,YENI MAHALLE MAH.,403,369,359,224,135
GAZIOSMANPASA,YENI MAHALLE MAH.,403,363,360,211,149
GAZIOSMANPASA,YENI MAHALLE MAH.,403,375,368,209,159
GAZIOSMANPASA,YENI MAHALLE MAH.,406,367,356,213,143
GAZIOSMANPASA,YENI MAHALLE MAH.,403,348,345,218,127
GAZIOSMANPASA,YENI MAHALLE MAH.,404,357,355,207,148
GAZIOSMANPASA,YENI MAHALLE MAH.,406,347,345,229,116
GAZIOSMANPASA,YENI MAHALLE MAH.,407,370,363,225,138
GAZIOSMANPASA,YENI MAHALLE MAH.,403,360,355,210,145
GAZIOSMANPASA,YENI MAHALLE MAH.,402,355,350,209,141
GAZIOSMANPASA,YENI MAHALLE MAH.,403,361,351,193,158
GAZIOSMANPASA,YENI MAHALLE MAH.,402,337,332,208,124
GAZIOSMANPASA,YENI MAHALLE MAH.,402,365,363,224,139
GAZIOSMANPASA,YENI MAHALLE MAH.,402,359,356,195,161
GAZIOSMANPASA,YENI MAHALLE MAH.,403,359,356,225,131
GAZIOSMANPASA,YENI MAHALLE MAH.,403,355,352,223,129
GAZIOSMANPASA,YENI MAHALLE MAH.,403,356,349,188,161
GAZIOSMANPASA,YENI MAHALLE MAH.,402,353,346,207,139
GAZIOSMANPASA,YENI MAHALLE MAH.,403,361,353,226,127
GAZIOSMANPASA,YENI MAHALLE MAH.,403,363,360,197,163
GAZIOSMANPASA,YENI MAHALLE MAH.,402,354,346,184,162
GAZIOSMANPASA,YENI MAHALLE MAH.,415,347,341,220,121
GAZIOSMANPASA,YENI MAHALLE MAH.,415,359,354,248,106
GAZIOSMANPASA,YENI MAHALLE MAH.,408,374,372,261,111
GAZIOSMANPASA,YENI MAHALLE MAH.,410,359,350,222,128
GAZIOSMANPASA,YENI MAHALLE MAH.,409,367,360,239,121
GAZIOSMANPASA,YENI MAHALLE MAH.,409,375,372,249,123
GAZIOSMANPASA,YENI MAHALLE MAH.,410,366,359,221,138
GAZIOSMANPASA,YENI MAHALLE MAH.,410,372,368,234,134
GAZIOSMANPASA,YENI MAHALLE MAH.,408,370,365,256,109
GAZIOSMANPASA,YENI MAHALLE MAH.,409,353,342,229,113
GAZIOSMANPASA,YENI MAHALLE MAH.,409,360,354,246,108
GAZIOSMANPASA,YENI MAHALLE MAH.,410,375,371,268,103
GAZIOSMANPASA,YENI MAHALLE MAH.,409,366,363,235,128
GAZIOSMANPASA,YENI MAHALLE MAH.,407,355,351,243,108
GAZIOSMANPASA,YENI MAHALLE MAH.,410,378,367,226,141
GAZIOSMANPASA,YENI MAHALLE MAH.,409,362,356,229,127
GAZIOSMANPASA,YENI MAHALLE MAH.,409,378,373,257,116
GAZIOSMANPASA,YENI MAHALLE MAH.,410,341,333,201,132
GAZIOSMANPASA,YENI MAHALLE MAH.,415,347,338,213,125
GAZIOSMANPASA,YENI MAHALLE MAH.,415,361,357,209,148
GAZIOSMANPASA,YENI MAHALLE MAH.,412,365,361,233,128
GAZIOSMANPASA,YENI MAHALLE MAH.,412,376,368,238,130
GAZIOSMANPASA,YENI MAHALLE MAH.,411,359,352,237,115
GAZIOSMANPASA,YENI MAHALLE MAH.,410,369,364,230,134
GAZIOSMANPASA,YENI MAHALLE MAH.,415,370,367,220,147
GAZIOSMANPASA,YENI MAHALLE MAH.,412,352,349,220,129
GAZIOSMANPASA,YENI MAHALLE MAH.,410,350,344,187,157
GAZIOSMANPASA,YENI MAHALLE MAH.,412,379,373,226,147
GAZIOSMANPASA,YENI MAHALLE MAH.,410,363,354,192,162
GAZIOSMANPASA,YENI MAHALLE MAH.,411,365,359,213,146
GAZIOSMANPASA,YENI MAHALLE MAH.,411,354,344,200,144
GAZIOSMANPASA,YENI MAHALLE MAH.,412,358,354,202,152
GAZIOSMANPASA,YENI MAHALLE MAH.,412,368,360,196,164
GAZIOSMANPASA,YENI MAHALLE MAH.,410,359,357,236,121
GAZIOSMANPASA,KARADENIZ MAH.,406,330,319,236,83
GAZIOSMANPASA,KARADENIZ MAH.,407,349,342,229,113
GAZIOSMANPASA,KARADENIZ MAH.,407,364,360,278,82
GAZIOSMANPASA,KARADENIZ MAH.,407,365,361,278,83
GAZIOSMANPASA,KARADENIZ MAH.,407,362,358,242,116
GAZIOSMANPASA,KARADENIZ MAH.,411,349,346,240,106
GAZIOSMANPASA,KARADENIZ MAH.,411,383,373,268,105
GAZIOSMANPASA,KARADENIZ MAH.,408,364,359,257,102
GAZIOSMANPASA,KARADENIZ MAH.,407,367,362,261,101
GAZIOSMANPASA,KARADENIZ MAH.,406,366,358,260,98
GAZIOSMANPASA,KARADENIZ MAH.,407,352,346,238,108
GAZIOSMANPASA,KARADENIZ MAH.,407,361,352,263,89
GAZIOSMANPASA,KARADENIZ MAH.,407,366,361,267,94
GAZIOSMANPASA,KARADENIZ MAH.,407,356,347,243,104
GAZIOSMANPASA,KARADENIZ MAH.,406,374,371,267,104
GAZIOSMANPASA,KARADENIZ MAH.,407,355,352,244,108
GAZIOSMANPASA,KARADENIZ MAH.,407,365,359,240,119
GAZIOSMANPASA,KARADENIZ MAH.,409,366,361,266,95
GAZIOSMANPASA,KARADENIZ MAH.,406,361,354,241,113
GAZIOSMANPASA,KARADENIZ MAH.,407,353,350,260,90
GAZIOSMANPASA,KARADENIZ MAH.,406,365,358,271,87
GAZIOSMANPASA,KARADENIZ MAH.,406,375,368,280,88
GAZIOSMANPASA,KARADENIZ MAH.,406,363,359,272,87
GAZIOSMANPASA,KARADENIZ MAH.,409,373,368,254,114
GAZIOSMANPASA,KARADENIZ MAH.,406,364,360,252,108
GAZIOSMANPASA,KARADENIZ MAH.,403,355,353,240,113
GAZIOSMANPASA,KARADENIZ MAH.,403,340,334,211,123
GAZIOSMANPASA,KARADENIZ MAH.,403,352,348,229,119
GAZIOSMANPASA,KARADENIZ MAH.,403,358,352,251,101
GAZIOSMANPASA,KARADENIZ MAH.,403,356,348,251,97
GAZIOSMANPASA,KARADENIZ MAH.,403,353,350,253,97
GAZIOSMANPASA,KARADENIZ MAH.,402,364,359,259,100
GAZIOSMANPASA,KARADENIZ MAH.,402,358,353,231,122
GAZIOSMANPASA,KARADENIZ MAH.,403,365,358,235,123
GAZIOSMANPASA,KARADENIZ MAH.,403,359,353,235,118
GAZIOSMANPASA,KARADENIZ MAH.,402,359,354,271,83
GAZIOSMANPASA,KARADENIZ MAH.,402,330,326,232,94
GAZIOSMANPASA,KARADENIZ MAH.,402,363,355,243,112
GAZIOSMANPASA,KARADENIZ MAH.,402,356,353,215,138
GAZIOSMANPASA,KARADENIZ MAH.,402,362,359,255,104
GAZIOSMANPASA,KARADENIZ MAH.,402,362,359,255,104
GAZIOSMANPASA,KARADENIZ MAH.,403,359,354,219,135
GAZIOSMANPASA,KARADENIZ MAH.,404,379,372,252,120
GAZIOSMANPASA,KARADENIZ MAH.,403,357,356,241,115
GAZIOSMANPASA,KARADENIZ MAH.,402,362,359,251,108
GAZIOSMANPASA,KARADENIZ MAH.,403,358,346,215,131
GAZIOSMANPASA,KARADENIZ MAH.,402,342,341,233,108
GAZIOSMANPASA,KARADENIZ MAH.,402,363,357,256,101
GAZIOSMANPASA,KARADENIZ MAH.,403,358,353,241,112
GAZIOSMANPASA,KARADENIZ MAH.,403,353,350,243,107
GAZIOSMANPASA,KARADENIZ MAH.,404,360,351,253,98
GAZIOSMANPASA,KARADENIZ MAH.,406,367,363,239,124
GAZIOSMANPASA,KARADENIZ MAH.,403,376,372,270,102
GAZIOSMANPASA,KARADENIZ MAH.,405,338,332,224,108
GAZIOSMANPASA,KARADENIZ MAH.,405,360,356,245,111
GAZIOSMANPASA,KARADENIZ MAH.,408,368,363,229,134
GAZIOSMANPASA,KARADENIZ MAH.,405,359,359,224,135
GAZIOSMANPASA,KARADENIZ MAH.,407,363,360,236,124
GAZIOSMANPASA,KARADENIZ MAH.,406,352,347,215,132
GAZIOSMANPASA,KARADENIZ MAH.,406,375,367,247,120
GAZIOSMANPASA,KARADENIZ MAH.,406,357,348,204,144
GAZIOSMANPASA,KARADENIZ MAH.,405,359,349,210,139
GAZIOSMANPASA,KARADENIZ MAH.,405,363,359,223,136
GAZIOSMANPASA,KARADENIZ MAH.,405,353,345,211,134
GAZIOSMANPASA,KARADENIZ MAH.,408,358,350,207,143
GAZIOSMANPASA,KARADENIZ MAH.,404,351,348,221,127
GAZIOSMANPASA,KARADENIZ MAH.,405,361,357,230,127
GAZIOSMANPASA,KARADENIZ MAH.,405,374,371,224,147
GAZIOSMANPASA,KARADENIZ MAH.,404,354,351,234,117
GAZIOSMANPASA,KARADENIZ MAH.,404,363,362,217,145
GAZIOSMANPASA,KARADENIZ MAH.,418,350,342,262,80
GAZIOSMANPASA,KARADENIZ MAH.,416,368,364,263,101
GAZIOSMANPASA,KARADENIZ MAH.,414,367,362,264,98
GAZIOSMANPASA,KARADENIZ MAH.,415,357,348,247,101
GAZIOSMANPASA,KARADENIZ MAH.,414,360,358,261,97
GAZIOSMANPASA,KARADENIZ MAH.,416,359,355,260,95
GAZIOSMANPASA,KARADENIZ MAH.,416,371,365,248,117
GAZIOSMANPASA,KARADENIZ MAH.,416,381,377,255,122
GAZIOSMANPASA,KARADENIZ MAH.,415,371,368,244,124
GAZIOSMANPASA,KARADENIZ MAH.,415,364,350,255,95
GAZIOSMANPASA,KARADENIZ MAH.,415,358,350,247,103
GAZIOSMANPASA,KARADENIZ MAH.,416,376,368,243,125
GAZIOSMANPASA,KARADENIZ MAH.,416,361,358,221,137
GAZIOSMANPASA,KARADENIZ MAH.,416,359,350,262,88
GAZIOSMANPASA,KARADENIZ MAH.,417,378,374,272,102
GAZIOSMANPASA,KARADENIZ MAH.,415,368,360,254,106
GAZIOSMANPASA,KARADENIZ MAH.,415,354,347,255,92
GAZIOSMANPASA,KARADENIZ MAH.,414,371,371,310,61
GAZIOSMANPASA,KARADENIZ MAH.,414,370,366,287,79
GAZIOSMANPASA,KARADENIZ MAH.,405,327,322,253,69
GAZIOSMANPASA,KARADENIZ MAH.,405,337,329,193,136
GAZIOSMANPASA,KARADENIZ MAH.,405,351,345,243,102
GAZIOSMANPASA,KARADENIZ MAH.,404,345,338,247,91
GAZIOSMANPASA,KARADENIZ MAH.,405,352,347,231,116
GAZIOSMANPASA,KARADENIZ MAH.,408,360,352,247,105
GAZIOSMANPASA,KARADENIZ MAH.,405,359,354,243,111
GAZIOSMANPASA,KARADENIZ MAH.,405,353,348,228,120
GAZIOSMANPASA,KARADENIZ MAH.,406,362,357,220,137
GAZIOSMANPASA,KARADENIZ MAH.,404,355,348,240,108
GAZIOSMANPASA,KARADENIZ MAH.,405,351,345,224,121
GAZIOSMANPASA,KARADENIZ MAH.,405,358,354,232,122
GAZIOSMANPASA,KARADENIZ MAH.,404,339,333,219,114
GAZIOSMANPASA,KARADENIZ MAH.,406,351,346,238,108
GAZIOSMANPASA,KARADENIZ MAH.,406,358,356,230,126
GAZIOSMANPASA,KARADENIZ MAH.,405,363,350,258,92
GAZIOSMANPASA,KARADENIZ MAH.,405,340,333,261,72
GAZIOSMANPASA,KARADENIZ MAH.,406,362,353,273,80
GAZIOSMANPASA,KARADENIZ MAH.,404,366,363,247,116
GAZIOSMANPASA,KARADENIZ MAH.,405,351,348,240,108
GAZIOSMANPASA,KARADENIZ MAH.,405,349,342,264,78
GAZIOSMANPASA,KARADENIZ MAH.,404,347,337,229,108
GAZIOSMANPASA,KARADENIZ MAH.,405,356,347,236,111
GAZIOSMANPASA,KARADENIZ MAH.,405,348,341,239,102
GAZIOSMANPASA,KARADENIZ MAH.,404,351,347,234,113
GAZIOSMANPASA,KARADENIZ MAH.,405,355,350,245,105
GAZIOSMANPASA,KARADENIZ MAH.,405,330,327,239,88
GAZIOSMANPASA,KARADENIZ MAH.,407,359,354,246,108
GAZIOSMANPASA,KARADENIZ MAH.,404,356,354,238,116
GAZIOSMANPASA,KARADENIZ MAH.,405,354,350,234,116
GAZIOSMANPASA,KARADENIZ MAH.,404,353,350,240,110
GAZIOSMANPASA,KARAYOLLARI MAH.,415,343,333,126,207
GAZIOSMANPASA,KARAYOLLARI MAH.,415,372,363,173,190
GAZIOSMANPASA,KARAYOLLARI MAH.,415,367,363,158,205
GAZIOSMANPASA,KARAYOLLARI MAH.,415,371,363,159,204
GAZIOSMANPASA,KARAYOLLARI MAH.,415,370,362,173,189
GAZIOSMANPASA,KARAYOLLARI MAH.,415,358,356,191,165
GAZIOSMANPASA,KARAYOLLARI MAH.,415,347,338,169,169
GAZIOSMANPASA,KARAYOLLARI MAH.,415,371,368,169,199
GAZIOSMANPASA,KARAYOLLARI MAH.,415,359,351,162,189
GAZIOSMANPASA,KARAYOLLARI MAH.,415,367,360,171,189
GAZIOSMANPASA,KARAYOLLARI MAH.,415,375,370,163,207
GAZIOSMANPASA,KARAYOLLARI MAH.,415,353,343,157,186
GAZIOSMANPASA,KARAYOLLARI MAH.,415,363,361,178,183
GAZIOSMANPASA,KARAYOLLARI MAH.,415,383,377,148,229
GAZIOSMANPASA,KARAYOLLARI MAH.,415,352,351,169,182
GAZIOSMANPASA,KARAYOLLARI MAH.,415,370,362,180,182
GAZIOSMANPASA,KARAYOLLARI MAH.,415,362,351,186,165
GAZIOSMANPASA,KARAYOLLARI MAH.,404,330,328,145,183
GAZIOSMANPASA,KARAYOLLARI MAH.,405,355,352,196,156
GAZIOSMANPASA,KARAYOLLARI MAH.,405,340,329,172,157
GAZIOSMANPASA,KARAYOLLARI MAH.,406,338,335,170,165
GAZIOSMANPASA,KARAYOLLARI MAH.,405,367,360,168,192
GAZIOSMANPASA,KARAYOLLARI MAH.,405,356,348,187,161
GAZIOSMANPASA,KARAYOLLARI MAH.,405,354,352,142,210
GAZIOSMANPASA,KARAYOLLARI MAH.,404,351,345,158,187
GAZIOSMANPASA,KARAYOLLARI MAH.,405,353,349,188,161
GAZIOSMANPASA,KARAYOLLARI MAH.,404,355,340,166,174
GAZIOSMANPASA,KARAYOLLARI MAH.,405,351,344,160,184
GAZIOSMANPASA,KARAYOLLARI MAH.,404,362,361,173,188
GAZIOSMANPASA,KARAYOLLARI MAH.,407,355,352,169,183
GAZIOSMANPASA,KARAYOLLARI MAH.,405,357,344,153,191
GAZIOSMANPASA,KARAYOLLARI MAH.,404,352,347,155,192
GAZIOSMANPASA,KARAYOLLARI MAH.,405,357,351,166,185
GAZIOSMANPASA,KARAYOLLARI MAH.,403,361,353,148,205
GAZIOSMANPASA,KARAYOLLARI MAH.,405,351,341,165,176
GAZIOSMANPASA,KARAYOLLARI MAH.,405,348,339,136,203
GAZIOSMANPASA,KARAYOLLARI MAH.,404,364,355,145,210
GAZIOSMANPASA,KARAYOLLARI MAH.,405,358,351,164,187
GAZIOSMANPASA,KARAYOLLARI MAH.,405,361,355,161,194
GAZIOSMANPASA,KARAYOLLARI MAH.,405,344,333,148,185
GAZIOSMANPASA,KARAYOLLARI MAH.,405,354,345,166,179
GAZIOSMANPASA,KARAYOLLARI MAH.,404,361,357,175,182
GAZIOSMANPASA,KARAYOLLARI MAH.,405,358,346,170,176
GAZIOSMANPASA,KARAYOLLARI MAH.,405,350,343,146,197
GAZIOSMANPASA,KARAYOLLARI MAH.,403,346,342,212,130
GAZIOSMANPASA,KARAYOLLARI MAH.,403,349,339,171,168
GAZIOSMANPASA,KARAYOLLARI MAH.,405,365,360,190,170
GAZIOSMANPASA,KARAYOLLARI MAH.,405,355,352,196,156
GAZIOSMANPASA,KARAYOLLARI MAH.,405,358,356,197,159
GAZIOSMANPASA,KARAYOLLARI MAH.,403,356,352,189,163
GAZIOSMANPASA,KARAYOLLARI MAH.,405,360,357,174,183
GAZIOSMANPASA,KARAYOLLARI MAH.,404,374,365,190,175
GAZIOSMANPASA,KARAYOLLARI MAH.,403,378,374,66,308
GAZIOSMANPASA,KARAYOLLARI MAH.,404,383,376,74,302
GAZIOSMANPASA,KARAYOLLARI MAH.,403,369,368,80,288
GAZIOSMANPASA,KARAYOLLARI MAH.,404,381,378,91,287
GAZIOSMANPASA,KARAYOLLARI MAH.,407,381,378,94,284
GAZIOSMANPASA,KARAYOLLARI MAH.,403,383,382,75,307
GAZIOSMANPASA,KARAYOLLARI MAH.,404,376,370,91,279
GAZIOSMANPASA,KARAYOLLARI MAH.,403,378,376,79,297
GAZIOSMANPASA,KARAYOLLARI MAH.,404,386,383,86,297
GAZIOSMANPASA,KARAYOLLARI MAH.,404,383,379,63,316
GAZIOSMANPASA,KARAYOLLARI MAH.,403,375,374,59,315
GAZIOSMANPASA,KARAYOLLARI MAH.,402,384,375,77,298
GAZIOSMANPASA,KAZIM KARABEKIR MAH.,408,338,328,233,95
GAZIOSMANPASA,KAZIM KARABEKIR MAH.,407,350,347,261,86
GAZIOSMANPASA,KAZIM KARABEKIR MAH.,406,348,343,246,97
GAZIOSMANPASA,KAZIM KARABEKIR MAH.,406,345,339,250,89
GAZIOSMANPASA,KAZIM KARABEKIR MAH.,407,359,355,252,103
GAZIOSMANPASA,KAZIM KARABEKIR MAH.,407,369,366,225,141
GAZIOSMANPASA,KAZIM KARABEKIR MAH.,407,353,349,251,98
GAZIOSMANPASA,KAZIM KARABEKIR MAH.,407,365,359,239,120
GAZIOSMANPASA,KAZIM KARABEKIR MAH.,406,363,356,250,106
GAZIOSMANPASA,KAZIM KARABEKIR MAH.,406,364,355,238,117
GAZIOSMANPASA,KAZIM KARABEKIR MAH.,406,359,354,263,91
GAZIOSMANPASA,KAZIM KARABEKIR MAH.,406,366,360,255,105
GAZIOSMANPASA,KAZIM KARABEKIR MAH.,407,374,367,270,97
GAZIOSMANPASA,KAZIM KARABEKIR MAH.,406,361,357,261,96
GAZIOSMANPASA,KAZIM KARABEKIR MAH.,407,354,346,229,117
GAZIOSMANPASA,KAZIM KARABEKIR MAH.,409,364,360,255,105
GAZIOSMANPASA,KAZIM KARABEKIR MAH.,407,348,340,211,129
GAZIOSMANPASA,KAZIM KARABEKIR MAH.,407,358,354,261,93
GAZIOSMANPASA,KAZIM KARABEKIR MAH.,406,371,369,267,102
GAZIOSMANPASA,KAZIM KARABEKIR MAH.,406,354,351,248,103
GAZIOSMANPASA,KAZIM KARABEKIR MAH.,406,361,359,256,103
GAZIOSMANPASA,KAZIM KARABEKIR MAH.,407,362,357,252,105
GAZIOSMANPASA,KAZIM KARABEKIR MAH.,407,360,356,241,115
GAZIOSMANPASA,KAZIM KARABEKIR MAH.,407,364,360,257,103
GAZIOSMANPASA,KAZIM KARABEKIR MAH.,406,371,364,259,105
GAZIOSMANPASA,KAZIM KARABEKIR MAH.,417,356,348,255,93
GAZIOSMANPASA,KAZIM KARABEKIR MAH.,420,382,377,286,91
GAZIOSMANPASA,KAZIM KARABEKIR MAH.,415,373,367,278,89
GAZIOSMANPASA,KAZIM KARABEKIR MAH.,415,379,374,251,123
GAZIOSMANPASA,KAZIM KARABEKIR MAH.,415,369,361,262,99
GAZIOSMANPASA,KAZIM KARABEKIR MAH.,416,379,373,291,82
GAZIOSMANPASA,KAZIM KARABEKIR MAH.,415,376,370,272,98
GAZIOSMANPASA,KAZIM KARABEKIR MAH.,416,365,359,276,83
GAZIOSMANPASA,KAZIM KARABEKIR MAH.,415,374,366,274,92
GAZIOSMANPASA,KAZIM KARABEKIR MAH.,416,370,369,275,94
GAZIOSMANPASA,KAZIM KARABEKIR MAH.,415,363,358,275,83
GAZIOSMANPASA,KAZIM KARABEKIR MAH.,415,371,365,270,95
GAZIOSMANPASA,KAZIM KARABEKIR MAH.,415,360,357,273,84
GAZIOSMANPASA,KAZIM KARABEKIR MAH.,415,362,354,252,102
GAZIOSMANPASA,KAZIM KARABEKIR MAH.,413,364,358,245,113
GAZIOSMANPASA,KAZIM KARABEKIR MAH.,417,366,358,254,104
GAZIOSMANPASA,KAZIM KARABEKIR MAH.,417,387,385,264,121
GAZIOSMANPASA,KAZIM KARABEKIR MAH.,415,365,362,267,95
GAZIOSMANPASA,KAZIM KARABEKIR MAH.,417,359,350,245,105
GAZIOSMANPASA,KAZIM KARABEKIR MAH.,415,345,341,249,92
GAZIOSMANPASA,KAZIM KARABEKIR MAH.,417,379,373,268,105
GAZIOSMANPASA,KAZIM KARABEKIR MAH.,413,384,381,254,127
GAZIOSMANPASA,KAZIM KARABEKIR MAH.,415,377,373,252,121
GAZIOSMANPASA,KAZIM KARABEKIR MAH.,415,372,366,251,115
GAZIOSMANPASA,KAZIM KARABEKIR MAH.,414,367,358,250,108
GAZIOSMANPASA,KAZIM KARABEKIR MAH.,414,362,357,242,115
GAZIOSMANPASA,KAZIM KARABEKIR MAH.,414,373,369,257,112
GAZIOSMANPASA,KAZIM KARABEKIR MAH.,415,365,361,250,111
GAZIOSMANPASA,KAZIM KARABEKIR MAH.,415,371,370,267,103
GAZIOSMANPASA,KAZIM KARABEKIR MAH.,414,388,374,268,106
GAZIOSMANPASA,KAZIM KARABEKIR MAH.,407,356,349,253,96
GAZIOSMANPASA,KAZIM KARABEKIR MAH.,406,353,349,239,110
GAZIOSMANPASA,KAZIM KARABEKIR MAH.,407,370,362,227,135
GAZIOSMANPASA,KAZIM KARABEKIR MAH.,405,361,352,278,74
GAZIOSMANPASA,KAZIM KARABEKIR MAH.,405,365,361,271,90
GAZIOSMANPASA,KAZIM KARABEKIR MAH.,405,370,366,257,109
GAZIOSMANPASA,KAZIM KARABEKIR MAH.,405,361,358,273,85
GAZIOSMANPASA,KAZIM KARABEKIR MAH.,404,362,353,242,111
GAZIOSMANPASA,KAZIM KARABEKIR MAH.,405,370,362,265,97
GAZIOSMANPASA,KAZIM KARABEKIR MAH.,405,366,363,271,92
GAZIOSMANPASA,KAZIM KARABEKIR MAH.,405,352,347,252,95
GAZIOSMANPASA,KAZIM KARABEKIR MAH.,407,370,368,267,101
GAZIOSMANPASA,KAZIM KARABEKIR MAH.,405,361,356,228,128
GAZIOSMANPASA,KAZIM KARABEKIR MAH.,404,377,371,292,79
GAZIOSMANPASA,KAZIM KARABEKIR MAH.,404,380,379,280,99
GAZIOSMANPASA,KAZIM KARABEKIR MAH.,405,366,365,257,108
GAZIOSMANPASA,KAZIM KARABEKIR MAH.,405,353,349,256,93
GAZIOSMANPASA,KAZIM KARABEKIR MAH.,405,351,347,253,94
GAZIOSMANPASA,KAZIM KARABEKIR MAH.,405,354,347,234,113
GAZIOSMANPASA,KAZIM KARABEKIR MAH.,404,364,359,267,92
GAZIOSMANPASA,KAZIM KARABEKIR MAH.,404,372,371,246,125
GAZIOSMANPASA,KAZIM KARABEKIR MAH.,405,365,358,270,88
GAZIOSMANPASA,KAZIM KARABEKIR MAH.,405,368,365,263,102
GAZIOSMANPASA,MEVLANA MAH.,407,333,328,136,192
GAZIOSMANPASA,MEVLANA MAH.,407,353,346,152,194
GAZIOSMANPASA,MEVLANA MAH.,406,364,356,159,197
GAZIOSMANPASA,MEVLANA MAH.,407,361,352,166,186
GAZIOSMANPASA,MEVLANA MAH.,407,376,375,185,190
GAZIOSMANPASA,MEVLANA MAH.,408,373,371,174,197
GAZIOSMANPASA,MEVLANA MAH.,407,372,367,156,211
GAZIOSMANPASA,MEVLANA MAH.,407,367,367,180,187
GAZIOSMANPASA,MEVLANA MAH.,408,363,359,174,185
GAZIOSMANPASA,MEVLANA MAH.,409,358,355,168,187
GAZIOSMANPASA,MEVLANA MAH.,407,360,356,163,193
GAZIOSMANPASA,MEVLANA MAH.,408,355,350,159,191
GAZIOSMANPASA,MEVLANA MAH.,407,375,374,176,198
GAZIOSMANPASA,MEVLANA MAH.,406,357,350,171,179
GAZIOSMANPASA,MEVLANA MAH.,407,374,372,190,182
GAZIOSMANPASA,MEVLANA MAH.,415,333,325,183,142
GAZIOSMANPASA,MEVLANA MAH.,415,333,320,167,153
GAZIOSMANPASA,MEVLANA MAH.,415,378,373,234,139
GAZIOSMANPASA,MEVLANA MAH.,411,367,361,221,140
GAZIOSMANPASA,MEVLANA MAH.,415,373,368,213,155
GAZIOSMANPASA,MEVLANA MAH.,415,359,352,220,132
GAZIOSMANPASA,MEVLANA MAH.,415,358,351,206,145
GAZIOSMANPASA,MEVLANA MAH.,412,367,363,196,167
GAZIOSMANPASA,MEVLANA MAH.,415,372,365,209,156
GAZIOSMANPASA,MEVLANA MAH.,412,374,369,230,139
GAZIOSMANPASA,MEVLANA MAH.,412,372,367,226,141
GAZIOSMANPASA,MEVLANA MAH.,415,358,355,200,155
GAZIOSMANPASA,MEVLANA MAH.,415,387,384,225,159
GAZIOSMANPASA,MEVLANA MAH.,413,367,362,246,116
GAZIOSMANPASA,MEVLANA MAH.,412,382,376,230,146
GAZIOSMANPASA,MEVLANA MAH.,411,359,352,217,135
GAZIOSMANPASA,MEVLANA MAH.,411,376,376,227,149
GAZIOSMANPASA,MEVLANA MAH.,415,378,373,255,118
GAZIOSMANPASA,MEVLANA MAH.,412,369,363,224,139
GAZIOSMANPASA,MEVLANA MAH.,411,371,363,238,125
GAZIOSMANPASA,MEVLANA MAH.,412,349,347,201,146
GAZIOSMANPASA,MEVLANA MAH.,412,364,362,202,160
GAZIOSMANPASA,MEVLANA MAH.,412,378,366,237,129
GAZIOSMANPASA,MEVLANA MAH.,413,372,367,206,161
GAZIOSMANPASA,MEVLANA MAH.,411,361,358,211,147
BEYLIKDUZU,ADNAN KAHVECI MAH.,415,364,357,127,230
BEYLIKDUZU,ADNAN KAHVECI MAH.,415,371,369,146,223
BEYLIKDUZU,ADNAN KAHVECI MAH.,415,384,382,146,236
BEYLIKDUZU,ADNAN KAHVECI MAH.,415,372,369,154,215
BEYLIKDUZU,ADNAN KAHVECI MAH.,411,378,377,136,241
BEYLIKDUZU,ADNAN KAHVECI MAH.,411,374,371,164,207
BEYLIKDUZU,ADNAN KAHVECI MAH.,412,374,370,136,234
BEYLIKDUZU,ADNAN KAHVECI MAH.,411,365,362,131,231
BEYLIKDUZU,ADNAN KAHVECI MAH.,412,385,380,147,233
BEYLIKDUZU,ADNAN KAHVECI MAH.,411,351,344,119,225
BEYLIKDUZU,ADNAN KAHVECI MAH.,411,360,356,112,244
BEYLIKDUZU,ADNAN KAHVECI MAH.,411,366,362,139,223
BEYLIKDUZU,ADNAN KAHVECI MAH.,410,372,365,135,230
BEYLIKDUZU,ADNAN KAHVECI MAH.,410,369,367,138,229
BEYLIKDUZU,ADNAN KAHVECI MAH.,410,368,366,133,233
BEYLIKDUZU,ADNAN KAHVECI MAH.,411,361,358,101,257
BEYLIKDUZU,ADNAN KAHVECI MAH.,411,374,373,131,242
BEYLIKDUZU,ADNAN KAHVECI MAH.,411,371,365,140,225
BEYLIKDUZU,ADNAN KAHVECI MAH.,410,378,374,127,247
BEYLIKDUZU,ADNAN KAHVECI MAH.,410,358,355,132,223
BEYLIKDUZU,ADNAN KAHVECI MAH.,410,384,382,128,254
BEYLIKDUZU,ADNAN KAHVECI MAH.,410,379,369,148,221
BEYLIKDUZU,ADNAN KAHVECI MAH.,411,359,357,126,231
BEYLIKDUZU,ADNAN KAHVECI MAH.,405,341,337,123,214
BEYLIKDUZU,ADNAN KAHVECI MAH.,404,334,327,109,218
BEYLIKDUZU,ADNAN KAHVECI MAH.,405,371,366,166,200
BEYLIKDUZU,ADNAN KAHVECI MAH.,403,365,362,143,219
BEYLIKDUZU,ADNAN KAHVECI MAH.,403,353,349,159,190
BEYLIKDUZU,ADNAN KAHVECI MAH.,403,356,342,133,209
BEYLIKDUZU,ADNAN KAHVECI MAH.,403,357,352,125,227
BEYLIKDUZU,ADNAN KAHVECI MAH.,403,367,365,157,208
BEYLIKDUZU,ADNAN KAHVECI MAH.,404,367,365,156,209
BEYLIKDUZU,ADNAN KAHVECI MAH.,405,359,356,118,238
BEYLIKDUZU,ADNAN KAHVECI MAH.,402,366,365,129,236
BEYLIKDUZU,ADNAN KAHVECI MAH.,404,357,353,128,225
BEYLIKDUZU,ADNAN KAHVECI MAH.,403,355,354,146,208
BEYLIKDUZU,ADNAN KAHVECI MAH.,403,361,354,133,221
BEYLIKDUZU,ADNAN KAHVECI MAH.,402,352,350,134,216
BEYLIKDUZU,ADNAN KAHVECI MAH.,403,355,348,151,197
BEYLIKDUZU,ADNAN KAHVECI MAH.,402,369,360,149,211
BEYLIKDUZU,ADNAN KAHVECI MAH.,403,350,346,145,201
BEYLIKDUZU,ADNAN KAHVECI MAH.,402,352,349,123,226
BEYLIKDUZU,ADNAN KAHVECI MAH.,403,360,354,117,237
BEYLIKDUZU,ADNAN KAHVECI MAH.,403,356,350,146,204
BEYLIKDUZU,ADNAN KAHVECI MAH.,402,369,359,165,194
BEYLIKDUZU,ADNAN KAHVECI MAH.,403,349,347,146,201
BEYLIKDUZU,ADNAN KAHVECI MAH.,402,359,351,122,229
BEYLIKDUZU,ADNAN KAHVECI MAH.,403,367,361,147,214
BEYLIKDUZU,ADNAN KAHVECI MAH.,402,352,348,121,227
BEYLIKDUZU,ADNAN KAHVECI MAH.,403,339,334,138,196
BEYLIKDUZU,ADNAN KAHVECI MAH.,403,364,358,156,202
BEYLIKDUZU,ADNAN KAHVECI MAH.,403,362,361,172,189
BEYLIKDUZU,ADNAN KAHVECI MAH.,402,353,347,137,210
BEYLIKDUZU,ADNAN KAHVECI MAH.,402,367,363,152,211
BEYLIKDUZU,ADNAN KAHVECI MAH.,404,335,328,133,195
BEYLIKDUZU,ADNAN KAHVECI MAH.,404,345,339,108,231
BEYLIKDUZU,ADNAN KAHVECI MAH.,405,371,369,155,214
BEYLIKDUZU,ADNAN KAHVECI MAH.,404,361,356,125,231
BEYLIKDUZU,ADNAN KAHVECI MAH.,404,355,351,114,237
BEYLIKDUZU,ADNAN KAHVECI MAH.,404,363,362,135,227
BEYLIKDUZU,ADNAN KAHVECI MAH.,404,358,353,115,238
BEYLIKDUZU,ADNAN KAHVECI MAH.,406,364,362,133,229
BEYLIKDUZU,ADNAN KAHVECI MAH.,407,364,361,125,236
BEYLIKDUZU,ADNAN KAHVECI MAH.,405,369,364,130,234
BEYLIKDUZU,ADNAN KAHVECI MAH.,408,362,356,140,216
BEYLIKDUZU,ADNAN KAHVECI MAH.,404,354,350,123,227
BEYLIKDUZU,ADNAN KAHVECI MAH.,403,353,348,121,227
BEYLIKDUZU,ADNAN KAHVECI MAH.,404,371,367,124,243
BEYLIKDUZU,ADNAN KAHVECI MAH.,406,349,340,127,213
BEYLIKDUZU,ADNAN KAHVECI MAH.,404,356,351,129,222
BEYLIKDUZU,ADNAN KAHVECI MAH.,403,369,365,120,245
BEYLIKDUZU,ADNAN KAHVECI MAH.,405,375,369,110,259
BEYLIKDUZU,ADNAN KAHVECI MAH.,404,357,356,99,257
BEYLIKDUZU,ADNAN KAHVECI MAH.,405,357,350,120,230
BEYLIKDUZU,ADNAN KAHVECI MAH.,404,349,346,99,247
BEYLIKDUZU,ADNAN KAHVECI MAH.,403,363,354,133,221
BEYLIKDUZU,ADNAN KAHVECI MAH.,403,355,354,116,238
BEYLIKDUZU,ADNAN KAHVECI MAH.,404,351,346,130,216
BEYLIKDUZU,ADNAN KAHVECI MAH.,410,354,351,118,233
BEYLIKDUZU,ADNAN KAHVECI MAH.,415,370,367,154,213
BEYLIKDUZU,ADNAN KAHVECI MAH.,409,373,371,125,246
BEYLIKDUZU,ADNAN KAHVECI MAH.,415,382,380,151,229
BEYLIKDUZU,ADNAN KAHVECI MAH.,409,376,375,155,220
BEYLIKDUZU,ADNAN KAHVECI MAH.,415,381,376,157,219
BEYLIKDUZU,ADNAN KAHVECI MAH.,415,372,368,131,237
BEYLIKDUZU,ADNAN KAHVECI MAH.,415,367,362,123,239
BEYLIKDUZU,ADNAN KAHVECI MAH.,415,382,376,120,256
BEYLIKDUZU,ADNAN KAHVECI MAH.,413,370,361,129,232
BEYLIKDUZU,ADNAN KAHVECI MAH.,412,377,374,130,244
BEYLIKDUZU,ADNAN KAHVECI MAH.,413,369,365,127,238
BEYLIKDUZU,ADNAN KAHVECI MAH.,413,381,374,119,255
BEYLIKDUZU,ADNAN KAHVECI MAH.,411,385,383,141,242
BEYLIKDUZU,ADNAN KAHVECI MAH.,413,362,357,140,217
BEYLIKDUZU,ADNAN KAHVECI MAH.,413,371,370,134,236
BEYLIKDUZU,ADNAN KAHVECI MAH.,411,371,367,138,229
BEYLIKDUZU,ADNAN KAHVECI MAH.,409,339,331,100,231
BEYLIKDUZU,ADNAN KAHVECI MAH.,408,348,341,96,245
BEYLIKDUZU,ADNAN KAHVECI MAH.,409,356,352,95,257
BEYLIKDUZU,ADNAN KAHVECI MAH.,407,376,370,120,250
BEYLIKDUZU,ADNAN KAHVECI MAH.,409,367,362,119,243
BEYLIKDUZU,ADNAN KAHVECI MAH.,409,360,352,103,249
BEYLIKDUZU,ADNAN KAHVECI MAH.,409,372,368,131,237
BEYLIKDUZU,ADNAN KAHVECI MAH.,409,363,358,95,263
BEYLIKDUZU,ADNAN KAHVECI MAH.,409,369,362,135,227
BEYLIKDUZU,ADNAN KAHVECI MAH.,408,359,357,116,241
BEYLIKDUZU,ADNAN KAHVECI MAH.,409,373,370,120,250
BEYLIKDUZU,ADNAN KAHVECI MAH.,408,377,374,99,275
BEYLIKDUZU,ADNAN KAHVECI MAH.,408,374,370,133,237
BEYLIKDUZU,ADNAN KAHVECI MAH.,409,375,371,120,251
BEYLIKDUZU,ADNAN KAHVECI MAH.,408,359,356,106,250
BEYLIKDUZU,ADNAN KAHVECI MAH.,408,376,371,107,264
BEYLIKDUZU,ADNAN KAHVECI MAH.,409,375,370,106,264
BEYLIKDUZU,ADNAN KAHVECI MAH.,409,369,367,120,247
BEYLIKDUZU,ADNAN KAHVECI MAH.,409,387,379,107,272
BEYLIKDUZU,ADNAN KAHVECI MAH.,408,376,371,140,231
BEYLIKDUZU,ADNAN KAHVECI MAH.,408,367,360,126,234
BEYLIKDUZU,ADNAN KAHVECI MAH.,409,375,368,108,260
BEYLIKDUZU,ADNAN KAHVECI MAH.,409,367,364,107,257
BEYLIKDUZU,ADNAN KAHVECI MAH.,409,375,375,122,253
BEYLIKDUZU,ADNAN KAHVECI MAH.,409,346,346,122,224
BEYLIKDUZU,ADNAN KAHVECI MAH.,406,358,353,85,268
BEYLIKDUZU,ADNAN KAHVECI MAH.,406,355,347,96,251
BEYLIKDUZU,ADNAN KAHVECI MAH.,406,392,389,113,276
BEYLIKDUZU,ADNAN KAHVECI MAH.,406,378,374,121,253
BEYLIKDUZU,ADNAN KAHVECI MAH.,405,376,373,117,256
BEYLIKDUZU,ADNAN KAHVECI MAH.,406,370,363,104,259
BEYLIKDUZU,ADNAN KAHVECI MAH.,405,378,372,127,245
BEYLIKDUZU,ADNAN KAHVECI MAH.,406,376,373,100,273
BEYLIKDUZU,ADNAN KAHVECI MAH.,405,373,372,113,259
BEYLIKDUZU,ADNAN KAHVECI MAH.,406,363,363,127,236
BEYLIKDUZU,ADNAN KAHVECI MAH.,405,373,368,123,245
BEYLIKDUZU,ADNAN KAHVECI MAH.,406,375,369,120,249
BEYLIKDUZU,ADNAN KAHVECI MAH.,405,362,359,97,262
BEYLIKDUZU,ADNAN KAHVECI MAH.,406,366,361,86,275
BEYLIKDUZU,ADNAN KAHVECI MAH.,405,362,360,109,251
BEYLIKDUZU,ADNAN KAHVECI MAH.,406,373,371,99,272
BEYLIKDUZU,ADNAN KAHVECI MAH.,406,372,371,114,257
BEYLIKDUZU,BARIS MAH.,401,338,327,61,266
BEYLIKDUZU,BARIS MAH.,402,331,327,88,239
BEYLIKDUZU,BARIS MAH.,404,360,356,119,237
BEYLIKDUZU,BARIS MAH.,402,364,361,89,272
BEYLIKDUZU,BARIS MAH.,403,370,361,71,290
BEYLIKDUZU,BARIS MAH.,406,374,372,90,282
BEYLIKDUZU,BARIS MAH.,403,374,372,127,245
BEYLIKDUZU,BARIS MAH.,402,370,366,93,273
BEYLIKDUZU,BARIS MAH.,403,363,356,108,248
BEYLIKDUZU,BARIS MAH.,402,364,359,112,247
BEYLIKDUZU,BARIS MAH.,402,362,360,101,259
BEYLIKDUZU,BARIS MAH.,402,379,372,107,265
BEYLIKDUZU,BARIS MAH.,402,379,376,103,273
BEYLIKDUZU,BARIS MAH.,403,368,364,86,278
BEYLIKDUZU,BARIS MAH.,403,372,372,77,295
BEYLIKDUZU,BARIS MAH.,403,369,368,102,266
BEYLIKDUZU,BARIS MAH.,402,359,355,99,256
BEYLIKDUZU,BARIS MAH.,401,360,353,82,271
BEYLIKDUZU,BARIS MAH.,402,370,367,94,273
BEYLIKDUZU,BARIS MAH.,404,363,357,98,259
BEYLIKDUZU,BARIS MAH.,401,371,368,72,296
BEYLIKDUZU,BARIS MAH.,402,374,372,105,267
BEYLIKDUZU,BARIS MAH.,401,374,369,101,268
BEYLIKDUZU,BARIS MAH.,402,360,359,79,280
BEYLIKDUZU,BARIS MAH.,401,376,370,95,275
BEYLIKDUZU,BARIS MAH.,402,360,356,72,284
BEYLIKDUZU,BARIS MAH.,388,329,326,91,235
BEYLIKDUZU,BARIS MAH.,389,349,345,109,236
BEYLIKDUZU,BARIS MAH.,387,362,359,120,239
BEYLIKDUZU,BARIS MAH.,386,370,369,118,251
BEYLIKDUZU,BARIS MAH.,387,354,348,111,237
BEYLIKDUZU,BARIS MAH.,388,354,350,112,238
BEYLIKDUZU,BARIS MAH.,386,371,367,128,239
BEYLIKDUZU,BARIS MAH.,386,348,343,107,236
BEYLIKDUZU,BARIS MAH.,387,353,348,109,239
BEYLIKDUZU,BARIS MAH.,387,349,347,124,223
BEYLIKDUZU,BARIS MAH.,387,347,344,124,220
BEYLIKDUZU,BARIS MAH.,386,342,336,118,218
BEYLIKDUZU,BARIS MAH.,395,357,354,89,265
BEYLIKDUZU,BARIS MAH.,394,360,357,90,267
BEYLIKDUZU,BARIS MAH.,394,369,366,126,240
BEYLIKDUZU,BARIS MAH.,395,362,357,99,258
BEYLIKDUZU,BARIS MAH.,393,369,365,95,270
BEYLIKDUZU,BARIS MAH.,393,375,371,121,250
BEYLIKDUZU,BARIS MAH.,393,363,361,99,262
BEYLIKDUZU,BARIS MAH.,412,377,371,112,259
BEYLIKDUZU,BARIS MAH.,415,367,364,114,250
BEYLIKDUZU,BARIS MAH.,412,372,364,128,236
BEYLIKDUZU,BARIS MAH.,412,367,363,107,256
BEYLIKDUZU,BARIS MAH.,411,372,371,109,262
BEYLIKDUZU,BARIS MAH.,412,383,377,114,263
BEYLIKDUZU,BARIS MAH.,412,363,358,93,265
BEYLIKDUZU,BARIS MAH.,411,376,372,119,253
BEYLIKDUZU,BARIS MAH.,403,352,350,81,269
BEYLIKDUZU,BARIS MAH.,400,343,337,93,244
BEYLIKDUZU,BARIS MAH.,400,359,357,106,251
BEYLIKDUZU,BARIS MAH.,399,364,359,121,238
BEYLIKDUZU,BARIS MAH.,399,361,361,103,258
BEYLIKDUZU,BARIS MAH.,400,359,356,96,260
BEYLIKDUZU,BARIS MAH.,400,378,374,108,266
BEYLIKDUZU,BARIS MAH.,399,375,370,114,256
BEYLIKDUZU,BARIS MAH.,399,366,362,111,251
BEYLIKDUZU,BARIS MAH.,400,356,348,102,246
BEYLIKDUZU,BARIS MAH.,400,372,365,93,272
BEYLIKDUZU,BARIS MAH.,400,371,368,79,289
BEYLIKDUZU,BARIS MAH.,400,364,362,103,259
BEYLIKDUZU,BARIS MAH.,399,382,375,88,287
BEYLIKDUZU,BARIS MAH.,401,370,363,119,244
BEYLIKDUZU,BARIS MAH.,399,356,353,112,241
BEYLIKDUZU,BARIS MAH.,400,352,343,96,247
BEYLIKDUZU,BARIS MAH.,399,375,370,95,275
BEYLIKDUZU,BARIS MAH.,400,367,364,102,262
BEYLIKDUZU,BARIS MAH.,399,379,377,106,271
BEYLIKDUZU,BARIS MAH.,400,366,364,88,276
BEYLIKDUZU,BARIS MAH.,399,366,363,97,266
BEYLIKDUZU,BARIS MAH.,399,366,365,118,247
BEYLIKDUZU,BARIS MAH.,400,366,364,103,261
BEYLIKDUZU,BARIS MAH.,403,350,341,106,235
BEYLIKDUZU,BARIS MAH.,402,356,348,89,259
BEYLIKDUZU,BARIS MAH.,402,365,358,103,255
BEYLIKDUZU,BARIS MAH.,401,368,362,93,269
BEYLIKDUZU,BARIS MAH.,402,364,362,112,250
BEYLIKDUZU,BARIS MAH.,401,368,362,105,257
BEYLIKDUZU,BARIS MAH.,401,360,358,99,259
BEYLIKDUZU,BARIS MAH.,402,364,357,71,286
BEYLIKDUZU,BARIS MAH.,401,365,362,88,274
BEYLIKDUZU,BARIS MAH.,402,367,363,87,276
BEYLIKDUZU,BARIS MAH.,401,366,361,100,261
BEYLIKDUZU,BARIS MAH.,400,370,368,98,270
BEYLIKDUZU,BARIS MAH.,401,363,355,77,278
BEYLIKDUZU,BARIS MAH.,402,378,374,113,261
BEYLIKDUZU,BARIS MAH.,401,352,342,103,239
BEYLIKDUZU,BARIS MAH.,402,361,357,98,259
BEYLIKDUZU,BARIS MAH.,402,373,371,81,290
BEYLIKDUZU,BARIS MAH.,401,381,378,121,257
BEYLIKDUZU,BUYUKSEHIR MAH.,386,320,316,77,239
BEYLIKDUZU,BUYUKSEHIR MAH.,386,349,337,102,235
BEYLIKDUZU,BUYUKSEHIR MAH.,386,350,343,82,261
BEYLIKDUZU,BUYUKSEHIR MAH.,386,354,350,98,252
BEYLIKDUZU,BUYUKSEHIR MAH.,386,355,354,74,280
BEYLIKDUZU,BUYUKSEHIR MAH.,387,355,347,74,273
BEYLIKDUZU,BUYUKSEHIR MAH.,386,360,360,92,268
BEYLIKDUZU,BUYUKSEHIR MAH.,386,348,346,69,277
BEYLIKDUZU,BUYUKSEHIR MAH.,386,350,345,77,268
BEYLIKDUZU,BUYUKSEHIR MAH.,386,340,337,85,252
BEYLIKDUZU,BUYUKSEHIR MAH.,387,348,343,88,255
BEYLIKDUZU,BUYUKSEHIR MAH.,385,343,339,79,260
BEYLIKDUZU,BUYUKSEHIR MAH.,400,353,346,74,272
BEYLIKDUZU,BUYUKSEHIR MAH.,399,358,356,85,271
BEYLIKDUZU,BUYUKSEHIR MAH.,398,369,365,115,250
BEYLIKDUZU,BUYUKSEHIR MAH.,399,362,360,73,287
BEYLIKDUZU,BUYUKSEHIR MAH.,399,352,352,71,281
BEYLIKDUZU,BUYUKSEHIR MAH.,398,366,363,94,269
BEYLIKDUZU,BUYUKSEHIR MAH.,399,363,358,90,268
BEYLIKDUZU,BUYUKSEHIR MAH.,398,365,356,84,272
BEYLIKDUZU,BUYUKSEHIR MAH.,399,366,361,101,260
BEYLIKDUZU,BUYUKSEHIR MAH.,399,358,358,89,269
BEYLIKDUZU,BUYUKSEHIR MAH.,398,366,364,64,300
BEYLIKDUZU,BUYUKSEHIR MAH.,399,360,359,108,251
BEYLIKDUZU,BUYUKSEHIR MAH.,397,342,338,76,262
BEYLIKDUZU,BUYUKSEHIR MAH.,398,335,327,84,243
BEYLIKDUZU,BUYUKSEHIR MAH.,398,350,348,99,249
BEYLIKDUZU,BUYUKSEHIR MAH.,398,358,356,99,257
BEYLIKDUZU,BUYUKSEHIR MAH.,399,365,361,101,260
BEYLIKDUZU,BUYUKSEHIR MAH.,398,365,364,113,251
BEYLIKDUZU,BUYUKSEHIR MAH.,398,369,367,122,245
BEYLIKDUZU,BUYUKSEHIR MAH.,398,359,357,99,258
BEYLIKDUZU,BUYUKSEHIR MAH.,397,362,360,70,290
BEYLIKDUZU,BUYUKSEHIR MAH.,398,371,368,73,295
BEYLIKDUZU,BUYUKSEHIR MAH.,398,365,362,96,266
BEYLIKDUZU,BUYUKSEHIR MAH.,398,359,353,107,246
BEYLIKDUZU,BUYUKSEHIR MAH.,397,365,363,82,281
BEYLIKDUZU,BUYUKSEHIR MAH.,398,362,359,101,258
BEYLIKDUZU,BUYUKSEHIR MAH.,398,365,363,104,259
BEYLIKDUZU,BUYUKSEHIR MAH.,397,365,357,81,276
BEYLIKDUZU,BUYUKSEHIR MAH.,398,367,363,95,268
BEYLIKDUZU,CUMHURIYET MAH.,408,364,361,68,293
BEYLIKDUZU,CUMHURIYET MAH.,409,361,358,81,277
BEYLIKDUZU,CUMHURIYET MAH.,408,376,371,89,282
BEYLIKDUZU,CUMHURIYET MAH.,408,377,374,90,284
BEYLIKDUZU,CUMHURIYET MAH.,408,370,368,82,286
BEYLIKDUZU,CUMHURIYET MAH.,408,367,365,100,265
BEYLIKDUZU,CUMHURIYET MAH.,409,376,370,83,287
BEYLIKDUZU,CUMHURIYET MAH.,409,374,370,105,265
BEYLIKDUZU,CUMHURIYET MAH.,408,384,379,91,288
BEYLIKDUZU,CUMHURIYET MAH.,409,361,356,87,269
BEYLIKDUZU,CUMHURIYET MAH.,410,374,368,77,291
BEYLIKDUZU,CUMHURIYET MAH.,408,377,371,86,285
BEYLIKDUZU,CUMHURIYET MAH.,408,374,372,75,297
BEYLIKDUZU,CUMHURIYET MAH.,408,372,368,89,279
BEYLIKDUZU,CUMHURIYET MAH.,408,364,359,78,281
BEYLIKDUZU,CUMHURIYET MAH.,408,381,381,75,306
BEYLIKDUZU,CUMHURIYET MAH.,408,387,383,99,284
BEYLIKDUZU,CUMHURIYET MAH.,408,380,376,89,287
BEYLIKDUZU,CUMHURIYET MAH.,409,372,367,107,260
BEYLIKDUZU,CUMHURIYET MAH.,407,372,370,87,283
BEYLIKDUZU,CUMHURIYET MAH.,405,349,346,63,283
BEYLIKDUZU,CUMHURIYET MAH.,403,360,357,44,313
BEYLIKDUZU,CUMHURIYET MAH.,404,374,368,81,287
BEYLIKDUZU,CUMHURIYET MAH.,403,377,374,57,317
BEYLIKDUZU,CUMHURIYET MAH.,403,373,367,55,312
BEYLIKDUZU,CUMHURIYET MAH.,403,375,373,76,297
BEYLIKDUZU,CUMHURIYET MAH.,403,363,356,69,287
BEYLIKDUZU,CUMHURIYET MAH.,403,384,382,74,308
BEYLIKDUZU,CUMHURIYET MAH.,402,378,374,83,291
BEYLIKDUZU,CUMHURIYET MAH.,402,361,358,65,293
BEYLIKDUZU,CUMHURIYET MAH.,404,381,374,77,297
BEYLIKDUZU,CUMHURIYET MAH.,402,374,373,65,308
BEYLIKDUZU,CUMHURIYET MAH.,402,376,375,63,312
BEYLIKDUZU,CUMHURIYET MAH.,402,376,373,62,311
BEYLIKDUZU,CUMHURIYET MAH.,403,376,371,53,318
BEYLIKDUZU,CUMHURIYET MAH.,403,362,360,85,275
BEYLIKDUZU,CUMHURIYET MAH.,402,367,364,70,294
BEYLIKDUZU,CUMHURIYET MAH.,402,377,373,71,302
BEYLIKDUZU,DEREAGZI MAH.,401,325,318,187,131
BEYLIKDUZU,DEREAGZI MAH.,399,338,331,163,168
BEYLIKDUZU,DEREAGZI MAH.,399,360,357,207,150
BEYLIKDUZU,DEREAGZI MAH.,400,358,350,182,168
BEYLIKDUZU,DEREAGZI MAH.,400,360,353,176,177
BEYLIKDUZU,DEREAGZI MAH.,400,348,344,183,161
BEYLIKDUZU,DEREAGZI MAH.,400,354,348,189,159
BEYLIKDUZU,DEREAGZI MAH.,400,362,357,200,157
BEYLIKDUZU,DEREAGZI MAH.,401,360,359,217,142
BEYLIKDUZU,DEREAGZI MAH.,406,363,358,184,174
BEYLIKDUZU,DEREAGZI MAH.,400,363,355,189,166
BEYLIKDUZU,DEREAGZI MAH.,401,365,359,209,150
BEYLIKDUZU,DEREAGZI MAH.,400,348,344,184,160
BEYLIKDUZU,DEREAGZI MAH.,401,364,356,186,170
BEYLIKDUZU,DEREAGZI MAH.,399,361,356,182,174
BEYLIKDUZU,DEREAGZI MAH.,400,351,348,208,140
BEYLIKDUZU,DEREAGZI MAH.,401,360,359,197,162
BEYLIKDUZU,DEREAGZI MAH.,400,365,360,190,170
BEYLIKDUZU,GURPINAR MAH.,384,310,306,146,160
BEYLIKDUZU,GURPINAR MAH.,382,341,336,170,166
BEYLIKDUZU,GURPINAR MAH.,384,348,340,182,158
BEYLIKDUZU,GURPINAR MAH.,384,348,346,170,176
BEYLIKDUZU,GURPINAR MAH.,383,344,340,179,161
BEYLIKDUZU,GURPINAR MAH.,383,342,339,174,165
BEYLIKDUZU,GURPINAR MAH.,384,320,315,173,142
BEYLIKDUZU,GURPINAR MAH.,384,327,326,152,174
BEYLIKDUZU,GURPINAR MAH.,384,334,332,167,165
BEYLIKDUZU,GURPINAR MAH.,383,346,341,171,170
BEYLIKDUZU,GURPINAR MAH.,384,336,334,183,151
BEYLIKDUZU,GURPINAR MAH.,407,321,311,167,144
BEYLIKDUZU,GURPINAR MAH.,409,313,305,167,138
BEYLIKDUZU,GURPINAR MAH.,409,374,371,210,161
BEYLIKDUZU,GURPINAR MAH.,410,353,345,211,134
BEYLIKDUZU,GURPINAR MAH.,409,364,356,196,160
BEYLIKDUZU,GURPINAR MAH.,408,361,356,201,155
BEYLIKDUZU,GURPINAR MAH.,409,367,358,200,158
BEYLIKDUZU,GURPINAR MAH.,408,358,357,206,151
BEYLIKDUZU,GURPINAR MAH.,409,355,352,194,158
BEYLIKDUZU,GURPINAR MAH.,409,343,331,213,118
BEYLIKDUZU,GURPINAR MAH.,409,363,359,194,165
BEYLIKDUZU,GURPINAR MAH.,409,359,352,209,143
BEYLIKDUZU,GURPINAR MAH.,409,356,349,186,163
BEYLIKDUZU,GURPINAR MAH.,409,366,363,211,152
BEYLIKDUZU,GURPINAR MAH.,409,353,349,187,162
BEYLIKDUZU,GURPINAR MAH.,409,370,363,212,151
BEYLIKDUZU,GURPINAR MAH.,407,353,347,202,145
BEYLIKDUZU,GURPINAR MAH.,409,359,357,181,176
BEYLIKDUZU,GURPINAR MAH.,408,367,356,202,154
BEYLIKDUZU,GURPINAR MAH.,409,358,348,187,161
BEYLIKDUZU,GURPINAR MAH.,407,363,355,241,114
BEYLIKDUZU,GURPINAR MAH.,409,353,347,200,147
BEYLIKDUZU,KAVAKLI MAH.,416,368,365,254,111
BEYLIKDUZU,KAVAKLI MAH.,416,374,369,251,118
BEYLIKDUZU,KAVAKLI MAH.,412,370,362,238,124
BEYLIKDUZU,KAVAKLI MAH.,415,387,385,234,151
BEYLIKDUZU,KAVAKLI MAH.,412,382,379,264,115
BEYLIKDUZU,KAVAKLI MAH.,416,385,380,261,119
BEYLIKDUZU,KAVAKLI MAH.,415,378,373,270,103
BEYLIKDUZU,KAVAKLI MAH.,416,383,379,255,124
BEYLIKDUZU,KAVAKLI MAH.,414,371,364,243,121
BEYLIKDUZU,KAVAKLI MAH.,414,378,371,257,114
BEYLIKDUZU,KAVAKLI MAH.,412,367,364,241,123
BEYLIKDUZU,KAVAKLI MAH.,415,382,379,255,124
BEYLIKDUZU,KAVAKLI MAH.,414,375,369,239,130
BEYLIKDUZU,KAVAKLI MAH.,415,388,386,253,133
BEYLIKDUZU,KAVAKLI MAH.,413,384,381,255,126
BEYLIKDUZU,KAVAKLI MAH.,412,384,381,269,112
BEYLIKDUZU,KAVAKLI MAH.,414,370,363,255,108
BEYLIKDUZU,KAVAKLI MAH.,413,369,366,232,134
BEYLIKDUZU,KAVAKLI MAH.,414,376,374,263,111
BEYLIKDUZU,KAVAKLI MAH.,414,377,376,264,112
BEYLIKDUZU,KAVAKLI MAH.,414,384,377,246,131
BEYLIKDUZU,KAVAKLI MAH.,398,349,342,201,141
BEYLIKDUZU,KAVAKLI MAH.,398,326,320,171,149
BEYLIKDUZU,KAVAKLI MAH.,398,352,348,186,162
BEYLIKDUZU,KAVAKLI MAH.,398,371,366,193,173
BEYLIKDUZU,KAVAKLI MAH.,398,360,355,197,158
BEYLIKDUZU,KAVAKLI MAH.,397,335,334,179,155
BEYLIKDUZU,KAVAKLI MAH.,398,341,337,179,158
BEYLIKDUZU,KAVAKLI MAH.,398,345,335,186,149
BEYLIKDUZU,KAVAKLI MAH.,398,347,339,175,164
BEYLIKDUZU,KAVAKLI MAH.,399,364,358,224,134
BEYLIKDUZU,KAVAKLI MAH.,398,353,350,213,137
BEYLIKDUZU,KAVAKLI MAH.,397,352,351,204,147
BEYLIKDUZU,KAVAKLI MAH.,397,367,364,208,156
BEYLIKDUZU,KAVAKLI MAH.,397,348,342,203,139
BEYLIKDUZU,KAVAKLI MAH.,398,368,360,228,132
BEYLIKDUZU,KAVAKLI MAH.,397,368,358,232,126
BEYLIKDUZU,KAVAKLI MAH.,398,345,338,188,150
BEYLIKDUZU,KAVAKLI MAH.,398,347,343,200,143
BEYLIKDUZU,KAVAKLI MAH.,397,358,355,205,150
BEYLIKDUZU,MARMARA MAH.,404,354,345,194,151
BEYLIKDUZU,MARMARA MAH.,403,358,331,195,136
BEYLIKDUZU,MARMARA MAH.,403,372,367,217,150
BEYLIKDUZU,MARMARA MAH.,404,370,366,202,164
BEYLIKDUZU,MARMARA MAH.,403,364,358,180,178
BEYLIKDUZU,MARMARA MAH.,403,366,362,181,181
BEYLIKDUZU,MARMARA MAH.,404,363,353,195,158
BEYLIKDUZU,MARMARA MAH.,404,365,359,214,145
BEYLIKDUZU,MARMARA MAH.,404,362,362,203,159
BEYLIKDUZU,MARMARA MAH.,403,371,357,191,166
BEYLIKDUZU,MARMARA MAH.,404,372,368,203,165
BEYLIKDUZU,MARMARA MAH.,404,370,366,179,187
BEYLIKDUZU,MARMARA MAH.,404,359,355,186,169
BEYLIKDUZU,MARMARA MAH.,404,375,373,182,191
BEYLIKDUZU,MARMARA MAH.,406,364,362,198,164
BEYLIKDUZU,MARMARA MAH.,404,359,355,204,151
BEYLIKDUZU,MARMARA MAH.,403,359,355,226,129
BEYLIKDUZU,MARMARA MAH.,404,369,364,185,179
BEYLIKDUZU,MARMARA MAH.,403,369,368,211,157
BEYLIKDUZU,MARMARA MAH.,403,357,349,191,158
BEYLIKDUZU,MARMARA MAH.,402,374,367,182,185
BEYLIKDUZU,MARMARA MAH.,403,357,351,178,173
BEYLIKDUZU,MARMARA MAH.,404,359,351,183,168
BEYLIKDUZU,MARMARA MAH.,404,364,358,206,152
BEYLIKDUZU,MARMARA MAH.,398,337,334,244,90
BEYLIKDUZU,MARMARA MAH.,397,339,331,223,108
BEYLIKDUZU,MARMARA MAH.,397,371,367,256,111
BEYLIKDUZU,MARMARA MAH.,396,379,375,280,95
BEYLIKDUZU,MARMARA MAH.,397,362,357,258,99
BEYLIKDUZU,MARMARA MAH.,396,370,365,266,99
BEYLIKDUZU,MARMARA MAH.,397,372,367,246,121
BEYLIKDUZU,MARMARA MAH.,396,364,356,247,109
BEYLIKDUZU,MARMARA MAH.,396,379,372,274,98
BEYLIKDUZU,MARMARA MAH.,396,375,372,267,105
BEYLIKDUZU,MARMARA MAH.,396,370,366,260,106
BEYLIKDUZU,MARMARA MAH.,395,362,349,258,91
BEYLIKDUZU,MARMARA MAH.,396,364,363,266,97
BEYLIKDUZU,MARMARA MAH.,395,358,350,262,88
BEYLIKDUZU,MARMARA MAH.,397,360,355,255,100
BEYLIKDUZU,MARMARA MAH.,396,369,368,265,103
BEYLIKDUZU,MARMARA MAH.,396,369,365,273,92
BEYLIKDUZU,MARMARA MAH.,396,362,359,243,116
BEYLIKDUZU,MARMARA MAH.,397,357,353,239,114
BEYLIKDUZU,MARMARA MAH.,396,371,367,285,82
BEYLIKDUZU,SAHIL MAH.,392,328,319,171,148
BEYLIKDUZU,SAHIL MAH.,392,354,354,204,150
BEYLIKDUZU,SAHIL MAH.,391,334,329,172,157
BEYLIKDUZU,SAHIL MAH.,391,366,362,202,160
BEYLIKDUZU,SAHIL MAH.,393,341,338,211,127
BEYLIKDUZU,SAHIL MAH.,392,330,326,160,166
BEYLIKDUZU,SAHIL MAH.,391,345,341,200,141
BEYLIKDUZU,YAKUPLU MAH.,406,345,339,172,167
BEYLIKDUZU,YAKUPLU MAH.,403,341,335,198,137
BEYLIKDUZU,YAKUPLU MAH.,402,346,343,185,158
BEYLIKDUZU,YAKUPLU MAH.,404,357,353,221,132
BEYLIKDUZU,YAKUPLU MAH.,403,362,354,200,154
BEYLIKDUZU,YAKUPLU MAH.,406,358,349,214,135
BEYLIKDUZU,YAKUPLU MAH.,403,352,346,193,153
BEYLIKDUZU,YAKUPLU MAH.,404,361,355,197,158
BEYLIKDUZU,YAKUPLU MAH.,405,354,353,184,169
BEYLIKDUZU,YAKUPLU MAH.,404,363,358,213,145
BEYLIKDUZU,YAKUPLU MAH.,403,355,349,207,142
BEYLIKDUZU,YAKUPLU MAH.,403,360,356,179,177
BEYLIKDUZU,YAKUPLU MAH.,403,341,337,225,112
BEYLIKDUZU,YAKUPLU MAH.,403,355,351,202,149
BEYLIKDUZU,YAKUPLU MAH.,403,346,342,206,136
BEYLIKDUZU,YAKUPLU MAH.,406,342,340,189,151
BEYLIKDUZU,YAKUPLU MAH.,403,357,348,209,139
BEYLIKDUZU,YAKUPLU MAH.,404,367,360,198,162
BEYLIKDUZU,YAKUPLU MAH.,403,339,330,184,146
BEYLIKDUZU,YAKUPLU MAH.,404,354,347,206,141
BEYLIKDUZU,YAKUPLU MAH.,402,351,344,199,145
BEYLIKDUZU,YAKUPLU MAH.,402,363,359,212,147
BEYLIKDUZU,YAKUPLU MAH.,403,363,353,217,136
BEYLIKDUZU,YAKUPLU MAH.,403,366,363,218,145
BEYLIKDUZU,YAKUPLU MAH.,402,363,354,215,139
BEYLIKDUZU,YAKUPLU MAH.,403,335,326,150,176
BEYLIKDUZU,YAKUPLU MAH.,401,337,327,165,162
BEYLIKDUZU,YAKUPLU MAH.,402,355,352,185,167
BEYLIKDUZU,YAKUPLU MAH.,401,346,343,199,144
BEYLIKDUZU,YAKUPLU MAH.,400,362,358,204,154
BEYLIKDUZU,YAKUPLU MAH.,401,348,345,185,160
BEYLIKDUZU,YAKUPLU MAH.,401,349,341,176,165
BEYLIKDUZU,YAKUPLU MAH.,401,365,362,166,196
BEYLIKDUZU,YAKUPLU MAH.,402,363,355,183,172
BEYLIKDUZU,YAKUPLU MAH.,402,355,353,175,178
BEYLIKDUZU,YAKUPLU MAH.,401,354,350,178,172
BEYLIKDUZU,YAKUPLU MAH.,401,339,334,194,140
BEYLIKDUZU,YAKUPLU MAH.,401,347,344,186,158
BEYLIKDUZU,YAKUPLU MAH.,400,342,333,179,154
BEYLIKDUZU,YAKUPLU MAH.,401,336,327,175,152
BEYLIKDUZU,YAKUPLU MAH.,402,342,338,180,158
BEYLIKDUZU,YAKUPLU MAH.,402,350,348,185,163
BEYLIKDUZU,YAKUPLU MAH.,401,353,346,197,149
BEYLIKDUZU,YAKUPLU MAH.,400,350,342,191,151
BEYLIKDUZU,YAKUPLU MAH.,400,351,341,181,160
BEYLIKDUZU,YAKUPLU MAH.,400,349,344,191,153
BEYLIKDUZU,YAKUPLU MAH.,401,356,352,189,163
BEYLIKDUZU,YAKUPLU MAH.,398,349,348,159,189
BEYLIKDUZU,YAKUPLU MAH.,397,337,329,185,144
BEYLIKDUZU,YAKUPLU MAH.,396,349,342,174,168
BEYLIKDUZU,YAKUPLU MAH.,396,344,338,166,172
BEYLIKDUZU,YAKUPLU MAH.,397,349,343,174,169
BEYLIKDUZU,YAKUPLU MAH.,397,351,345,172,173
BEYLIKDUZU,YAKUPLU MAH.,401,333,329,200,129
BEYLIKDUZU,YAKUPLU MAH.,397,354,351,190,161
BEYLIKDUZU,YAKUPLU MAH.,397,354,346,197,149
BEYLIKDUZU,YAKUPLU MAH.,396,358,351,190,161
BEYLIKDUZU,YAKUPLU MAH.,397,356,346,191,155
BEYLIKDUZU,YAKUPLU MAH.,397,347,342,181,161
BEYLIKDUZU,YAKUPLU MAH.,397,353,343,181,162
BEYLIKDUZU,YAKUPLU MAH.,397,353,345,175,170
BEYLIKDUZU,YAKUPLU MAH.,397,350,339,170,169
BEYLIKDUZU,YAKUPLU MAH.,396,347,345,201,144
BEYLIKDUZU,YAKUPLU MAH.,397,361,354,178,176
BEYLIKDUZU,YAKUPLU MAH.,396,351,346,182,164
BEYLIKDUZU,YAKUPLU MAH.,396,337,335,173,162
BEYLIKDUZU,YAKUPLU MAH.,397,353,346,174,172
BEYLIKDUZU,YAKUPLU MAH.,396,332,326,178,148
BEYLIKDUZU,YAKUPLU MAH.,398,348,340,173,167
SISLI,CUMHURIYET MAH.,399,314,312,21,291
SISLI,CUMHURIYET MAH.,399,314,309,35,274
SISLI,CUMHURIYET MAH.,399,347,341,36,305
SISLI,CUMHURIYET MAH.,399,353,352,43,309
SISLI,CUMHURIYET MAH.,400,364,361,44,317
SISLI,CUMHURIYET MAH.,400,332,330,53,277
SISLI,CUMHURIYET MAH.,399,347,347,49,298
SISLI,CUMHURIYET MAH.,398,368,363,71,292
SISLI,CUMHURIYET MAH.,398,350,344,65,279
SISLI,CUMHURIYET MAH.,398,357,356,42,314
SISLI,CUMHURIYET MAH.,399,369,367,43,324
SISLI,CUMHURIYET MAH.,399,362,362,44,318
SISLI,CUMHURIYET MAH.,290,266,265,43,222
SISLI,ESENTEPE MAH.,376,321,314,143,171
SISLI,ESENTEPE MAH.,375,333,331,138,193
SISLI,ESENTEPE MAH.,375,330,330,119,211
SISLI,ESENTEPE MAH.,376,310,305,125,180
SISLI,ESENTEPE MAH.,376,325,325,103,222
SISLI,ESENTEPE MAH.,376,342,340,121,219
SISLI,ESENTEPE MAH.,402,343,337,48,289
SISLI,ESENTEPE MAH.,402,369,363,47,316
SISLI,ESENTEPE MAH.,403,365,361,43,318
SISLI,ESENTEPE MAH.,402,358,348,65,283
SISLI,ESENTEPE MAH.,402,374,372,69,303
SISLI,ESENTEPE MAH.,402,362,358,63,295
SISLI,ESENTEPE MAH.,402,372,368,60,308
SISLI,ESENTEPE MAH.,402,362,357,57,300
SISLI,FULYA MAH.,389,322,316,73,243
SISLI,FULYA MAH.,390,327,324,43,281
SISLI,FULYA MAH.,389,355,349,40,309
SISLI,FULYA MAH.,390,354,350,46,304
SISLI,FULYA MAH.,390,355,354,51,303
SISLI,FULYA MAH.,390,362,358,59,299
SISLI,FULYA MAH.,391,352,349,70,279
SISLI,FULYA MAH.,389,347,344,61,283
SISLI,FULYA MAH.,389,355,352,45,307
SISLI,FULYA MAH.,390,348,344,60,284
SISLI,FULYA MAH.,392,360,354,69,285
SISLI,FULYA MAH.,389,354,350,72,278
SISLI,FULYA MAH.,389,360,358,51,307
SISLI,FULYA MAH.,390,347,343,59,284
SISLI,FULYA MAH.,390,353,351,60,291
SISLI,FULYA MAH.,406,355,352,122,230
SISLI,FULYA MAH.,406,356,354,95,259
SISLI,FULYA MAH.,405,374,372,81,291
SISLI,FULYA MAH.,405,346,341,98,243
SISLI,FULYA MAH.,406,355,352,73,279
SISLI,FULYA MAH.,405,359,357,99,258
SISLI,FULYA MAH.,406,361,359,81,278
SISLI,FULYA MAH.,405,360,357,89,268
SISLI,FULYA MAH.,387,315,314,86,228
SISLI,FULYA MAH.,386,343,338,71,267
SISLI,FULYA MAH.,388,352,348,63,285
SISLI,FULYA MAH.,387,352,351,66,285
SISLI,FULYA MAH.,388,359,357,80,277
SISLI,FULYA MAH.,386,339,338,67,271
SISLI,FULYA MAH.,386,353,351,67,284
SISLI,FULYA MAH.,388,355,351,60,291
SISLI,FULYA MAH.,354,289,287,46,241
SISLI,FULYA MAH.,354,321,316,43,273
SISLI,FULYA MAH.,354,333,331,36,295
SISLI,FULYA MAH.,354,327,319,52,267
SISLI,FULYA MAH.,353,323,321,59,262
SISLI,GULBAHAR MAH.,406,336,335,120,215
SISLI,GULBAHAR MAH.,407,330,328,109,219
SISLI,GULBAHAR MAH.,407,337,332,125,207
SISLI,GULBAHAR MAH.,406,352,345,115,230
SISLI,GULBAHAR MAH.,407,346,340,133,207
SISLI,GULBAHAR MAH.,406,331,330,123,207
SISLI,GULBAHAR MAH.,406,354,347,107,240
SISLI,GULBAHAR MAH.,407,344,342,108,234
SISLI,GULBAHAR MAH.,406,351,345,125,220
SISLI,GULBAHAR MAH.,407,368,365,131,234
SISLI,GULBAHAR MAH.,407,364,360,115,245
SISLI,GULBAHAR MAH.,408,351,348,134,214
SISLI,GULBAHAR MAH.,407,363,358,136,222
SISLI,GULBAHAR MAH.,407,346,341,127,214
SISLI,GULBAHAR MAH.,406,347,343,110,233
SISLI,GULBAHAR MAH.,407,350,344,122,222
SISLI,GULBAHAR MAH.,407,338,334,108,226
SISLI,GULBAHAR MAH.,407,347,346,134,212
SISLI,GULBAHAR MAH.,406,366,361,112,249
SISLI,GULBAHAR MAH.,406,358,353,108,245
SISLI,GULBAHAR MAH.,406,347,345,132,213
SISLI,GULBAHAR MAH.,406,345,340,120,220
SISLI,GULBAHAR MAH.,407,358,353,131,222
SISLI,GULBAHAR MAH.,407,358,354,134,220
SISLI,GULBAHAR MAH.,406,349,346,132,214
SISLI,GULBAHAR MAH.,408,331,325,125,200
SISLI,GULBAHAR MAH.,406,359,354,134,220
SISLI,GULBAHAR MAH.,407,345,339,116,223
SISLI,GULBAHAR MAH.,409,349,348,78,270
SISLI,GULBAHAR MAH.,406,360,356,98,258
SISLI,GULBAHAR MAH.,405,362,356,118,238
SISLI,GULBAHAR MAH.,406,360,356,120,236
SISLI,GULBAHAR MAH.,405,369,365,100,265
SISLI,GULBAHAR MAH.,405,341,337,98,239
SISLI,GULBAHAR MAH.,406,367,362,106,256
SISLI,GULBAHAR MAH.,406,357,354,110,244
SISLI,GULBAHAR MAH.,405,343,341,96,245
SISLI,GULBAHAR MAH.,406,357,355,96,259
SISLI,GULBAHAR MAH.,406,362,358,132,226
SISLI,GULBAHAR MAH.,405,344,342,104,238
SISLI,GULBAHAR MAH.,406,352,347,109,238
SISLI,GULBAHAR MAH.,405,362,358,106,252
SISLI,GULBAHAR MAH.,405,366,362,122,240
SISLI,HALASKARGAZI MAH.,331,246,242,22,220
SISLI,HALASKARGAZI MAH.,331,303,299,66,233
SISLI,HALASKARGAZI MAH.,331,295,291,41,250
SISLI,HALASKARGAZI MAH.,331,291,288,54,234
SISLI,HARBIYE MAH.,343,266,261,20,241
SISLI,HARBIYE MAH.,343,307,304,23,281
SISLI,HARBIYE MAH.,342,301,300,51,249
SISLI,HARBIYE MAH.,341,306,304,54,250
SISLI,HARBIYE MAH.,342,308,308,55,253
SISLI,INONU MAH.,385,273,264,90,174
SISLI,INONU MAH.,384,324,320,84,236
SISLI,INONU MAH.,385,314,311,83,228
SISLI,INONU MAH.,385,336,332,91,241
SISLI,INONU MAH.,385,338,334,110,224
SISLI,INONU MAH.,385,332,330,89,241
SISLI,INONU MAH.,384,319,314,87,227
SISLI,IZZET PASA MAH.,392,330,318,126,192
SISLI,IZZET PASA MAH.,391,344,334,163,171
SISLI,IZZET PASA MAH.,392,350,345,157,188
SISLI,IZZET PASA MAH.,392,347,341,165,176
SISLI,IZZET PASA MAH.,392,354,349,148,201
SISLI,IZZET PASA MAH.,391,360,353,157,196
SISLI,IZZET PASA MAH.,391,342,340,154,186
SISLI,IZZET PASA MAH.,392,348,342,152,190
SISLI,IZZET PASA MAH.,392,347,346,165,181
SISLI,IZZET PASA MAH.,391,355,351,134,217
SISLI,IZZET PASA MAH.,394,343,339,147,192
SISLI,IZZET PASA MAH.,391,353,349,174,175
SISLI,IZZET PASA MAH.,392,354,352,146,206
SISLI,IZZET PASA MAH.,392,350,346,154,192
SISLI,IZZET PASA MAH.,392,335,327,158,169
SISLI,IZZET PASA MAH.,390,353,348,149,199
SISLI,MECIDIYEKOY MAH.,399,327,324,116,208
SISLI,MECIDIYEKOY MAH.,397,326,321,122,199
SISLI,MECIDIYEKOY MAH.,397,350,347,119,228
SISLI,MECIDIYEKOY MAH.,399,335,330,103,227
SISLI,MECIDIYEKOY MAH.,398,343,342,126,216
SISLI,MECIDIYEKOY MAH.,397,341,336,111,225
SISLI,MECIDIYEKOY MAH.,397,352,351,118,233
SISLI,MECIDIYEKOY MAH.,397,352,349,126,223
SISLI,MECIDIYEKOY MAH.,397,355,354,110,244
SISLI,MECIDIYEKOY MAH.,398,346,345,124,221
SISLI,MECIDIYEKOY MAH.,397,344,340,135,205
SISLI,MECIDIYEKOY MAH.,397,356,355,131,224
SISLI,MECIDIYEKOY MAH.,400,343,331,111,220
SISLI,MECIDIYEKOY MAH.,400,336,332,120,212
SISLI,MECIDIYEKOY MAH.,402,356,354,131,223
SISLI,MECIDIYEKOY MAH.,400,357,353,108,245
SISLI,MECIDIYEKOY MAH.,401,339,333,102,231
SISLI,MECIDIYEKOY MAH.,402,358,353,125,228
SISLI,MECIDIYEKOY MAH.,399,352,347,101,246
SISLI,MECIDIYEKOY MAH.,400,343,339,151,188
SISLI,MECIDIYEKOY MAH.,400,342,336,87,249
SISLI,MECIDIYEKOY MAH.,399,334,330,109,221
SISLI,MECIDIYEKOY MAH.,399,357,353,114,239
SISLI,MECIDIYEKOY MAH.,400,351,348,117,231
SISLI,MECIDIYEKOY MAH.,400,334,321,154,167
SISLI,MECIDIYEKOY MAH.,397,337,330,112,218
SISLI,MECIDIYEKOY MAH.,398,355,352,115,237
SISLI,MECIDIYEKOY MAH.,397,335,333,106,227
SISLI,MECIDIYEKOY MAH.,397,347,341,117,224
SISLI,MECIDIYEKOY MAH.,397,347,345,95,250
SISLI,MECIDIYEKOY MAH.,398,353,351,150,201
SISLI,MECIDIYEKOY MAH.,399,337,335,132,203
SISLI,MECIDIYEKOY MAH.,397,357,355,131,224
SISLI,MECIDIYEKOY MAH.,396,350,346,119,227
SISLI,MECIDIYEKOY MAH.,397,334,330,116,214
SISLI,MECIDIYEKOY MAH.,396,352,346,127,219
SISLI,MECIDIYEKOY MAH.,397,363,358,118,240
SISLI,MECIDIYEKOY MAH.,396,350,343,137,206
SISLI,MECIDIYEKOY MAH.,396,343,341,120,221
SISLI,MERKEZ MAH.,415,303,299,55,244
SISLI,MERKEZ MAH.,411,313,311,38,273
SISLI,MERKEZ MAH.,415,317,317,41,276
SISLI,MERKEZ MAH.,415,312,311,14,297
SISLI,MERKEZ MAH.,411,298,291,39,252
SISLI,MERKEZ MAH.,412,358,356,49,307
SISLI,MERKEZ MAH.,410,372,366,35,331
SISLI,MERKEZ MAH.,412,366,365,38,327
SISLI,MERKEZ MAH.,410,355,351,56,295
SISLI,MERKEZ MAH.,412,346,340,42,298
SISLI,MERKEZ MAH.,412,355,350,48,302
SISLI,MERKEZ MAH.,412,369,362,76,286
SISLI,MERKEZ MAH.,411,367,362,35,327
SISLI,MERKEZ MAH.,410,352,349,52,297
SISLI,MERKEZ MAH.,412,344,338,50,288
SISLI,MERKEZ MAH.,412,370,367,63,304
SISLI,MERKEZ MAH.,412,353,349,68,281
SISLI,MERKEZ MAH.,411,364,358,63,295
SISLI,MERKEZ MAH.,411,347,344,40,304
SISLI,MERKEZ MAH.,412,364,362,54,308
SISLI,MERKEZ MAH.,411,368,362,41,321
SISLI,MERKEZ MAH.,412,361,356,54,302
SISLI,MERKEZ MAH.,411,365,363,50,313
SISLI,MERKEZ MAH.,412,376,372,47,325
SISLI,MERKEZ MAH.,411,372,369,69,300
SISLI,MERKEZ MAH.,411,366,365,42,323
SISLI,MESRUTIYET MAH.,404,306,303,67,236
SISLI,MESRUTIYET MAH.,408,322,316,54,262
SISLI,MESRUTIYET MAH.,415,354,348,64,284
SISLI,MESRUTIYET MAH.,406,350,348,75,273
SISLI,MESRUTIYET MAH.,405,369,366,82,284
SISLI,MESRUTIYET MAH.,406,355,350,75,275
SISLI,MESRUTIYET MAH.,405,357,356,68,288
SISLI,MESRUTIYET MAH.,405,342,341,68,273
SISLI,MESRUTIYET MAH.,403,361,357,69,288
SISLI,MESRUTIYET MAH.,405,359,354,68,286
SISLI,MESRUTIYET MAH.,406,360,352,74,278
SISLI,MESRUTIYET MAH.,405,361,357,77,280
SISLI,MESRUTIYET MAH.,403,346,344,98,246
SISLI,MESRUTIYET MAH.,406,361,355,61,294
SISLI,MESRUTIYET MAH.,402,362,360,95,265
SISLI,TESVIKIYE MAH.,405,327,319,19,300
SISLI,TESVIKIYE MAH.,406,332,327,37,290
SISLI,TESVIKIYE MAH.,406,350,344,30,314
SISLI,TESVIKIYE MAH.,406,358,352,32,320
SISLI,TESVIKIYE MAH.,406,372,371,39,332
SISLI,TESVIKIYE MAH.,405,368,368,30,338
SISLI,TESVIKIYE MAH.,405,371,368,50,318
SISLI,TESVIKIYE MAH.,406,370,368,44,324
SISLI,TESVIKIYE MAH.,406,368,364,40,324
SISLI,TESVIKIYE MAH.,405,369,364,49,315
SISLI,TESVIKIYE MAH.,405,375,372,41,331
SISLI,TESVIKIYE MAH.,406,370,367,25,342
SISLI,TESVIKIYE MAH.,401,313,304,19,285
SISLI,TESVIKIYE MAH.,400,306,304,23,281
SISLI,TESVIKIYE MAH.,401,348,346,29,317
SISLI,TESVIKIYE MAH.,401,366,360,36,324
SISLI,TESVIKIYE MAH.,400,342,337,34,303
SISLI,TESVIKIYE MAH.,401,355,349,53,296
SISLI,TESVIKIYE MAH.,401,365,365,30,335
SISLI,TESVIKIYE MAH.,401,355,355,42,313
SISLI,TESVIKIYE MAH.,400,357,355,26,329
SISLI,TESVIKIYE MAH.,401,360,356,25,331
SISLI,TESVIKIYE MAH.,401,369,366,45,321
SISLI,19 MAYIS MAH.,391,297,292,64,228
SISLI,19 MAYIS MAH.,391,351,350,68,282
SISLI,19 MAYIS MAH.,391,338,330,72,258
SISLI,19 MAYIS MAH.,391,333,329,68,261
SISLI,19 MAYIS MAH.,391,345,335,67,268
SISLI,19 MAYIS MAH.,390,326,319,78,241
SISLI,19 MAYIS MAH.,390,336,332,64,268
SISLI,19 MAYIS MAH.,390,339,336,69,267
SISLI,19 MAYIS MAH.,410,332,325,99,226
SISLI,19 MAYIS MAH.,410,367,366,52,314
SISLI,19 MAYIS MAH.,410,366,362,61,301
SISLI,19 MAYIS MAH.,410,352,347,84,263
SISLI,19 MAYIS MAH.,410,364,360,72,288
SISLI,19 MAYIS MAH.,410,357,355,55,300
SISLI,19 MAYIS MAH.,411,364,363,85,278
SISLI,19 MAYIS MAH.,411,363,361,85,276
SISLI,19 MAYIS MAH.,412,366,364,83,281
SISLI,19 MAYIS MAH.,411,360,356,74,282
SISLI,19 MAYIS MAH.,410,359,356,66,290
SISLI,19 MAYIS MAH.,410,361,357,70,287
SISLI,19 MAYIS MAH.,409,360,360,66,294
SISLI,BOZKURT MAH.,414,274,267,37,230
SISLI,BOZKURT MAH.,414,282,273,33,240
SISLI,BOZKURT MAH.,414,338,329,43,286
SISLI,BOZKURT MAH.,414,354,350,50,300
SISLI,BOZKURT MAH.,414,334,332,41,291
SISLI,BOZKURT MAH.,414,353,350,25,325
SISLI,BOZKURT MAH.,414,359,353,49,304
SISLI,BOZKURT MAH.,415,359,356,67,289
SISLI,BOZKURT MAH.,415,361,359,57,302
SISLI,BOZKURT MAH.,413,364,359,63,296
SISLI,BOZKURT MAH.,415,372,369,53,316
SISLI,BOZKURT MAH.,399,295,290,41,249
SISLI,BOZKURT MAH.,401,282,275,42,233
SISLI,BOZKURT MAH.,399,341,334,46,288
SISLI,BOZKURT MAH.,399,361,361,50,311
SISLI,BOZKURT MAH.,399,355,349,42,307
SISLI,BOZKURT MAH.,399,352,352,43,309
SISLI,BOZKURT MAH.,399,352,346,41,305
SISLI,BOZKURT MAH.,398,344,339,40,299
SISLI,BOZKURT MAH.,399,371,367,31,336
SISLI,BOZKURT MAH.,398,357,355,43,312
SISLI,BOZKURT MAH.,399,364,358,52,306
SISLI,DUATEPE MAH.,408,294,288,37,251
SISLI,DUATEPE MAH.,415,293,285,29,256
SISLI,DUATEPE MAH.,409,319,315,33,282
SISLI,DUATEPE MAH.,408,360,355,43,312
SISLI,DUATEPE MAH.,406,371,370,62,308
SISLI,DUATEPE MAH.,408,363,358,58,300
SISLI,DUATEPE MAH.,406,366,354,53,301
SISLI,DUATEPE MAH.,409,365,364,36,328
SISLI,DUATEPE MAH.,408,356,354,48,306
SISLI,DUATEPE MAH.,409,348,343,71,272
SISLI,DUATEPE MAH.,408,369,362,58,304
SISLI,DUATEPE MAH.,352,285,283,63,220
SISLI,DUATEPE MAH.,352,311,309,76,233
SISLI,DUATEPE MAH.,354,316,313,102,211
SISLI,DUATEPE MAH.,352,333,330,93,237
SISLI,DUATEPE MAH.,351,316,312,90,222
SISLI,DUATEPE MAH.,353,316,313,93,220
SISLI,ERGENEKON MAH.,342,263,257,55,202
SISLI,ERGENEKON MAH.,341,309,306,63,243
SISLI,ERGENEKON MAH.,341,299,295,57,238
SISLI,ERGENEKON MAH.,340,286,286,45,241
SISLI,ERGENEKON MAH.,341,286,282,42,240
SISLI,ERGENEKON MAH.,317,246,244,33,211
SISLI,ESKISEHIR MAH.,411,318,310,88,222
SISLI,ESKISEHIR MAH.,410,316,312,89,223
SISLI,ESKISEHIR MAH.,410,295,291,101,190
SISLI,ESKISEHIR MAH.,410,335,330,113,217
SISLI,ESKISEHIR MAH.,411,345,343,96,247
SISLI,ESKISEHIR MAH.,411,357,352,108,244
SISLI,ESKISEHIR MAH.,410,360,358,132,226
SISLI,ESKISEHIR MAH.,410,350,347,132,215
SISLI,ESKISEHIR MAH.,410,357,352,104,248
SISLI,ESKISEHIR MAH.,411,373,369,107,262
SISLI,ESKISEHIR MAH.,411,357,351,126,225
SISLI,ESKISEHIR MAH.,411,366,361,119,242
SISLI,ESKISEHIR MAH.,411,360,358,98,260
SISLI,ESKISEHIR MAH.,410,346,342,111,231
SISLI,ESKISEHIR MAH.,415,363,357,128,229
SISLI,ESKISEHIR MAH.,410,350,349,126,223
SISLI,ESKISEHIR MAH.,410,343,341,92,249
SISLI,ESKISEHIR MAH.,411,343,340,89,251
SISLI,ESKISEHIR MAH.,409,343,337,105,232
SISLI,ESKISEHIR MAH.,409,354,350,109,241
SISLI,ESKISEHIR MAH.,411,352,344,103,241
SISLI,ESKISEHIR MAH.,410,365,362,123,239
SISLI,FERIKOY MAH.,405,303,294,62,232
SISLI,FERIKOY MAH.,404,312,305,48,257
SISLI,FERIKOY MAH.,403,308,300,53,247
SISLI,FERIKOY MAH.,403,315,311,44,267
SISLI,FERIKOY MAH.,403,309,301,75,226
SISLI,FERIKOY MAH.,402,329,325,61,264
SISLI,FERIKOY MAH.,403,356,352,82,270
SISLI,FERIKOY MAH.,403,361,359,85,274
SISLI,FERIKOY MAH.,403,365,358,70,288
SISLI,FERIKOY MAH.,403,364,363,81,282
SISLI,FERIKOY MAH.,405,346,342,69,273
SISLI,FERIKOY MAH.,403,362,355,74,281
SISLI,FERIKOY MAH.,403,365,364,80,284
SISLI,FERIKOY MAH.,405,368,365,95,270
SISLI,FERIKOY MAH.,404,371,367,64,303
SISLI,FERIKOY MAH.,403,372,368,91,277
SISLI,FERIKOY MAH.,403,354,351,79,272
SISLI,FERIKOY MAH.,403,356,353,98,255
SISLI,FERIKOY MAH.,403,368,363,75,288
SISLI,FERIKOY MAH.,404,371,370,57,313
SISLI,FERIKOY MAH.,403,362,357,77,280
SISLI,FERIKOY MAH.,403,354,352,70,282
SISLI,FERIKOY MAH.,403,360,357,78,279
SISLI,FERIKOY MAH.,402,353,349,80,269
SISLI,FERIKOY MAH.,403,352,347,78,269
SISLI,FERIKOY MAH.,403,362,357,73,284
SISLI,FERIKOY MAH.,403,365,359,80,279
SISLI,FERIKOY MAH.,402,353,345,63,282
SISLI,FERIKOY MAH.,403,380,372,108,264
SISLI,HALIDE EDIP ADIVAR MAH.,391,341,332,147,185
SISLI,HALIDE EDIP ADIVAR MAH.,392,362,359,121,238
SISLI,HALIDE EDIP ADIVAR MAH.,392,350,347,140,207
SISLI,HALIDE EDIP ADIVAR MAH.,391,351,349,173,176
SISLI,HALIDE EDIP ADIVAR MAH.,391,369,363,151,212
SISLI,HALIDE EDIP ADIVAR MAH.,390,340,337,167,170
SISLI,HALIDE EDIP ADIVAR MAH.,393,359,355,139,216
SISLI,HALIDE EDIP ADIVAR MAH.,391,347,341,150,191
SISLI,HALIDE EDIP ADIVAR MAH.,391,357,352,143,209
SISLI,HALIDE EDIP ADIVAR MAH.,392,356,350,138,212
SISLI,HALIDE EDIP ADIVAR MAH.,391,344,336,137,199
SISLI,HALIDE EDIP ADIVAR MAH.,391,359,351,138,213
SISLI,HALIDE EDIP ADIVAR MAH.,391,354,352,135,217
SISLI,HALIDE EDIP ADIVAR MAH.,390,360,354,159,195
SISLI,HALIDE EDIP ADIVAR MAH.,399,327,322,165,157
SISLI,HALIDE EDIP ADIVAR MAH.,399,366,363,161,202
SISLI,HALIDE EDIP ADIVAR MAH.,399,353,349,139,210
SISLI,HALIDE EDIP ADIVAR MAH.,399,353,348,126,222
SISLI,HALIDE EDIP ADIVAR MAH.,399,350,345,142,203
SISLI,HALIDE EDIP ADIVAR MAH.,400,356,353,140,213
SISLI,HALIDE EDIP ADIVAR MAH.,400,350,347,148,199
SISLI,HALIDE EDIP ADIVAR MAH.,400,363,357,169,188
SISLI,HALIDE EDIP ADIVAR MAH.,398,366,360,149,211
SISLI,HALIDE EDIP ADIVAR MAH.,398,345,338,142,196
SISLI,HALIDE EDIP ADIVAR MAH.,399,354,352,132,220
SISLI,HALIDE EDIP ADIVAR MAH.,398,357,353,132,221
SISLI,HALIDE EDIP ADIVAR MAH.,399,374,370,169,201
SISLI,HALIDE EDIP ADIVAR MAH.,398,352,348,168,180
SISLI,HALIDE EDIP ADIVAR MAH.,403,357,351,145,206
SISLI,HALIDE EDIP ADIVAR MAH.,398,353,345,154,191
SISLI,HALIDE EDIP ADIVAR MAH.,399,355,348,166,182
SISLI,HALIDE EDIP ADIVAR MAH.,399,359,352,146,206
SISLI,HALIL RIFAT PASA MAH.,225,191,182,120,62
SISLI,HALIL RIFAT PASA MAH.,212,180,172,98,74
SISLI,HALIL RIFAT PASA MAH.,359,316,309,92,217
SISLI,HALIL RIFAT PASA MAH.,360,334,331,85,246
SISLI,HALIL RIFAT PASA MAH.,359,345,342,81,261
SISLI,HALIL RIFAT PASA MAH.,357,339,338,95,243
SISLI,HALIL RIFAT PASA MAH.,359,333,333,78,255
SISLI,HALIL RIFAT PASA MAH.,359,340,335,85,250
SISLI,HALIL RIFAT PASA MAH.,358,320,316,83,233
SISLI,KAPTANPASA MAH.,358,296,292,50,242
SISLI,KAPTANPASA MAH.,357,328,323,56,267
SISLI,KAPTANPASA MAH.,357,320,318,61,257
SISLI,KAPTANPASA MAH.,358,326,321,59,262
SISLI,KAPTANPASA MAH.,358,332,328,69,259
SISLI,KAPTANPASA MAH.,357,329,325,58,267
SISLI,KAPTANPASA MAH.,357,335,333,60,273
SISLI,KUSTEPE MAH.,386,309,298,147,151
SISLI,KUSTEPE MAH.,386,290,281,131,150
SISLI,KUSTEPE MAH.,389,315,312,124,188
SISLI,KUSTEPE MAH.,386,304,302,141,161
SISLI,KUSTEPE MAH.,386,309,305,133,172
SISLI,KUSTEPE MAH.,387,312,308,147,161
SISLI,KUSTEPE MAH.,385,301,299,142,157
SISLI,KUSTEPE MAH.,387,319,317,136,181
SISLI,KUSTEPE MAH.,386,322,315,135,180
SISLI,KUSTEPE MAH.,385,297,293,96,197
SISLI,KUSTEPE MAH.,415,303,299,146,153
SISLI,KUSTEPE MAH.,411,333,327,137,190
SISLI,KUSTEPE MAH.,415,344,338,160,178
SISLI,KUSTEPE MAH.,411,353,348,157,191
SISLI,KUSTEPE MAH.,410,332,327,140,187
SISLI,KUSTEPE MAH.,411,337,329,155,174
SISLI,KUSTEPE MAH.,412,348,343,185,158
SISLI,KUSTEPE MAH.,411,334,327,164,163
SISLI,KUSTEPE MAH.,409,342,335,160,175
SISLI,KUSTEPE MAH.,410,323,320,156,164
SISLI,KUSTEPE MAH.,411,351,348,189,159
SISLI,KUSTEPE MAH.,389,308,302,153,149
SISLI,KUSTEPE MAH.,389,345,342,143,199
SISLI,KUSTEPE MAH.,389,317,307,147,160
SISLI,KUSTEPE MAH.,390,308,306,149,157
SISLI,KUSTEPE MAH.,390,317,314,135,179
SISLI,KUSTEPE MAH.,389,314,308,130,178
SISLI,KUSTEPE MAH.,388,309,299,135,164
SISLI,KUSTEPE MAH.,389,331,327,167,160
SISLI,MAHMUT SEVKET PASA MAH.,404,363,360,77,283
SISLI,MAHMUT SEVKET PASA MAH.,409,351,348,86,262
SISLI,MAHMUT SEVKET PASA MAH.,404,357,350,90,260
SISLI,MAHMUT SEVKET PASA MAH.,403,358,354,72,282
SISLI,MAHMUT SEVKET PASA MAH.,404,363,359,80,279
SISLI,MAHMUT SEVKET PASA MAH.,404,366,363,76,287
SISLI,MAHMUT SEVKET PASA MAH.,403,358,356,87,269
SISLI,MAHMUT SEVKET PASA MAH.,403,371,366,89,277
SISLI,MAHMUT SEVKET PASA MAH.,404,358,353,72,281
SISLI,MAHMUT SEVKET PASA MAH.,404,368,363,121,242
SISLI,MAHMUT SEVKET PASA MAH.,403,359,355,101,254
SISLI,MAHMUT SEVKET PASA MAH.,404,371,363,83,280
SISLI,MAHMUT SEVKET PASA MAH.,403,360,353,89,264
SISLI,MAHMUT SEVKET PASA MAH.,403,363,355,85,270
SISLI,MAHMUT SEVKET PASA MAH.,403,365,357,116,241
SISLI,MAHMUT SEVKET PASA MAH.,404,359,356,90,266
SISLI,MAHMUT SEVKET PASA MAH.,404,348,342,92,250
SISLI,MAHMUT SEVKET PASA MAH.,404,371,368,89,279
SISLI,MAHMUT SEVKET PASA MAH.,403,374,369,104,265
SISLI,MAHMUT SEVKET PASA MAH.,404,362,358,86,272
SISLI,MAHMUT SEVKET PASA MAH.,404,359,357,100,257
SISLI,MAHMUT SEVKET PASA MAH.,403,370,368,115,253
SISLI,MAHMUT SEVKET PASA MAH.,403,370,365,90,275
SISLI,MAHMUT SEVKET PASA MAH.,404,366,363,102,261
SISLI,MAHMUT SEVKET PASA MAH.,403,367,361,96,265
SISLI,MAHMUT SEVKET PASA MAH.,403,372,366,70,296
SISLI,MAHMUT SEVKET PASA MAH.,404,379,371,94,277
SISLI,MAHMUT SEVKET PASA MAH.,403,363,359,100,259
SISLI,MAHMUT SEVKET PASA MAH.,403,379,368,102,266
SISLI,MAHMUT SEVKET PASA MAH.,404,374,372,83,289
SISLI,MAHMUT SEVKET PASA MAH.,404,359,354,92,262
SISLI,MAHMUT SEVKET PASA MAH.,403,353,348,82,266
SISLI,MAHMUT SEVKET PASA MAH.,404,364,359,75,284
SISLI,MAHMUT SEVKET PASA MAH.,404,376,372,81,291
SISLI,MAHMUT SEVKET PASA MAH.,404,376,373,93,280
SISLI,PASA MAH.,391,316,308,111,197
SISLI,PASA MAH.,390,331,329,120,209
SISLI,PASA MAH.,391,344,341,144,197
SISLI,PASA MAH.,391,352,347,114,233
SISLI,PASA MAH.,391,352,348,157,191
SISLI,PASA MAH.,391,343,338,93,245
SISLI,PASA MAH.,391,347,341,160,181
SISLI,PASA MAH.,390,341,335,138,197
SISLI,PASA MAH.,392,344,341,143,198
SISLI,PASA MAH.,390,350,345,159,186
SISLI,PASA MAH.,391,338,335,136,199
SISLI,PASA MAH.,392,346,342,122,220
SISLI,PASA MAH.,391,349,343,137,206
SISLI,PASA MAH.,392,318,316,153,163
SISLI,PASA MAH.,392,347,343,177,166
SISLI,PASA MAH.,393,355,355,188,167
SISLI,PASA MAH.,392,354,349,141,208
SISLI,PASA MAH.,391,349,346,146,200
SISLI,PASA MAH.,391,351,348,146,202
SISLI,PASA MAH.,391,336,331,149,182
SISLI,PASA MAH.,392,354,349,150,199
SISLI,PASA MAH.,387,315,310,116,194
SISLI,PASA MAH.,387,343,340,138,202
SISLI,PASA MAH.,389,347,340,151,189
SISLI,PASA MAH.,387,340,340,144,196
SISLI,PASA MAH.,390,352,343,149,194
SISLI,PASA MAH.,387,340,336,114,222
SISLI,PASA MAH.,386,361,358,144,214
SISLI,PASA MAH.,387,336,331,150,181
SISLI,PASA MAH.,387,347,345,138,207
SISLI,PASA MAH.,386,346,335,152,183
SISLI,PASA MAH.,387,333,329,118,211
SISLI,PASA MAH.,386,344,342,137,205
SISLI,PASA MAH.,386,341,335,155,180
SISLI,YAYLA MAH.,407,318,310,163,147
SISLI,YAYLA MAH.,415,349,341,139,202
SISLI,YAYLA MAH.,409,362,356,169,187
SISLI,YAYLA MAH.,409,343,337,149,188
SISLI,YAYLA MAH.,409,374,368,172,196
SISLI,YAYLA MAH.,409,359,355,179,176
SISLI,YAYLA MAH.,410,358,354,147,207
SISLI,YAYLA MAH.,410,379,373,185,188
SISLI,YAYLA MAH.,409,350,348,163,185
SISLI,YAYLA MAH.,408,356,348,161,187
SISLI,YAYLA MAH.,408,363,361,173,188
SISLI,YAYLA MAH.,409,340,337,142,195
SISLI,YAYLA MAH.,408,363,358,193,165
SISLI,YAYLA MAH.,408,354,350,164,186
SISLI,YAYLA MAH.,408,359,352,162,190
SISLI,YAYLA MAH.,408,374,371,173,198
SISLI,YAYLA MAH.,409,360,355,164,191
SISLI,YAYLA MAH.,408,377,368,164,204
SISLI,YAYLA MAH.,411,383,380,191,189
SISLI,YAYLA MAH.,408,364,358,174,184
AVCILAR,AMBARLI MAH.,415,335,330,104,226
AVCILAR,AMBARLI MAH.,409,325,316,86,230
AVCILAR,AMBARLI MAH.,410,327,325,96,229
AVCILAR,AMBARLI MAH.,411,358,356,114,242
AVCILAR,AMBARLI MAH.,415,366,361,133,228
AVCILAR,AMBARLI MAH.,411,359,355,100,255
AVCILAR,AMBARLI MAH.,410,363,362,116,246
AVCILAR,AMBARLI MAH.,410,370,366,120,246
AVCILAR,AMBARLI MAH.,411,351,346,128,218
AVCILAR,AMBARLI MAH.,411,363,363,95,268
AVCILAR,AMBARLI MAH.,411,357,356,114,242
AVCILAR,AMBARLI MAH.,409,359,356,120,236
AVCILAR,AMBARLI MAH.,409,364,363,111,252
AVCILAR,AMBARLI MAH.,410,369,365,106,259
AVCILAR,AMBARLI MAH.,411,352,345,84,261
AVCILAR,AMBARLI MAH.,409,363,358,114,244
AVCILAR,AMBARLI MAH.,411,356,353,124,229
AVCILAR,AMBARLI MAH.,411,357,353,127,226
AVCILAR,AMBARLI MAH.,409,375,372,116,256
AVCILAR,AMBARLI MAH.,410,366,361,114,247
AVCILAR,AMBARLI MAH.,411,365,362,126,236
AVCILAR,AMBARLI MAH.,410,377,372,129,243
AVCILAR,AMBARLI MAH.,410,367,364,131,233
AVCILAR,AMBARLI MAH.,410,355,352,129,223
AVCILAR,AMBARLI MAH.,411,347,335,103,232
AVCILAR,AMBARLI MAH.,411,354,350,106,244
AVCILAR,AMBARLI MAH.,410,375,371,139,232
AVCILAR,AMBARLI MAH.,409,364,362,119,243
AVCILAR,AMBARLI MAH.,411,352,344,131,213
AVCILAR,AMBARLI MAH.,411,363,358,109,249
AVCILAR,AMBARLI MAH.,415,337,334,127,207
AVCILAR,AMBARLI MAH.,415,342,338,110,228
AVCILAR,AMBARLI MAH.,415,360,355,150,205
AVCILAR,AMBARLI MAH.,415,365,358,121,237
AVCILAR,AMBARLI MAH.,415,368,363,140,223
AVCILAR,AMBARLI MAH.,415,352,351,147,204
AVCILAR,AMBARLI MAH.,414,359,357,136,221
AVCILAR,AMBARLI MAH.,415,352,343,152,191
AVCILAR,AMBARLI MAH.,415,346,343,118,225
AVCILAR,AMBARLI MAH.,414,358,353,161,192
AVCILAR,AMBARLI MAH.,415,355,350,151,199
AVCILAR,AMBARLI MAH.,415,368,367,133,234
AVCILAR,AMBARLI MAH.,412,360,357,140,217
AVCILAR,AMBARLI MAH.,415,376,374,148,226
AVCILAR,AMBARLI MAH.,414,349,344,154,190
AVCILAR,AMBARLI MAH.,415,356,345,147,198
AVCILAR,AMBARLI MAH.,414,368,363,130,233
AVCILAR,AMBARLI MAH.,414,363,358,148,210
AVCILAR,AMBARLI MAH.,415,368,363,134,229
AVCILAR,AMBARLI MAH.,415,360,357,139,218
AVCILAR,AMBARLI MAH.,413,357,348,122,226
AVCILAR,AMBARLI MAH.,415,336,330,105,225
AVCILAR,AMBARLI MAH.,416,324,318,114,204
AVCILAR,AMBARLI MAH.,415,364,362,138,224
AVCILAR,AMBARLI MAH.,418,350,347,146,201
AVCILAR,AMBARLI MAH.,416,364,359,132,227
AVCILAR,AMBARLI MAH.,415,359,354,125,229
AVCILAR,AMBARLI MAH.,418,364,359,132,227
AVCILAR,AMBARLI MAH.,416,368,361,113,248
AVCILAR,AMBARLI MAH.,415,360,355,131,224
AVCILAR,AMBARLI MAH.,415,368,363,133,230
AVCILAR,AMBARLI MAH.,415,364,356,132,224
AVCILAR,AMBARLI MAH.,415,363,358,124,234
AVCILAR,AMBARLI MAH.,414,365,359,145,214
AVCILAR,AMBARLI MAH.,415,361,349,137,212
AVCILAR,AMBARLI MAH.,414,369,366,154,212
AVCILAR,AMBARLI MAH.,414,351,344,124,220
AVCILAR,AMBARLI MAH.,414,357,350,110,240
AVCILAR,AMBARLI MAH.,415,357,352,120,232
AVCILAR,AMBARLI MAH.,415,373,372,138,234
AVCILAR,CIHANGIR MAH.,406,334,331,158,173
AVCILAR,CIHANGIR MAH.,407,336,328,151,177
AVCILAR,CIHANGIR MAH.,406,352,348,121,227
AVCILAR,CIHANGIR MAH.,406,343,338,177,161
AVCILAR,CIHANGIR MAH.,408,358,352,178,174
AVCILAR,CIHANGIR MAH.,407,350,350,148,202
AVCILAR,CIHANGIR MAH.,407,354,352,156,196
AVCILAR,CIHANGIR MAH.,407,344,341,163,178
AVCILAR,CIHANGIR MAH.,406,369,363,172,191
AVCILAR,CIHANGIR MAH.,406,360,356,170,186
AVCILAR,CIHANGIR MAH.,407,374,370,145,225
AVCILAR,CIHANGIR MAH.,407,363,357,156,201
AVCILAR,CIHANGIR MAH.,405,351,347,122,225
AVCILAR,CIHANGIR MAH.,406,330,325,133,192
AVCILAR,CIHANGIR MAH.,407,356,350,149,201
AVCILAR,CIHANGIR MAH.,407,358,351,158,193
AVCILAR,CIHANGIR MAH.,406,361,360,188,172
AVCILAR,CIHANGIR MAH.,401,334,326,152,174
AVCILAR,CIHANGIR MAH.,398,345,337,171,166
AVCILAR,CIHANGIR MAH.,399,360,357,163,194
AVCILAR,CIHANGIR MAH.,398,350,348,166,182
AVCILAR,CIHANGIR MAH.,397,345,341,125,216
AVCILAR,CIHANGIR MAH.,398,352,348,133,215
AVCILAR,CIHANGIR MAH.,397,344,341,145,196
AVCILAR,CIHANGIR MAH.,397,341,336,139,197
AVCILAR,CIHANGIR MAH.,398,356,349,160,189
AVCILAR,CIHANGIR MAH.,397,345,344,120,224
AVCILAR,CIHANGIR MAH.,397,363,361,158,203
AVCILAR,CIHANGIR MAH.,397,350,345,140,205
AVCILAR,CIHANGIR MAH.,399,348,346,165,181
AVCILAR,CIHANGIR MAH.,404,327,321,116,205
AVCILAR,CIHANGIR MAH.,403,322,315,112,203
AVCILAR,CIHANGIR MAH.,403,339,330,132,198
AVCILAR,CIHANGIR MAH.,406,351,349,143,206
AVCILAR,CIHANGIR MAH.,403,354,350,125,225
AVCILAR,CIHANGIR MAH.,403,358,355,122,233
AVCILAR,CIHANGIR MAH.,403,365,359,150,209
AVCILAR,CIHANGIR MAH.,403,339,334,121,213
AVCILAR,CIHANGIR MAH.,403,370,364,136,228
AVCILAR,CIHANGIR MAH.,402,349,346,113,233
AVCILAR,CIHANGIR MAH.,404,364,361,140,221
AVCILAR,CIHANGIR MAH.,405,349,347,133,214
AVCILAR,CIHANGIR MAH.,406,350,345,131,214
AVCILAR,CIHANGIR MAH.,404,359,357,136,221
AVCILAR,CIHANGIR MAH.,403,362,359,143,216
AVCILAR,CIHANGIR MAH.,403,345,341,139,202
AVCILAR,CIHANGIR MAH.,402,345,343,143,200
AVCILAR,CIHANGIR MAH.,403,336,332,129,203
AVCILAR,CIHANGIR MAH.,402,356,349,133,216
AVCILAR,CIHANGIR MAH.,403,343,339,113,226
AVCILAR,CIHANGIR MAH.,403,335,329,113,216
AVCILAR,CIHANGIR MAH.,402,346,340,123,217
AVCILAR,CIHANGIR MAH.,404,346,345,141,204
AVCILAR,CIHANGIR MAH.,402,342,340,128,212
AVCILAR,CIHANGIR MAH.,403,366,359,145,214
AVCILAR,CIHANGIR MAH.,403,355,352,140,212
AVCILAR,CIHANGIR MAH.,403,354,351,117,234
AVCILAR,CIHANGIR MAH.,403,355,349,151,198
AVCILAR,CIHANGIR MAH.,402,352,349,144,205
AVCILAR,CIHANGIR MAH.,410,343,338,130,208
AVCILAR,CIHANGIR MAH.,412,328,322,115,207
AVCILAR,CIHANGIR MAH.,412,331,321,124,197
AVCILAR,CIHANGIR MAH.,412,355,353,144,209
AVCILAR,CIHANGIR MAH.,411,338,334,118,216
AVCILAR,CIHANGIR MAH.,412,361,359,141,218
AVCILAR,CIHANGIR MAH.,411,358,356,152,204
AVCILAR,CIHANGIR MAH.,411,354,352,139,213
AVCILAR,CIHANGIR MAH.,411,355,351,146,205
AVCILAR,CIHANGIR MAH.,411,342,340,169,171
AVCILAR,CIHANGIR MAH.,411,353,347,148,199
AVCILAR,CIHANGIR MAH.,412,360,354,140,214
AVCILAR,CIHANGIR MAH.,411,370,364,142,222
AVCILAR,CIHANGIR MAH.,411,362,361,167,194
AVCILAR,CIHANGIR MAH.,412,354,350,167,183
AVCILAR,CIHANGIR MAH.,411,367,366,170,196
AVCILAR,CIHANGIR MAH.,411,355,354,168,186
AVCILAR,CIHANGIR MAH.,412,369,366,169,197
AVCILAR,CIHANGIR MAH.,411,351,349,178,171
AVCILAR,CIHANGIR MAH.,412,374,369,165,204
AVCILAR,CIHANGIR MAH.,411,339,336,124,212
AVCILAR,CIHANGIR MAH.,411,350,349,150,199
AVCILAR,CIHANGIR MAH.,411,351,348,153,195
AVCILAR,CIHANGIR MAH.,411,354,350,166,184
AVCILAR,CIHANGIR MAH.,411,358,353,172,181
AVCILAR,CIHANGIR MAH.,411,362,354,151,203
AVCILAR,CIHANGIR MAH.,411,348,346,143,203
AVCILAR,CIHANGIR MAH.,411,362,357,137,220
AVCILAR,CIHANGIR MAH.,412,359,354,156,198
AVCILAR,CIHANGIR MAH.,415,338,327,113,214
AVCILAR,CIHANGIR MAH.,411,310,308,124,184
AVCILAR,CIHANGIR MAH.,415,360,356,136,220
AVCILAR,CIHANGIR MAH.,415,360,355,180,175
AVCILAR,CIHANGIR MAH.,413,355,355,122,233
AVCILAR,CIHANGIR MAH.,415,368,364,157,207
AVCILAR,CIHANGIR MAH.,410,349,346,139,207
AVCILAR,CIHANGIR MAH.,412,354,349,156,193
AVCILAR,CIHANGIR MAH.,411,357,352,158,194
AVCILAR,CIHANGIR MAH.,411,353,350,154,196
AVCILAR,CIHANGIR MAH.,412,380,379,155,224
AVCILAR,CIHANGIR MAH.,412,350,345,131,214
AVCILAR,CIHANGIR MAH.,412,351,347,154,193
AVCILAR,CIHANGIR MAH.,412,360,356,130,226
AVCILAR,CIHANGIR MAH.,412,357,356,172,184
AVCILAR,CIHANGIR MAH.,411,360,352,178,174
AVCILAR,CIHANGIR MAH.,410,366,365,172,193
AVCILAR,CIHANGIR MAH.,412,344,344,136,208
AVCILAR,CIHANGIR MAH.,412,347,343,160,183
AVCILAR,CIHANGIR MAH.,412,359,354,160,194
AVCILAR,CIHANGIR MAH.,411,346,342,133,209
AVCILAR,CIHANGIR MAH.,411,360,356,137,219
AVCILAR,CIHANGIR MAH.,411,366,365,154,211
AVCILAR,CIHANGIR MAH.,412,338,332,130,202
AVCILAR,DENIZKOSKLER MAH.,409,339,334,106,228
AVCILAR,DENIZKOSKLER MAH.,409,342,335,112,223
AVCILAR,DENIZKOSKLER MAH.,409,332,327,106,221
AVCILAR,DENIZKOSKLER MAH.,409,355,351,101,250
AVCILAR,DENIZKOSKLER MAH.,409,359,353,115,238
AVCILAR,DENIZKOSKLER MAH.,409,342,340,120,220
AVCILAR,DENIZKOSKLER MAH.,408,345,340,129,211
AVCILAR,DENIZKOSKLER MAH.,409,354,352,112,240
AVCILAR,DENIZKOSKLER MAH.,409,364,360,103,257
AVCILAR,DENIZKOSKLER MAH.,408,371,368,131,237
AVCILAR,DENIZKOSKLER MAH.,407,360,356,107,249
AVCILAR,DENIZKOSKLER MAH.,409,363,361,119,242
AVCILAR,DENIZKOSKLER MAH.,409,368,364,124,240
AVCILAR,DENIZKOSKLER MAH.,409,347,344,115,229
AVCILAR,DENIZKOSKLER MAH.,409,356,353,147,206
AVCILAR,DENIZKOSKLER MAH.,409,364,362,127,235
AVCILAR,DENIZKOSKLER MAH.,408,336,333,114,219
AVCILAR,DENIZKOSKLER MAH.,408,370,363,129,234
AVCILAR,DENIZKOSKLER MAH.,408,363,358,101,257
AVCILAR,DENIZKOSKLER MAH.,407,345,342,126,216
AVCILAR,DENIZKOSKLER MAH.,408,357,354,133,221
AVCILAR,DENIZKOSKLER MAH.,408,374,368,119,249
AVCILAR,DENIZKOSKLER MAH.,409,374,371,123,248
AVCILAR,DENIZKOSKLER MAH.,409,358,350,131,219
AVCILAR,DENIZKOSKLER MAH.,409,351,348,108,240
AVCILAR,DENIZKOSKLER MAH.,409,362,356,102,254
AVCILAR,DENIZKOSKLER MAH.,409,353,348,116,232
AVCILAR,DENIZKOSKLER MAH.,408,355,350,114,236
AVCILAR,DENIZKOSKLER MAH.,408,354,346,119,227
AVCILAR,DENIZKOSKLER MAH.,408,367,360,117,243
AVCILAR,DENIZKOSKLER MAH.,408,351,347,111,236
AVCILAR,DENIZKOSKLER MAH.,409,369,366,137,229
AVCILAR,DENIZKOSKLER MAH.,403,320,315,100,215
AVCILAR,DENIZKOSKLER MAH.,405,303,301,100,201
AVCILAR,DENIZKOSKLER MAH.,405,329,317,114,203
AVCILAR,DENIZKOSKLER MAH.,405,352,349,118,231
AVCILAR,DENIZKOSKLER MAH.,405,354,352,111,241
AVCILAR,DENIZKOSKLER MAH.,403,346,341,125,216
AVCILAR,DENIZKOSKLER MAH.,406,355,353,132,221
AVCILAR,DENIZKOSKLER MAH.,404,346,342,135,207
AVCILAR,DENIZKOSKLER MAH.,405,362,358,125,233
AVCILAR,DENIZKOSKLER MAH.,403,346,343,121,222
AVCILAR,DENIZKOSKLER MAH.,405,361,356,126,230
AVCILAR,DENIZKOSKLER MAH.,405,352,344,139,205
AVCILAR,DENIZKOSKLER MAH.,404,361,354,136,218
AVCILAR,DENIZKOSKLER MAH.,405,364,359,132,227
AVCILAR,DENIZKOSKLER MAH.,404,359,356,132,224
AVCILAR,DENIZKOSKLER MAH.,404,362,358,170,188
AVCILAR,DENIZKOSKLER MAH.,405,351,350,135,215
AVCILAR,DENIZKOSKLER MAH.,405,351,348,131,217
AVCILAR,DENIZKOSKLER MAH.,405,350,343,136,207
AVCILAR,DENIZKOSKLER MAH.,405,332,327,109,218
AVCILAR,DENIZKOSKLER MAH.,405,356,352,143,209
AVCILAR,DENIZKOSKLER MAH.,407,342,337,108,229
AVCILAR,DENIZKOSKLER MAH.,405,360,357,143,214
AVCILAR,DENIZKOSKLER MAH.,404,347,339,122,217
AVCILAR,DENIZKOSKLER MAH.,408,353,351,119,232
AVCILAR,DENIZKOSKLER MAH.,405,353,350,128,222
AVCILAR,DENIZKOSKLER MAH.,403,352,349,145,204
AVCILAR,DENIZKOSKLER MAH.,405,350,345,99,246
AVCILAR,DENIZKOSKLER MAH.,405,357,356,135,221
AVCILAR,DENIZKOSKLER MAH.,405,349,344,130,214
AVCILAR,DENIZKOSKLER MAH.,406,344,336,139,197
AVCILAR,DENIZKOSKLER MAH.,405,345,341,114,227
AVCILAR,DENIZKOSKLER MAH.,404,351,347,159,188
AVCILAR,DENIZKOSKLER MAH.,415,336,330,123,207
AVCILAR,DENIZKOSKLER MAH.,415,348,342,104,238
AVCILAR,DENIZKOSKLER MAH.,409,365,362,151,211
AVCILAR,DENIZKOSKLER MAH.,409,345,343,133,210
AVCILAR,DENIZKOSKLER MAH.,409,353,348,126,222
AVCILAR,DENIZKOSKLER MAH.,408,360,352,138,214
AVCILAR,DENIZKOSKLER MAH.,408,346,341,130,211
AVCILAR,DENIZKOSKLER MAH.,407,354,350,140,210
AVCILAR,DENIZKOSKLER MAH.,409,360,357,146,211
AVCILAR,DENIZKOSKLER MAH.,407,333,327,119,208
AVCILAR,DENIZKOSKLER MAH.,408,353,346,141,205
AVCILAR,DENIZKOSKLER MAH.,409,359,355,147,208
AVCILAR,DENIZKOSKLER MAH.,409,341,336,130,206
AVCILAR,DENIZKOSKLER MAH.,407,348,345,126,219
AVCILAR,DENIZKOSKLER MAH.,409,345,341,135,206
AVCILAR,DENIZKOSKLER MAH.,409,356,354,141,213
AVCILAR,DENIZKOSKLER MAH.,408,362,358,157,201
AVCILAR,DENIZKOSKLER MAH.,408,348,346,161,185
AVCILAR,GUMUSPALA MAH.,411,325,319,127,192
AVCILAR,GUMUSPALA MAH.,412,340,333,119,214
AVCILAR,GUMUSPALA MAH.,415,356,353,161,192
AVCILAR,GUMUSPALA MAH.,415,372,364,163,201
AVCILAR,GUMUSPALA MAH.,412,370,368,129,239
AVCILAR,GUMUSPALA MAH.,410,356,350,154,196
AVCILAR,GUMUSPALA MAH.,411,360,356,150,206
AVCILAR,GUMUSPALA MAH.,411,361,352,171,181
AVCILAR,GUMUSPALA MAH.,411,357,353,160,193
AVCILAR,GUMUSPALA MAH.,410,361,359,166,193
AVCILAR,GUMUSPALA MAH.,415,368,363,155,208
AVCILAR,GUMUSPALA MAH.,411,371,369,153,216
AVCILAR,GUMUSPALA MAH.,411,360,357,162,195
AVCILAR,GUMUSPALA MAH.,415,366,363,152,211
AVCILAR,GUMUSPALA MAH.,415,368,365,175,190
AVCILAR,GUMUSPALA MAH.,410,363,361,157,204
AVCILAR,GUMUSPALA MAH.,411,369,368,136,232
AVCILAR,GUMUSPALA MAH.,399,328,322,129,193
AVCILAR,GUMUSPALA MAH.,400,343,337,135,202
AVCILAR,GUMUSPALA MAH.,399,356,349,168,181
AVCILAR,GUMUSPALA MAH.,400,350,348,143,205
AVCILAR,GUMUSPALA MAH.,399,337,335,138,197
AVCILAR,GUMUSPALA MAH.,399,368,362,154,208
AVCILAR,GUMUSPALA MAH.,400,347,341,117,224
AVCILAR,GUMUSPALA MAH.,400,331,328,147,181
AVCILAR,GUMUSPALA MAH.,400,352,347,154,193
AVCILAR,GUMUSPALA MAH.,399,351,347,113,234
AVCILAR,GUMUSPALA MAH.,400,348,346,135,211
AVCILAR,GUMUSPALA MAH.,399,365,361,174,187
AVCILAR,GUMUSPALA MAH.,400,352,347,143,204
AVCILAR,GUMUSPALA MAH.,402,356,349,159,190
AVCILAR,GUMUSPALA MAH.,400,365,362,163,199
AVCILAR,GUMUSPALA MAH.,400,331,326,154,172
AVCILAR,GUMUSPALA MAH.,399,350,347,163,184
AVCILAR,GUMUSPALA MAH.,400,350,347,139,208
AVCILAR,GUMUSPALA MAH.,399,357,349,134,215
AVCILAR,GUMUSPALA MAH.,399,350,348,134,214
AVCILAR,GUMUSPALA MAH.,401,353,350,130,220
AVCILAR,GUMUSPALA MAH.,399,331,324,138,186
AVCILAR,GUMUSPALA MAH.,402,348,344,138,206
AVCILAR,GUMUSPALA MAH.,399,356,355,165,190
AVCILAR,GUMUSPALA MAH.,399,344,339,171,168
AVCILAR,GUMUSPALA MAH.,401,339,337,164,173
AVCILAR,GUMUSPALA MAH.,400,355,354,170,184
AVCILAR,GUMUSPALA MAH.,400,370,362,167,195
AVCILAR,GUMUSPALA MAH.,399,361,358,181,177
AVCILAR,GUMUSPALA MAH.,399,354,349,163,186
AVCILAR,GUMUSPALA MAH.,399,364,362,173,189
AVCILAR,GUMUSPALA MAH.,399,367,361,161,200
AVCILAR,GUMUSPALA MAH.,403,354,349,175,174
AVCILAR,GUMUSPALA MAH.,399,347,340,169,171
AVCILAR,GUMUSPALA MAH.,400,357,355,164,191
AVCILAR,GUMUSPALA MAH.,399,352,348,151,197
AVCILAR,GUMUSPALA MAH.,399,346,340,175,165
AVCILAR,GUMUSPALA MAH.,398,359,354,174,180
AVCILAR,GUMUSPALA MAH.,398,343,339,146,193
AVCILAR,GUMUSPALA MAH.,398,353,349,156,193
AVCILAR,GUMUSPALA MAH.,399,336,329,127,202
AVCILAR,GUMUSPALA MAH.,397,327,326,147,179
AVCILAR,GUMUSPALA MAH.,397,370,365,167,198
AVCILAR,GUMUSPALA MAH.,397,358,355,158,197
AVCILAR,GUMUSPALA MAH.,398,353,343,150,193
AVCILAR,GUMUSPALA MAH.,397,347,344,181,163
AVCILAR,GUMUSPALA MAH.,398,370,368,180,188
AVCILAR,GUMUSPALA MAH.,398,363,360,177,183
AVCILAR,GUMUSPALA MAH.,397,351,347,173,174
AVCILAR,GUMUSPALA MAH.,397,357,354,192,162
AVCILAR,GUMUSPALA MAH.,398,350,348,151,197
AVCILAR,GUMUSPALA MAH.,397,354,350,154,196
AVCILAR,GUMUSPALA MAH.,397,352,348,150,198
AVCILAR,GUMUSPALA MAH.,398,352,350,141,209
AVCILAR,GUMUSPALA MAH.,398,337,329,159,170
AVCILAR,GUMUSPALA MAH.,398,338,337,179,158
AVCILAR,GUMUSPALA MAH.,397,349,346,164,182
AVCILAR,MERKEZ MAH.,400,321,315,111,204
AVCILAR,MERKEZ MAH.,400,309,305,98,207
AVCILAR,MERKEZ MAH.,400,335,328,119,209
AVCILAR,MERKEZ MAH.,400,355,352,114,238
AVCILAR,MERKEZ MAH.,400,330,324,106,218
AVCILAR,MERKEZ MAH.,401,347,345,123,222
AVCILAR,MERKEZ MAH.,400,361,361,149,212
AVCILAR,MERKEZ MAH.,400,343,338,123,215
AVCILAR,MERKEZ MAH.,400,347,339,127,212
AVCILAR,MERKEZ MAH.,399,337,336,108,228
AVCILAR,MERKEZ MAH.,401,335,333,127,206
AVCILAR,MERKEZ MAH.,400,353,349,106,243
AVCILAR,MERKEZ MAH.,400,360,359,123,236
AVCILAR,MERKEZ MAH.,399,351,348,119,229
AVCILAR,MERKEZ MAH.,400,354,350,129,221
AVCILAR,MERKEZ MAH.,400,360,358,142,216
AVCILAR,MERKEZ MAH.,401,347,341,117,224
AVCILAR,MERKEZ MAH.,400,355,350,113,237
AVCILAR,MERKEZ MAH.,399,348,347,127,220
AVCILAR,MERKEZ MAH.,401,356,352,121,231
AVCILAR,MERKEZ MAH.,399,347,344,91,253
AVCILAR,MERKEZ MAH.,400,354,353,126,227
AVCILAR,MERKEZ MAH.,415,333,329,116,213
AVCILAR,MERKEZ MAH.,415,333,328,94,234
AVCILAR,MERKEZ MAH.,415,343,342,94,248
AVCILAR,MERKEZ MAH.,415,367,364,141,223
AVCILAR,MERKEZ MAH.,415,366,366,123,243
AVCILAR,MERKEZ MAH.,416,357,354,119,235
AVCILAR,MERKEZ MAH.,415,358,353,102,251
AVCILAR,MERKEZ MAH.,416,378,375,124,251
AVCILAR,MERKEZ MAH.,417,379,375,125,250
AVCILAR,MERKEZ MAH.,417,373,370,120,250
AVCILAR,MERKEZ MAH.,416,366,362,121,241
AVCILAR,MERKEZ MAH.,418,382,378,141,237
AVCILAR,MERKEZ MAH.,416,362,355,125,230
AVCILAR,MERKEZ MAH.,415,350,349,112,237
AVCILAR,MERKEZ MAH.,415,355,353,98,255
AVCILAR,MERKEZ MAH.,414,353,349,133,216
AVCILAR,MERKEZ MAH.,415,357,352,152,200
AVCILAR,MERKEZ MAH.,414,372,369,138,231
AVCILAR,MERKEZ MAH.,415,362,356,129,227
AVCILAR,MERKEZ MAH.,415,362,361,107,254
AVCILAR,MERKEZ MAH.,414,380,375,124,251
AVCILAR,MERKEZ MAH.,415,355,348,131,217
AVCILAR,MERKEZ MAH.,414,338,334,102,232
AVCILAR,MERKEZ MAH.,415,333,327,85,242
AVCILAR,MERKEZ MAH.,415,366,364,110,254
AVCILAR,MERKEZ MAH.,416,366,366,115,251
AVCILAR,MERKEZ MAH.,415,349,345,106,239
AVCILAR,MERKEZ MAH.,415,357,354,146,208
AVCILAR,MERKEZ MAH.,415,379,369,133,236
AVCILAR,MERKEZ MAH.,418,355,353,108,245
AVCILAR,MERKEZ MAH.,415,367,364,127,237
AVCILAR,MERKEZ MAH.,415,348,346,115,231
AVCILAR,MERKEZ MAH.,414,360,356,121,235
AVCILAR,MERKEZ MAH.,417,359,356,122,234
AVCILAR,MERKEZ MAH.,414,347,341,122,219
AVCILAR,MERKEZ MAH.,415,356,354,122,232
AVCILAR,MERKEZ MAH.,414,360,358,126,232
AVCILAR,FIRUZKOY MAH.,409,377,369,91,278
AVCILAR,FIRUZKOY MAH.,409,365,359,103,256
AVCILAR,FIRUZKOY MAH.,408,373,371,95,276
AVCILAR,FIRUZKOY MAH.,409,375,370,98,272
AVCILAR,FIRUZKOY MAH.,410,371,362,78,284
AVCILAR,FIRUZKOY MAH.,409,372,364,99,265
AVCILAR,FIRUZKOY MAH.,408,381,375,106,269
AVCILAR,FIRUZKOY MAH.,409,370,366,94,272
AVCILAR,FIRUZKOY MAH.,410,386,383,81,302
AVCILAR,FIRUZKOY MAH.,409,363,361,94,267
AVCILAR,FIRUZKOY MAH.,408,382,378,96,282
AVCILAR,FIRUZKOY MAH.,409,385,377,73,304
AVCILAR,FIRUZKOY MAH.,408,376,373,103,270
AVCILAR,FIRUZKOY MAH.,409,357,354,97,257
AVCILAR,FIRUZKOY MAH.,409,382,373,109,264
AVCILAR,FIRUZKOY MAH.,408,372,367,98,269
AVCILAR,FIRUZKOY MAH.,408,365,363,89,274
AVCILAR,FIRUZKOY MAH.,408,366,363,89,274
AVCILAR,FIRUZKOY MAH.,408,365,362,94,268
AVCILAR,FIRUZKOY MAH.,408,372,368,117,251
AVCILAR,FIRUZKOY MAH.,410,368,362,111,251
AVCILAR,FIRUZKOY MAH.,408,380,374,108,266
AVCILAR,FIRUZKOY MAH.,407,366,360,116,244
AVCILAR,FIRUZKOY MAH.,408,378,374,100,274
AVCILAR,FIRUZKOY MAH.,412,371,369,100,269
AVCILAR,FIRUZKOY MAH.,407,376,370,91,279
AVCILAR,FIRUZKOY MAH.,409,355,354,93,261
AVCILAR,FIRUZKOY MAH.,407,380,376,98,278
AVCILAR,FIRUZKOY MAH.,383,313,308,63,245
AVCILAR,FIRUZKOY MAH.,381,332,325,69,256
AVCILAR,FIRUZKOY MAH.,382,335,333,89,244
AVCILAR,FIRUZKOY MAH.,382,344,342,86,256
AVCILAR,FIRUZKOY MAH.,382,343,338,95,243
AVCILAR,FIRUZKOY MAH.,382,352,351,98,253
AVCILAR,FIRUZKOY MAH.,384,331,328,79,249
AVCILAR,FIRUZKOY MAH.,382,335,331,73,258
AVCILAR,FIRUZKOY MAH.,383,352,348,103,245
AVCILAR,FIRUZKOY MAH.,383,343,339,78,261
AVCILAR,FIRUZKOY MAH.,382,343,342,98,244
AVCILAR,FIRUZKOY MAH.,382,343,337,85,252
AVCILAR,MUSTAFA KEMALPASA MAH.,397,330,325,131,194
AVCILAR,MUSTAFA KEMALPASA MAH.,397,335,331,151,180
AVCILAR,MUSTAFA KEMALPASA MAH.,397,354,349,166,183
AVCILAR,MUSTAFA KEMALPASA MAH.,397,355,351,145,206
AVCILAR,MUSTAFA KEMALPASA MAH.,397,346,340,125,215
AVCILAR,MUSTAFA KEMALPASA MAH.,397,347,344,163,181
AVCILAR,MUSTAFA KEMALPASA MAH.,396,367,363,172,191
AVCILAR,MUSTAFA KEMALPASA MAH.,395,361,358,159,199
AVCILAR,MUSTAFA KEMALPASA MAH.,396,359,358,173,185
AVCILAR,MUSTAFA KEMALPASA MAH.,395,347,342,147,195
AVCILAR,MUSTAFA KEMALPASA MAH.,397,355,350,141,209
AVCILAR,MUSTAFA KEMALPASA MAH.,399,366,359,159,200
AVCILAR,MUSTAFA KEMALPASA MAH.,396,352,343,132,211
AVCILAR,MUSTAFA KEMALPASA MAH.,397,340,334,168,166
AVCILAR,MUSTAFA KEMALPASA MAH.,396,347,342,164,178
AVCILAR,MUSTAFA KEMALPASA MAH.,397,363,360,168,192
AVCILAR,MUSTAFA KEMALPASA MAH.,396,349,344,170,174
AVCILAR,MUSTAFA KEMALPASA MAH.,397,333,331,133,198
AVCILAR,MUSTAFA KEMALPASA MAH.,395,351,346,125,221
AVCILAR,MUSTAFA KEMALPASA MAH.,396,340,332,137,195
AVCILAR,MUSTAFA KEMALPASA MAH.,397,333,327,154,173
AVCILAR,MUSTAFA KEMALPASA MAH.,397,343,341,169,172
AVCILAR,MUSTAFA KEMALPASA MAH.,397,351,347,161,186
AVCILAR,MUSTAFA KEMALPASA MAH.,398,342,342,183,159
AVCILAR,MUSTAFA KEMALPASA MAH.,398,354,352,181,171
AVCILAR,MUSTAFA KEMALPASA MAH.,397,357,355,165,190
AVCILAR,MUSTAFA KEMALPASA MAH.,397,353,350,181,169
AVCILAR,MUSTAFA KEMALPASA MAH.,398,360,356,174,182
AVCILAR,MUSTAFA KEMALPASA MAH.,398,359,354,142,212
AVCILAR,MUSTAFA KEMALPASA MAH.,398,360,354,177,177
AVCILAR,MUSTAFA KEMALPASA MAH.,397,362,361,198,163
AVCILAR,MUSTAFA KEMALPASA MAH.,398,359,354,138,216
AVCILAR,MUSTAFA KEMALPASA MAH.,397,353,348,160,188
AVCILAR,MUSTAFA KEMALPASA MAH.,398,353,351,140,211
AVCILAR,MUSTAFA KEMALPASA MAH.,398,350,345,154,191
AVCILAR,MUSTAFA KEMALPASA MAH.,396,361,358,178,180
AVCILAR,MUSTAFA KEMALPASA MAH.,396,358,354,164,190
AVCILAR,MUSTAFA KEMALPASA MAH.,415,349,336,149,187
AVCILAR,MUSTAFA KEMALPASA MAH.,415,342,339,107,232
AVCILAR,MUSTAFA KEMALPASA MAH.,415,370,366,150,216
AVCILAR,MUSTAFA KEMALPASA MAH.,415,370,362,166,196
AVCILAR,MUSTAFA KEMALPASA MAH.,415,364,358,161,197
AVCILAR,MUSTAFA KEMALPASA MAH.,414,368,365,177,188
AVCILAR,MUSTAFA KEMALPASA MAH.,415,376,369,177,192
AVCILAR,MUSTAFA KEMALPASA MAH.,415,370,364,188,176
AVCILAR,MUSTAFA KEMALPASA MAH.,415,370,368,161,207
AVCILAR,MUSTAFA KEMALPASA MAH.,415,370,361,159,202
AVCILAR,MUSTAFA KEMALPASA MAH.,415,366,363,151,212
AVCILAR,MUSTAFA KEMALPASA MAH.,414,356,356,148,208
AVCILAR,MUSTAFA KEMALPASA MAH.,412,353,344,149,195
AVCILAR,MUSTAFA KEMALPASA MAH.,415,377,374,189,185
AVCILAR,MUSTAFA KEMALPASA MAH.,415,381,376,161,215
AVCILAR,MUSTAFA KEMALPASA MAH.,415,382,379,169,210
AVCILAR,MUSTAFA KEMALPASA MAH.,413,375,370,195,175
AVCILAR,MUSTAFA KEMALPASA MAH.,412,374,372,162,210
AVCILAR,MUSTAFA KEMALPASA MAH.,414,342,339,174,165
AVCILAR,MUSTAFA KEMALPASA MAH.,413,375,373,163,210
AVCILAR,MUSTAFA KEMALPASA MAH.,414,376,373,160,213
AVCILAR,MUSTAFA KEMALPASA MAH.,414,374,368,163,205
AVCILAR,MUSTAFA KEMALPASA MAH.,414,371,364,153,211
AVCILAR,MUSTAFA KEMALPASA MAH.,408,342,334,146,188
AVCILAR,MUSTAFA KEMALPASA MAH.,408,329,321,139,182
AVCILAR,MUSTAFA KEMALPASA MAH.,408,351,349,162,187
AVCILAR,MUSTAFA KEMALPASA MAH.,410,367,361,180,181
AVCILAR,MUSTAFA KEMALPASA MAH.,408,374,367,185,182
AVCILAR,MUSTAFA KEMALPASA MAH.,408,363,362,174,188
AVCILAR,MUSTAFA KEMALPASA MAH.,411,368,362,162,200
AVCILAR,MUSTAFA KEMALPASA MAH.,408,352,348,157,191
AVCILAR,MUSTAFA KEMALPASA MAH.,408,370,364,164,200
AVCILAR,MUSTAFA KEMALPASA MAH.,408,375,369,163,206
AVCILAR,MUSTAFA KEMALPASA MAH.,407,365,360,161,199
AVCILAR,MUSTAFA KEMALPASA MAH.,407,370,365,163,202
AVCILAR,MUSTAFA KEMALPASA MAH.,409,355,353,186,167
AVCILAR,MUSTAFA KEMALPASA MAH.,408,355,353,175,178
AVCILAR,MUSTAFA KEMALPASA MAH.,407,359,357,165,192
AVCILAR,MUSTAFA KEMALPASA MAH.,408,363,357,147,210
AVCILAR,MUSTAFA KEMALPASA MAH.,407,362,359,149,210
AVCILAR,MUSTAFA KEMALPASA MAH.,407,360,354,160,194
AVCILAR,MUSTAFA KEMALPASA MAH.,409,354,350,178,172
AVCILAR,MUSTAFA KEMALPASA MAH.,407,356,354,171,183
AVCILAR,MUSTAFA KEMALPASA MAH.,408,367,363,156,207
AVCILAR,MUSTAFA KEMALPASA MAH.,407,377,354,171,183
AVCILAR,MUSTAFA KEMALPASA MAH.,408,368,365,150,215
AVCILAR,TAHTAKALE MAH.,409,364,361,248,113
AVCILAR,TAHTAKALE MAH.,409,345,342,213,129
AVCILAR,TAHTAKALE MAH.,409,365,362,255,107
AVCILAR,TAHTAKALE MAH.,409,364,357,241,116
AVCILAR,TAHTAKALE MAH.,409,361,357,252,105
AVCILAR,TAHTAKALE MAH.,412,367,366,256,110
AVCILAR,TAHTAKALE MAH.,409,365,363,249,114
AVCILAR,TAHTAKALE MAH.,410,369,365,231,134
AVCILAR,TAHTAKALE MAH.,409,363,354,219,135
AVCILAR,TAHTAKALE MAH.,415,372,367,243,124
AVCILAR,TAHTAKALE MAH.,415,389,384,251,133
AVCILAR,TAHTAKALE MAH.,409,365,359,237,122
AVCILAR,TAHTAKALE MAH.,409,360,354,203,151
AVCILAR,TAHTAKALE MAH.,409,359,355,238,117
AVCILAR,TAHTAKALE MAH.,409,361,358,243,115
AVCILAR,TAHTAKALE MAH.,415,377,371,251,120
AVCILAR,TAHTAKALE MAH.,415,376,371,249,122
AVCILAR,TAHTAKALE MAH.,410,360,354,241,113
AVCILAR,TAHTAKALE MAH.,409,365,363,258,105
AVCILAR,TAHTAKALE MAH.,410,363,361,221,140
AVCILAR,TAHTAKALE MAH.,408,358,356,239,117
AVCILAR,TAHTAKALE MAH.,415,369,360,182,178
AVCILAR,TAHTAKALE MAH.,417,381,379,178,201
AVCILAR,TAHTAKALE MAH.,415,379,374,166,208
AVCILAR,TAHTAKALE MAH.,415,382,378,166,212
AVCILAR,TAHTAKALE MAH.,415,388,384,176,208
AVCILAR,TAHTAKALE MAH.,415,377,371,171,200
AVCILAR,TAHTAKALE MAH.,415,365,363,158,205
AVCILAR,TAHTAKALE MAH.,415,378,376,166,210
AVCILAR,TAHTAKALE MAH.,416,385,383,161,222
AVCILAR,TAHTAKALE MAH.,415,387,385,154,231
AVCILAR,TAHTAKALE MAH.,415,387,381,185,196
AVCILAR,TAHTAKALE MAH.,415,375,371,165,206
AVCILAR,TAHTAKALE MAH.,415,366,361,153,208
AVCILAR,TAHTAKALE MAH.,415,365,362,163,199
AVCILAR,TAHTAKALE MAH.,415,373,368,175,193
AVCILAR,TAHTAKALE MAH.,417,388,386,159,227
AVCILAR,TAHTAKALE MAH.,414,384,382,151,231
AVCILAR,TAHTAKALE MAH.,415,372,368,165,203
AVCILAR,TAHTAKALE MAH.,415,378,375,158,217
AVCILAR,TAHTAKALE MAH.,417,386,380,147,233
AVCILAR,TAHTAKALE MAH.,416,404,397,176,221
AVCILAR,TAHTAKALE MAH.,416,373,368,154,214
AVCILAR,TAHTAKALE MAH.,415,382,375,188,187
AVCILAR,TAHTAKALE MAH.,416,386,382,165,217
AVCILAR,TAHTAKALE MAH.,414,386,383,145,238
AVCILAR,TAHTAKALE MAH.,414,390,386,166,220
AVCILAR,TAHTAKALE MAH.,417,381,380,152,228
AVCILAR,TAHTAKALE MAH.,416,385,379,153,226
AVCILAR,TAHTAKALE MAH.,415,365,362,183,179
AVCILAR,TAHTAKALE MAH.,415,374,369,165,204
AVCILAR,TAHTAKALE MAH.,416,389,388,168,220
AVCILAR,TAHTAKALE MAH.,415,379,375,164,211
AVCILAR,TAHTAKALE MAH.,415,383,379,149,230
AVCILAR,TAHTAKALE MAH.,415,359,356,165,191
AVCILAR,TAHTAKALE MAH.,415,391,387,164,223
AVCILAR,TAHTAKALE MAH.,414,390,388,174,214
AVCILAR,TAHTAKALE MAH.,415,381,378,186,192
AVCILAR,TAHTAKALE MAH.,414,386,379,156,223
AVCILAR,TAHTAKALE MAH.,415,384,382,199,183
AVCILAR,TAHTAKALE MAH.,403,334,323,140,183
AVCILAR,TAHTAKALE MAH.,400,333,326,189,137
AVCILAR,TAHTAKALE MAH.,401,360,354,194,160
AVCILAR,TAHTAKALE MAH.,402,365,364,220,144
AVCILAR,TAHTAKALE MAH.,400,342,338,207,131
AVCILAR,TAHTAKALE MAH.,400,354,351,225,126
AVCILAR,TAHTAKALE MAH.,399,362,358,213,145
AVCILAR,TAHTAKALE MAH.,399,355,350,223,127
AVCILAR,TAHTAKALE MAH.,400,340,336,198,138
AVCILAR,TAHTAKALE MAH.,399,349,341,203,138
AVCILAR,TAHTAKALE MAH.,400,345,341,216,125
AVCILAR,TAHTAKALE MAH.,400,345,339,202,137
AVCILAR,TAHTAKALE MAH.,399,365,358,210,148
AVCILAR,TAHTAKALE MAH.,399,351,347,184,163
AVCILAR,TAHTAKALE MAH.,400,354,350,200,150
AVCILAR,TAHTAKALE MAH.,399,340,338,203,135
AVCILAR,TAHTAKALE MAH.,399,354,351,189,162
AVCILAR,TAHTAKALE MAH.,399,338,331,200,131
AVCILAR,TAHTAKALE MAH.,405,344,338,204,134
AVCILAR,UNIVERSITE MAH.,410,330,326,137,189
AVCILAR,UNIVERSITE MAH.,415,374,367,121,246
AVCILAR,UNIVERSITE MAH.,411,358,350,127,223
AVCILAR,UNIVERSITE MAH.,415,357,345,122,223
AVCILAR,UNIVERSITE MAH.,411,385,383,143,240
AVCILAR,UNIVERSITE MAH.,410,357,353,168,185
AVCILAR,UNIVERSITE MAH.,410,365,362,121,241
AVCILAR,UNIVERSITE MAH.,415,357,351,152,199
AVCILAR,UNIVERSITE MAH.,412,366,362,129,233
AVCILAR,UNIVERSITE MAH.,411,367,362,132,230
AVCILAR,UNIVERSITE MAH.,412,359,357,143,214
AVCILAR,UNIVERSITE MAH.,411,361,353,141,212
AVCILAR,UNIVERSITE MAH.,409,350,346,133,213
AVCILAR,UNIVERSITE MAH.,411,351,348,128,220
AVCILAR,UNIVERSITE MAH.,412,325,317,124,193
AVCILAR,UNIVERSITE MAH.,411,369,362,138,224
AVCILAR,UNIVERSITE MAH.,397,346,339,134,205
AVCILAR,UNIVERSITE MAH.,397,334,330,130,200
AVCILAR,UNIVERSITE MAH.,399,346,341,139,202
AVCILAR,UNIVERSITE MAH.,397,362,360,123,237
AVCILAR,UNIVERSITE MAH.,398,360,360,145,215
AVCILAR,UNIVERSITE MAH.,397,356,355,129,226
AVCILAR,UNIVERSITE MAH.,397,354,352,167,185
AVCILAR,UNIVERSITE MAH.,401,356,353,161,192
AVCILAR,UNIVERSITE MAH.,397,356,354,128,226
AVCILAR,UNIVERSITE MAH.,397,350,341,134,207
AVCILAR,UNIVERSITE MAH.,397,351,344,138,206
AVCILAR,UNIVERSITE MAH.,397,347,341,143,198
AVCILAR,UNIVERSITE MAH.,396,353,347,114,233
AVCILAR,UNIVERSITE MAH.,398,361,360,153,207
AVCILAR,UNIVERSITE MAH.,398,358,355,123,232
AVCILAR,UNIVERSITE MAH.,397,361,358,124,234
AVCILAR,UNIVERSITE MAH.,397,344,340,134,206
AVCILAR,UNIVERSITE MAH.,398,357,350,130,220
AVCILAR,UNIVERSITE MAH.,397,347,347,140,207
AVCILAR,UNIVERSITE MAH.,397,362,358,146,212
AVCILAR,YESILKENT MAH.,407,335,328,146,182
AVCILAR,YESILKENT MAH.,409,352,347,125,222
AVCILAR,YESILKENT MAH.,406,322,319,135,184
AVCILAR,YESILKENT MAH.,406,353,350,129,221
AVCILAR,YESILKENT MAH.,407,362,353,133,220
AVCILAR,YESILKENT MAH.,407,348,345,170,175
AVCILAR,YESILKENT MAH.,407,357,354,157,197
AVCILAR,YESILKENT MAH.,407,359,355,158,197
AVCILAR,YESILKENT MAH.,406,356,349,119,230
AVCILAR,YESILKENT MAH.,406,369,364,136,228
AVCILAR,YESILKENT MAH.,405,354,346,155,191
AVCILAR,YESILKENT MAH.,407,361,352,166,186
AVCILAR,YESILKENT MAH.,407,361,359,150,209
AVCILAR,YESILKENT MAH.,406,357,353,143,210
AVCILAR,YESILKENT MAH.,415,366,356,144,212
AVCILAR,YESILKENT MAH.,405,359,356,147,209
AVCILAR,YESILKENT MAH.,407,352,349,160,189
AVCILAR,YESILKENT MAH.,405,363,358,157,201
AVCILAR,YESILKENT MAH.,405,340,335,147,188
AVCILAR,YESILKENT MAH.,407,368,361,158,203
AVCILAR,YESILKENT MAH.,406,355,351,150,201
AVCILAR,YESILKENT MAH.,407,363,354,143,211
AVCILAR,YESILKENT MAH.,405,368,358,138,220
AVCILAR,YESILKENT MAH.,405,361,358,149,209
AVCILAR,YESILKENT MAH.,406,357,351,163,188
AVCILAR,YESILKENT MAH.,407,362,358,161,197
AVCILAR,YESILKENT MAH.,407,368,361,170,191
AVCILAR,YESILKENT MAH.,407,371,365,158,207
AVCILAR,YESILKENT MAH.,405,359,356,171,185
AVCILAR,YESILKENT MAH.,407,353,352,176,176
AVCILAR,YESILKENT MAH.,406,367,359,174,185
AVCILAR,YESILKENT MAH.,406,354,345,146,199
AVCILAR,YESILKENT MAH.,407,361,351,187,164
AVCILAR,YESILKENT MAH.,407,356,352,168,184
AVCILAR,YESILKENT MAH.,407,335,331,151,180
AVCILAR,YESILKENT MAH.,407,359,348,148,200
AVCILAR,YESILKENT MAH.,407,362,353,161,192
AVCILAR,YESILKENT MAH.,407,354,349,176,173
AVCILAR,YESILKENT MAH.,406,360,358,151,207
AVCILAR,YESILKENT MAH.,406,357,349,135,214
AVCILAR,YESILKENT MAH.,406,372,363,144,219
AVCILAR,YESILKENT MAH.,415,373,358,174,184
AVCILAR,YESILKENT MAH.,415,367,358,111,247
AVCILAR,YESILKENT MAH.,415,344,338,129,209
AVCILAR,YESILKENT MAH.,410,366,363,119,244
AVCILAR,YESILKENT MAH.,410,358,351,125,226
AVCILAR,YESILKENT MAH.,410,350,346,136,210
AVCILAR,YESILKENT MAH.,415,354,348,153,195
AVCILAR,YESILKENT MAH.,410,347,335,126,209
AVCILAR,YESILKENT MAH.,410,379,371,128,243
AVCILAR,YESILKENT MAH.,410,363,356,123,233
AVCILAR,YESILKENT MAH.,411,374,362,155,207
AVCILAR,YESILKENT MAH.,415,369,360,139,221
AVCILAR,YESILKENT MAH.,412,362,358,157,201
AVCILAR,YESILKENT MAH.,410,374,367,151,216
AVCILAR,YESILKENT MAH.,411,370,363,127,236
AVCILAR,YESILKENT MAH.,410,368,366,175,191
AVCILAR,YESILKENT MAH.,409,351,341,149,192
AVCILAR,YESILKENT MAH.,411,358,352,151,201
AVCILAR,YESILKENT MAH.,410,347,339,152,187
AVCILAR,YESILKENT MAH.,411,365,358,137,221
AVCILAR,YESILKENT MAH.,410,371,368,127,241
AVCILAR,YESILKENT MAH.,410,360,355,138,217
AVCILAR,YESILKENT MAH.,411,355,352,134,218
AVCILAR,YESILKENT MAH.,410,358,348,143,205
AVCILAR,YESILKENT MAH.,411,362,360,152,208
AVCILAR,YESILKENT MAH.,411,362,355,143,212
AVCILAR,YESILKENT MAH.,410,361,357,142,215
AVCILAR,YESILKENT MAH.,410,360,353,155,198
AVCILAR,YESILKENT MAH.,410,370,358,158,200
AVCILAR,YESILKENT MAH.,409,337,337,122,215
AVCILAR,YESILKENT MAH.,411,362,353,150,203
AVCILAR,YESILKENT MAH.,411,372,368,166,202
AVCILAR,YESILKENT MAH.,410,378,374,143,231
AVCILAR,YESILKENT MAH.,410,354,346,136,210
AVCILAR,YESILKENT MAH.,411,372,365,151,214
AVCILAR,YESILKENT MAH.,415,365,356,151,205
AVCILAR,YESILKENT MAH.,410,347,338,140,198
AVCILAR,YESILKENT MAH.,410,358,348,145,203
AVCILAR,YESILKENT MAH.,411,363,350,132,218
AVCILAR,YESILKENT MAH.,411,371,360,136,224
AVCILAR,YESILKENT MAH.,411,377,375,154,221
AVCILAR,YESILKENT MAH.,410,354,352,146,206
AVCILAR,YESILKENT MAH.,411,351,341,129,212
AVCILAR,YESILKENT MAH.,412,373,364,153,211
AVCILAR,YESILKENT MAH.,415,354,341,161,180
AVCILAR,YESILKENT MAH.,411,370,365,160,205
AVCILAR,YESILKENT MAH.,415,372,367,153,214
AVCILAR,YESILKENT MAH.,410,364,359,168,191
AVCILAR,YESILKENT MAH.,410,365,358,142,216
AVCILAR,YESILKENT MAH.,410,359,356,142,214
AVCILAR,YESILKENT MAH.,410,372,368,143,225
AVCILAR,YESILKENT MAH.,410,380,376,172,204
AVCILAR,YESILKENT MAH.,410,357,347,135,212
AVCILAR,YESILKENT MAH.,415,368,368,126,242
AVCILAR,YESILKENT MAH.,410,352,347,149,198
AVCILAR,YESILKENT MAH.,409,365,357,157,200
AVCILAR,YESILKENT MAH.,410,360,347,143,204
AVCILAR,YESILKENT MAH.,409,363,354,165,189
AVCILAR,YESILKENT MAH.,409,362,355,172,183
AVCILAR,YESILKENT MAH.,409,353,348,168,180
AVCILAR,YESILKENT MAH.,409,355,344,150,194
AVCILAR,YESILKENT MAH.,410,384,376,167,209
AVCILAR,YESILKENT MAH.,409,355,344,151,193
AVCILAR,YESILKENT MAH.,410,360,353,154,199
AVCILAR,YESILKENT MAH.,410,367,359,186,173
AVCILAR,YESILKENT MAH.,410,354,346,167,179
AVCILAR,YESILKENT MAH.,410,366,361,153,208
AVCILAR,YESILKENT MAH.,409,371,366,123,243
AVCILAR,YESILKENT MAH.,410,371,369,150,219
AVCILAR,YESILKENT MAH.,410,352,348,141,207
AVCILAR,YESILKENT MAH.,410,361,355,163,192
AVCILAR,YESILKENT MAH.,410,349,345,157,188
SANCAKTEPE,ABDURRAHMANGAZI MAH.,415,357,352,165,187
SANCAKTEPE,ABDURRAHMANGAZI MAH.,415,334,329,204,125
SANCAKTEPE,ABDURRAHMANGAZI MAH.,415,364,358,184,174
SANCAKTEPE,ABDURRAHMANGAZI MAH.,415,387,379,201,178
SANCAKTEPE,ABDURRAHMANGAZI MAH.,411,375,369,191,178
SANCAKTEPE,ABDURRAHMANGAZI MAH.,410,391,382,206,176
SANCAKTEPE,ABDURRAHMANGAZI MAH.,410,378,371,198,173
SANCAKTEPE,ABDURRAHMANGAZI MAH.,411,376,365,180,185
SANCAKTEPE,ABDURRAHMANGAZI MAH.,411,370,364,196,168
SANCAKTEPE,ABDURRAHMANGAZI MAH.,411,383,373,182,191
SANCAKTEPE,ABDURRAHMANGAZI MAH.,410,369,360,197,163
SANCAKTEPE,ABDURRAHMANGAZI MAH.,410,365,361,170,191
SANCAKTEPE,ABDURRAHMANGAZI MAH.,411,352,349,194,155
SANCAKTEPE,ABDURRAHMANGAZI MAH.,410,357,351,193,158
SANCAKTEPE,ABDURRAHMANGAZI MAH.,415,378,376,231,145
SANCAKTEPE,ABDURRAHMANGAZI MAH.,411,374,365,190,175
SANCAKTEPE,ABDURRAHMANGAZI MAH.,410,363,355,187,168
SANCAKTEPE,ABDURRAHMANGAZI MAH.,411,380,367,191,176
SANCAKTEPE,ABDURRAHMANGAZI MAH.,411,374,365,185,180
SANCAKTEPE,ABDURRAHMANGAZI MAH.,410,365,361,177,184
SANCAKTEPE,ABDURRAHMANGAZI MAH.,411,379,374,213,161
SANCAKTEPE,ABDURRAHMANGAZI MAH.,411,366,363,183,180
SANCAKTEPE,ABDURRAHMANGAZI MAH.,410,351,349,182,167
SANCAKTEPE,ABDURRAHMANGAZI MAH.,411,361,354,196,158
SANCAKTEPE,ABDURRAHMANGAZI MAH.,410,365,360,207,153
SANCAKTEPE,ABDURRAHMANGAZI MAH.,410,361,360,205,155
SANCAKTEPE,ABDURRAHMANGAZI MAH.,411,361,356,211,145
SANCAKTEPE,ABDURRAHMANGAZI MAH.,411,372,368,183,185
SANCAKTEPE,ABDURRAHMANGAZI MAH.,411,364,357,198,159
SANCAKTEPE,ABDURRAHMANGAZI MAH.,412,373,367,190,177
SANCAKTEPE,ABDURRAHMANGAZI MAH.,410,368,365,187,178
SANCAKTEPE,ABDURRAHMANGAZI MAH.,411,361,357,203,154
SANCAKTEPE,ABDURRAHMANGAZI MAH.,410,374,370,190,180
SANCAKTEPE,ABDURRAHMANGAZI MAH.,410,377,364,188,176
SANCAKTEPE,ABDURRAHMANGAZI MAH.,410,357,354,179,175
SANCAKTEPE,ABDURRAHMANGAZI MAH.,410,363,353,174,179
SANCAKTEPE,ABDURRAHMANGAZI MAH.,411,379,370,182,188
SANCAKTEPE,ABDURRAHMANGAZI MAH.,411,373,370,198,172
SANCAKTEPE,ABDURRAHMANGAZI MAH.,411,375,372,200,172
SANCAKTEPE,ABDURRAHMANGAZI MAH.,410,369,361,188,173
SANCAKTEPE,ABDURRAHMANGAZI MAH.,410,371,366,210,156
SANCAKTEPE,ABDURRAHMANGAZI MAH.,410,377,374,221,153
SANCAKTEPE,ABDURRAHMANGAZI MAH.,410,352,349,195,154
SANCAKTEPE,ABDURRAHMANGAZI MAH.,411,372,368,214,154
SANCAKTEPE,ABDURRAHMANGAZI MAH.,411,366,361,170,191
SANCAKTEPE,ABDURRAHMANGAZI MAH.,410,382,373,181,192
SANCAKTEPE,ABDURRAHMANGAZI MAH.,411,362,361,172,189
SANCAKTEPE,ABDURRAHMANGAZI MAH.,409,384,375,196,179
SANCAKTEPE,ATATURK MAH.,411,369,364,83,281
SANCAKTEPE,ATATURK MAH.,416,355,350,78,272
SANCAKTEPE,ATATURK MAH.,416,367,361,108,253
SANCAKTEPE,ATATURK MAH.,415,398,391,129,262
SANCAKTEPE,ATATURK MAH.,412,387,383,113,270
SANCAKTEPE,ATATURK MAH.,416,377,373,123,250
SANCAKTEPE,ATATURK MAH.,416,381,375,138,237
SANCAKTEPE,ATATURK MAH.,416,382,381,124,257
SANCAKTEPE,ATATURK MAH.,412,365,360,107,253
SANCAKTEPE,ATATURK MAH.,416,372,365,120,245
SANCAKTEPE,ATATURK MAH.,415,374,370,121,249
SANCAKTEPE,ATATURK MAH.,411,376,365,97,268
SANCAKTEPE,ATATURK MAH.,414,379,374,132,242
SANCAKTEPE,ATATURK MAH.,411,386,380,145,235
SANCAKTEPE,ATATURK MAH.,415,391,387,107,280
SANCAKTEPE,ATATURK MAH.,415,381,375,117,258
SANCAKTEPE,ATATURK MAH.,415,390,387,124,263
SANCAKTEPE,ATATURK MAH.,414,380,370,108,262
SANCAKTEPE,ATATURK MAH.,412,375,372,109,263
SANCAKTEPE,ATATURK MAH.,414,378,377,120,257
SANCAKTEPE,ATATURK MAH.,415,383,379,110,269
SANCAKTEPE,ATATURK MAH.,414,373,369,114,255
SANCAKTEPE,ATATURK MAH.,413,374,367,101,266
SANCAKTEPE,ATATURK MAH.,414,376,372,86,286
SANCAKTEPE,ATATURK MAH.,413,381,378,105,273
SANCAKTEPE,ATATURK MAH.,414,376,370,98,272
SANCAKTEPE,ATATURK MAH.,410,352,345,120,225
SANCAKTEPE,ATATURK MAH.,408,370,365,103,262
SANCAKTEPE,ATATURK MAH.,408,395,387,139,248
SANCAKTEPE,ATATURK MAH.,408,374,372,116,256
SANCAKTEPE,ATATURK MAH.,408,361,359,117,242
SANCAKTEPE,ATATURK MAH.,409,377,366,117,249
SANCAKTEPE,ATATURK MAH.,410,369,361,112,249
SANCAKTEPE,ATATURK MAH.,408,371,365,140,225
SANCAKTEPE,ATATURK MAH.,408,369,369,114,255
SANCAKTEPE,ATATURK MAH.,408,366,362,149,213
SANCAKTEPE,ATATURK MAH.,408,360,358,136,222
SANCAKTEPE,ATATURK MAH.,408,362,359,122,237
SANCAKTEPE,ATATURK MAH.,407,378,372,84,288
SANCAKTEPE,ATATURK MAH.,409,359,358,119,239
SANCAKTEPE,ATATURK MAH.,409,370,367,107,260
SANCAKTEPE,ATATURK MAH.,407,371,366,114,252
SANCAKTEPE,ATATURK MAH.,411,370,362,142,220
SANCAKTEPE,ATATURK MAH.,408,376,373,131,242
SANCAKTEPE,ATATURK MAH.,408,357,348,111,237
SANCAKTEPE,ATATURK MAH.,408,376,369,138,231
SANCAKTEPE,ATATURK MAH.,409,366,362,125,237
SANCAKTEPE,HILAL MAH.,404,360,349,225,124
SANCAKTEPE,HILAL MAH.,403,382,378,257,121
SANCAKTEPE,HILAL MAH.,404,369,359,243,116
SANCAKTEPE,HILAL MAH.,403,364,356,233,123
SANCAKTEPE,HILAL MAH.,404,371,362,242,120
SANCAKTEPE,HILAL MAH.,402,365,356,260,96
SANCAKTEPE,HILAL MAH.,404,365,358,275,83
SANCAKTEPE,HILAL MAH.,404,350,347,210,137
SANCAKTEPE,HILAL MAH.,404,352,346,214,132
SANCAKTEPE,INONU MAH.,408,359,353,94,259
SANCAKTEPE,INONU MAH.,407,350,348,91,257
SANCAKTEPE,INONU MAH.,408,383,379,94,285
SANCAKTEPE,INONU MAH.,407,375,370,64,306
SANCAKTEPE,INONU MAH.,408,386,382,98,284
SANCAKTEPE,INONU MAH.,407,376,373,83,290
SANCAKTEPE,INONU MAH.,407,372,367,99,268
SANCAKTEPE,INONU MAH.,406,370,364,97,267
SANCAKTEPE,INONU MAH.,406,370,359,59,300
SANCAKTEPE,INONU MAH.,408,382,377,81,296
SANCAKTEPE,INONU MAH.,406,383,379,93,286
SANCAKTEPE,INONU MAH.,406,376,372,81,291
SANCAKTEPE,INONU MAH.,407,372,368,100,268
SANCAKTEPE,INONU MAH.,407,375,370,99,271
SANCAKTEPE,INONU MAH.,408,374,374,92,282
SANCAKTEPE,INONU MAH.,407,376,372,85,287
SANCAKTEPE,INONU MAH.,407,357,352,85,267
SANCAKTEPE,INONU MAH.,406,367,366,78,288
SANCAKTEPE,INONU MAH.,407,368,366,92,274
SANCAKTEPE,INONU MAH.,407,371,365,79,286
SANCAKTEPE,INONU MAH.,407,391,387,79,308
SANCAKTEPE,INONU MAH.,407,377,372,70,302
SANCAKTEPE,INONU MAH.,408,379,373,85,288
SANCAKTEPE,INONU MAH.,407,369,367,92,275
SANCAKTEPE,INONU MAH.,406,373,368,74,294
SANCAKTEPE,INONU MAH.,395,345,341,95,246
SANCAKTEPE,INONU MAH.,395,369,361,128,233
SANCAKTEPE,INONU MAH.,395,355,353,123,230
SANCAKTEPE,INONU MAH.,394,364,359,110,249
SANCAKTEPE,INONU MAH.,396,350,347,127,220
SANCAKTEPE,INONU MAH.,397,356,354,119,235
SANCAKTEPE,INONU MAH.,395,367,364,144,220
SANCAKTEPE,INONU MAH.,395,367,365,123,242
SANCAKTEPE,INONU MAH.,398,350,345,110,235
SANCAKTEPE,INONU MAH.,395,370,367,131,236
SANCAKTEPE,INONU MAH.,394,355,352,92,260
SANCAKTEPE,INONU MAH.,398,356,349,94,255
SANCAKTEPE,INONU MAH.,395,349,348,122,226
SANCAKTEPE,INONU MAH.,395,362,361,123,238
SANCAKTEPE,INONU MAH.,395,361,352,118,234
SANCAKTEPE,KEMAL TURKLER MAH.,375,337,327,166,161
SANCAKTEPE,KEMAL TURKLER MAH.,374,356,352,170,182
SANCAKTEPE,KEMAL TURKLER MAH.,375,332,330,136,194
SANCAKTEPE,KEMAL TURKLER MAH.,375,346,335,152,183
SANCAKTEPE,KEMAL TURKLER MAH.,376,351,349,149,200
SANCAKTEPE,KEMAL TURKLER MAH.,375,340,336,169,167
SANCAKTEPE,KEMAL TURKLER MAH.,377,346,341,156,185
SANCAKTEPE,KEMAL TURKLER MAH.,375,340,336,155,181
SANCAKTEPE,KEMAL TURKLER MAH.,375,337,329,135,194
SANCAKTEPE,KEMAL TURKLER MAH.,375,335,332,159,173
SANCAKTEPE,KEMAL TURKLER MAH.,407,371,365,134,231
SANCAKTEPE,KEMAL TURKLER MAH.,408,367,359,143,216
SANCAKTEPE,KEMAL TURKLER MAH.,408,373,369,128,241
SANCAKTEPE,KEMAL TURKLER MAH.,409,378,374,156,218
SANCAKTEPE,KEMAL TURKLER MAH.,407,374,367,156,211
SANCAKTEPE,KEMAL TURKLER MAH.,408,382,378,164,214
SANCAKTEPE,KEMAL TURKLER MAH.,408,377,368,180,188
SANCAKTEPE,KEMAL TURKLER MAH.,408,371,369,147,222
SANCAKTEPE,KEMAL TURKLER MAH.,407,362,358,154,204
SANCAKTEPE,KEMAL TURKLER MAH.,407,371,365,164,201
SANCAKTEPE,KEMAL TURKLER MAH.,407,378,369,139,230
SANCAKTEPE,KEMAL TURKLER MAH.,407,366,360,137,223
SANCAKTEPE,KEMAL TURKLER MAH.,407,358,354,150,204
SANCAKTEPE,KEMAL TURKLER MAH.,408,370,366,163,203
SANCAKTEPE,KEMAL TURKLER MAH.,408,359,347,151,196
SANCAKTEPE,KEMAL TURKLER MAH.,409,373,368,150,218
SANCAKTEPE,KEMAL TURKLER MAH.,407,360,351,138,213
SANCAKTEPE,KEMAL TURKLER MAH.,408,371,363,166,197
SANCAKTEPE,KEMAL TURKLER MAH.,408,372,363,149,214
SANCAKTEPE,KEMAL TURKLER MAH.,408,371,367,160,207
SANCAKTEPE,KEMAL TURKLER MAH.,408,368,367,176,191
SANCAKTEPE,KEMAL TURKLER MAH.,408,382,374,139,235
SANCAKTEPE,MERVE MAH.,403,367,356,217,139
SANCAKTEPE,MERVE MAH.,404,364,359,255,104
SANCAKTEPE,MERVE MAH.,405,371,360,213,147
SANCAKTEPE,MERVE MAH.,404,375,368,227,141
SANCAKTEPE,MERVE MAH.,404,369,363,226,137
SANCAKTEPE,MERVE MAH.,404,373,367,213,154
SANCAKTEPE,MERVE MAH.,405,375,366,208,158
SANCAKTEPE,MERVE MAH.,404,372,367,240,127
SANCAKTEPE,MERVE MAH.,404,364,362,232,130
SANCAKTEPE,MERVE MAH.,404,372,366,237,129
SANCAKTEPE,MERVE MAH.,406,359,352,229,123
SANCAKTEPE,MERVE MAH.,404,365,360,217,143
SANCAKTEPE,MERVE MAH.,405,367,361,223,138
SANCAKTEPE,MERVE MAH.,408,370,363,243,120
SANCAKTEPE,MERVE MAH.,404,382,373,227,146
SANCAKTEPE,MERVE MAH.,404,368,364,241,123
SANCAKTEPE,MERVE MAH.,403,374,373,242,131
SANCAKTEPE,MERVE MAH.,404,364,353,227,126
SANCAKTEPE,MERVE MAH.,403,371,365,237,128
SANCAKTEPE,MERVE MAH.,403,373,365,209,156
SANCAKTEPE,MERVE MAH.,407,376,371,197,174
SANCAKTEPE,MERVE MAH.,403,375,370,200,170
SANCAKTEPE,MERVE MAH.,403,371,364,231,133
SANCAKTEPE,MERVE MAH.,404,363,361,210,151
SANCAKTEPE,MERVE MAH.,404,361,356,232,124
SANCAKTEPE,MERVE MAH.,404,382,379,241,138
SANCAKTEPE,MERVE MAH.,404,362,351,219,132
SANCAKTEPE,MERVE MAH.,403,359,357,218,139
SANCAKTEPE,MERVE MAH.,403,364,357,211,146
SANCAKTEPE,MEVLANA MAH.,399,342,328,185,143
SANCAKTEPE,MEVLANA MAH.,398,337,328,193,135
SANCAKTEPE,MEVLANA MAH.,398,335,324,212,112
SANCAKTEPE,MEVLANA MAH.,398,364,358,216,142
SANCAKTEPE,MEVLANA MAH.,398,341,333,190,143
SANCAKTEPE,MEVLANA MAH.,398,372,368,202,166
SANCAKTEPE,MEVLANA MAH.,398,353,345,175,170
SANCAKTEPE,MEVLANA MAH.,398,361,350,227,123
SANCAKTEPE,MEVLANA MAH.,398,356,343,215,128
SANCAKTEPE,MEVLANA MAH.,398,361,361,224,137
SANCAKTEPE,MEVLANA MAH.,397,359,352,232,120
SANCAKTEPE,MEVLANA MAH.,400,354,348,182,166
SANCAKTEPE,MEVLANA MAH.,399,345,339,210,129
SANCAKTEPE,MEVLANA MAH.,399,365,358,200,158
SANCAKTEPE,MEVLANA MAH.,401,356,348,200,148
SANCAKTEPE,MEVLANA MAH.,398,360,347,212,135
SANCAKTEPE,MEVLANA MAH.,399,354,349,217,132
SANCAKTEPE,MEVLANA MAH.,398,352,343,221,122
SANCAKTEPE,MEVLANA MAH.,397,341,337,215,122
SANCAKTEPE,MEVLANA MAH.,398,355,346,217,129
SANCAKTEPE,MEVLANA MAH.,398,342,339,211,128
SANCAKTEPE,MEVLANA MAH.,397,344,340,214,126
SANCAKTEPE,MEVLANA MAH.,397,350,347,215,132
SANCAKTEPE,MEVLANA MAH.,398,370,360,195,165
SANCAKTEPE,PASAKOY MAH.,403,350,344,181,163
SANCAKTEPE,PASAKOY MAH.,403,366,358,175,183
SANCAKTEPE,PASAKOY MAH.,402,365,360,197,163
SANCAKTEPE,SAFA MAH.,409,358,343,247,96
SANCAKTEPE,SAFA MAH.,408,359,355,239,116
SANCAKTEPE,SAFA MAH.,408,358,353,246,107
SANCAKTEPE,SAFA MAH.,407,361,358,241,117
SANCAKTEPE,SAFA MAH.,407,369,364,232,132
SANCAKTEPE,SAFA MAH.,407,359,357,236,121
SANCAKTEPE,SAFA MAH.,408,360,349,238,111
SANCAKTEPE,SAFA MAH.,407,363,356,243,113
SANCAKTEPE,SAFA MAH.,408,383,381,257,124
SANCAKTEPE,SAFA MAH.,408,377,374,242,132
SANCAKTEPE,SAFA MAH.,408,362,355,233,122
SANCAKTEPE,SAFA MAH.,408,369,365,254,111
SANCAKTEPE,SAFA MAH.,408,354,351,246,105
SANCAKTEPE,SAFA MAH.,408,345,338,231,107
SANCAKTEPE,SAFA MAH.,409,361,351,232,119
SANCAKTEPE,SAFA MAH.,408,364,358,219,139
SANCAKTEPE,SAFA MAH.,408,366,362,225,137
SANCAKTEPE,SAFA MAH.,407,363,361,240,121
SANCAKTEPE,SAFA MAH.,407,362,360,248,112
SANCAKTEPE,SAFA MAH.,408,352,342,239,103
SANCAKTEPE,SAFA MAH.,408,355,350,218,132
SANCAKTEPE,SAFA MAH.,407,364,358,247,111
SANCAKTEPE,SAFA MAH.,409,372,366,231,135
SANCAKTEPE,SAFA MAH.,407,373,369,260,109
SANCAKTEPE,SAFA MAH.,407,368,365,237,128
SANCAKTEPE,SAFA MAH.,408,371,363,244,119
SANCAKTEPE,YENIDOGAN MAH.,400,344,336,146,190
SANCAKTEPE,YENIDOGAN MAH.,401,360,358,209,149
SANCAKTEPE,YENIDOGAN MAH.,401,368,362,206,156
SANCAKTEPE,YENIDOGAN MAH.,399,366,358,177,181
SANCAKTEPE,YENIDOGAN MAH.,399,352,345,182,163
SANCAKTEPE,YENIDOGAN MAH.,399,375,371,221,150
SANCAKTEPE,YENIDOGAN MAH.,399,360,352,189,163
SANCAKTEPE,YENIDOGAN MAH.,401,361,359,195,164
SANCAKTEPE,YENIDOGAN MAH.,401,368,360,191,169
SANCAKTEPE,YENIDOGAN MAH.,400,367,362,202,160
SANCAKTEPE,YENIDOGAN MAH.,399,377,369,230,139
SANCAKTEPE,YENIDOGAN MAH.,400,360,353,186,167
SANCAKTEPE,YENIDOGAN MAH.,406,361,351,205,146
SANCAKTEPE,YENIDOGAN MAH.,402,364,356,202,154
SANCAKTEPE,YENIDOGAN MAH.,403,364,362,217,145
SANCAKTEPE,YENIDOGAN MAH.,403,365,363,168,195
SANCAKTEPE,YENIDOGAN MAH.,402,352,342,179,163
SANCAKTEPE,YENIDOGAN MAH.,403,379,374,202,172
SANCAKTEPE,YENIDOGAN MAH.,402,369,364,190,174
SANCAKTEPE,YENIDOGAN MAH.,403,376,371,213,158
SANCAKTEPE,YENIDOGAN MAH.,403,374,369,198,171
SANCAKTEPE,YENIDOGAN MAH.,403,367,363,214,149
SANCAKTEPE,YENIDOGAN MAH.,403,372,365,216,149
SANCAKTEPE,YENIDOGAN MAH.,402,361,355,222,133
SANCAKTEPE,YENIDOGAN MAH.,403,372,361,196,165
SANCAKTEPE,YENIDOGAN MAH.,403,374,373,217,156
SANCAKTEPE,YENIDOGAN MAH.,402,372,370,208,162
SANCAKTEPE,YENIDOGAN MAH.,402,367,361,201,160
SANCAKTEPE,YENIDOGAN MAH.,402,371,367,228,139
SANCAKTEPE,YENIDOGAN MAH.,402,341,339,174,165
SANCAKTEPE,YENIDOGAN MAH.,402,368,362,226,136
SANCAKTEPE,YENIDOGAN MAH.,402,366,366,201,165
SANCAKTEPE,YUNUS EMRE MAH.,404,356,351,243,108
SANCAKTEPE,YUNUS EMRE MAH.,404,365,358,255,103
SANCAKTEPE,YUNUS EMRE MAH.,405,366,361,248,113
SANCAKTEPE,YUNUS EMRE MAH.,405,363,358,247,111
SANCAKTEPE,YUNUS EMRE MAH.,406,366,360,256,104
SANCAKTEPE,YUNUS EMRE MAH.,405,372,368,249,119
SANCAKTEPE,YUNUS EMRE MAH.,404,365,357,222,135
SANCAKTEPE,YUNUS EMRE MAH.,404,359,348,225,123
SANCAKTEPE,YUNUS EMRE MAH.,405,364,357,228,129
SANCAKTEPE,YUNUS EMRE MAH.,405,365,360,210,150
SANCAKTEPE,YUNUS EMRE MAH.,405,350,347,240,107
SANCAKTEPE,YUNUS EMRE MAH.,407,358,355,241,114
SANCAKTEPE,YUNUS EMRE MAH.,405,375,371,228,143
SANCAKTEPE,YUNUS EMRE MAH.,405,368,362,251,111
SANCAKTEPE,YUNUS EMRE MAH.,404,361,353,245,108
SANCAKTEPE,YUNUS EMRE MAH.,404,362,359,251,108
SANCAKTEPE,YUNUS EMRE MAH.,405,366,365,256,109
SANCAKTEPE,YUNUS EMRE MAH.,393,328,326,228,98
SANCAKTEPE,YUNUS EMRE MAH.,394,352,346,237,109
SANCAKTEPE,YUNUS EMRE MAH.,395,349,342,246,96
SANCAKTEPE,YUNUS EMRE MAH.,394,354,351,250,101
SANCAKTEPE,YUNUS EMRE MAH.,393,349,343,241,102
SANCAKTEPE,YUNUS EMRE MAH.,395,361,355,254,101
SANCAKTEPE,YUNUS EMRE MAH.,393,343,340,236,104
SANCAKTEPE,YUNUS EMRE MAH.,394,344,341,213,128
SANCAKTEPE,YUNUS EMRE MAH.,393,354,351,233,118
SANCAKTEPE,YUNUS EMRE MAH.,394,340,337,235,102
SANCAKTEPE,YUNUS EMRE MAH.,394,341,337,234,103
SANCAKTEPE,YUNUS EMRE MAH.,393,323,317,237,80
SANCAKTEPE,YUNUS EMRE MAH.,395,365,358,248,110
SANCAKTEPE,YUNUS EMRE MAH.,394,362,358,257,101
SANCAKTEPE,AKPINAR MAH.,415,368,356,195,161
SANCAKTEPE,AKPINAR MAH.,415,351,340,216,124
SANCAKTEPE,AKPINAR MAH.,415,371,354,238,116
SANCAKTEPE,AKPINAR MAH.,415,392,384,229,155
SANCAKTEPE,AKPINAR MAH.,415,385,378,242,136
SANCAKTEPE,AKPINAR MAH.,410,376,369,224,145
SANCAKTEPE,AKPINAR MAH.,409,371,362,219,143
SANCAKTEPE,AKPINAR MAH.,410,367,361,208,153
SANCAKTEPE,AKPINAR MAH.,410,371,367,218,149
SANCAKTEPE,AKPINAR MAH.,415,367,363,205,158
SANCAKTEPE,AKPINAR MAH.,415,375,372,222,150
SANCAKTEPE,AKPINAR MAH.,415,381,373,192,181
SANCAKTEPE,AKPINAR MAH.,410,368,366,216,150
SANCAKTEPE,AKPINAR MAH.,411,386,384,233,151
SANCAKTEPE,AKPINAR MAH.,411,377,372,208,164
SANCAKTEPE,AKPINAR MAH.,411,368,360,232,128
SANCAKTEPE,AKPINAR MAH.,410,358,355,245,110
SANCAKTEPE,AKPINAR MAH.,410,350,349,222,127
SANCAKTEPE,AKPINAR MAH.,410,378,369,236,133
SANCAKTEPE,AKPINAR MAH.,410,371,368,211,157
SANCAKTEPE,AKPINAR MAH.,411,383,362,250,112
SANCAKTEPE,AKPINAR MAH.,410,377,361,250,111
SANCAKTEPE,AKPINAR MAH.,411,364,361,218,143
SANCAKTEPE,AKPINAR MAH.,410,368,359,231,128
SANCAKTEPE,AKPINAR MAH.,410,378,373,241,132
SANCAKTEPE,AKPINAR MAH.,410,361,356,231,125
SANCAKTEPE,AKPINAR MAH.,411,380,376,217,159
SANCAKTEPE,AKPINAR MAH.,410,371,364,225,139
SANCAKTEPE,AKPINAR MAH.,410,376,370,228,142
SANCAKTEPE,AKPINAR MAH.,410,360,351,187,164
SANCAKTEPE,AKPINAR MAH.,411,357,355,212,143
SANCAKTEPE,AKPINAR MAH.,410,373,368,224,144
SANCAKTEPE,EMEK MAH.,415,355,346,152,194
SANCAKTEPE,EMEK MAH.,415,383,379,102,277
SANCAKTEPE,EMEK MAH.,415,387,382,124,258
SANCAKTEPE,EMEK MAH.,415,375,370,122,248
SANCAKTEPE,EMEK MAH.,415,378,376,144,232
SANCAKTEPE,EMEK MAH.,417,379,370,139,231
SANCAKTEPE,EMEK MAH.,417,390,389,156,233
SANCAKTEPE,EMEK MAH.,415,384,381,148,233
SANCAKTEPE,EMEK MAH.,415,378,374,146,228
SANCAKTEPE,EMEK MAH.,415,376,370,128,242
SANCAKTEPE,EMEK MAH.,415,389,383,144,239
SANCAKTEPE,EMEK MAH.,414,364,358,130,228
SANCAKTEPE,EMEK MAH.,415,378,371,132,239
SANCAKTEPE,EMEK MAH.,414,384,381,136,245
SANCAKTEPE,EMEK MAH.,415,372,368,126,242
SANCAKTEPE,EMEK MAH.,415,389,385,144,241
SANCAKTEPE,EMEK MAH.,414,389,380,130,250
SANCAKTEPE,EMEK MAH.,414,381,374,129,245
SANCAKTEPE,EMEK MAH.,415,385,379,134,245
SANCAKTEPE,EMEK MAH.,415,379,369,155,214
SANCAKTEPE,EMEK MAH.,415,378,370,115,255
SANCAKTEPE,EMEK MAH.,415,386,378,121,257
SANCAKTEPE,EMEK MAH.,415,362,355,105,250
SANCAKTEPE,EMEK MAH.,400,342,327,155,172
SANCAKTEPE,EMEK MAH.,401,369,364,198,166
SANCAKTEPE,EMEK MAH.,399,360,357,203,154
SANCAKTEPE,EMEK MAH.,400,370,363,215,148
SANCAKTEPE,EMEK MAH.,400,374,369,215,154
SANCAKTEPE,EMEK MAH.,402,370,364,200,164
SANCAKTEPE,EMEK MAH.,400,368,362,190,172
SANCAKTEPE,EMEK MAH.,399,367,361,183,178
SANCAKTEPE,EMEK MAH.,399,367,360,174,186
SANCAKTEPE,EMEK MAH.,403,356,340,182,158
SANCAKTEPE,EMEK MAH.,399,368,363,205,158
SANCAKTEPE,EMEK MAH.,399,349,339,214,125
SANCAKTEPE,EMEK MAH.,400,375,362,200,162
SANCAKTEPE,EMEK MAH.,400,373,366,200,166
SANCAKTEPE,EMEK MAH.,399,359,349,202,147
SANCAKTEPE,EYUP SULTAN MAH.,411,345,341,239,102
SANCAKTEPE,EYUP SULTAN MAH.,410,349,336,217,119
SANCAKTEPE,EYUP SULTAN MAH.,415,372,368,238,130
SANCAKTEPE,EYUP SULTAN MAH.,415,378,373,258,115
SANCAKTEPE,EYUP SULTAN MAH.,411,378,372,235,137
SANCAKTEPE,EYUP SULTAN MAH.,410,371,367,249,118
SANCAKTEPE,EYUP SULTAN MAH.,415,373,371,235,136
SANCAKTEPE,EYUP SULTAN MAH.,415,383,379,251,128
SANCAKTEPE,EYUP SULTAN MAH.,412,377,372,236,136
SANCAKTEPE,EYUP SULTAN MAH.,411,348,345,224,121
SANCAKTEPE,EYUP SULTAN MAH.,415,379,375,230,145
SANCAKTEPE,EYUP SULTAN MAH.,415,372,364,241,123
SANCAKTEPE,EYUP SULTAN MAH.,412,364,360,215,145
SANCAKTEPE,EYUP SULTAN MAH.,412,365,359,220,139
SANCAKTEPE,EYUP SULTAN MAH.,415,370,364,209,155
SANCAKTEPE,EYUP SULTAN MAH.,411,385,378,248,130
SANCAKTEPE,EYUP SULTAN MAH.,411,363,359,226,133
SANCAKTEPE,EYUP SULTAN MAH.,411,371,358,250,108
SANCAKTEPE,EYUP SULTAN MAH.,412,361,355,206,149
SANCAKTEPE,EYUP SULTAN MAH.,412,364,360,220,140
SANCAKTEPE,EYUP SULTAN MAH.,412,359,357,231,126
SANCAKTEPE,EYUP SULTAN MAH.,415,375,365,234,131
SANCAKTEPE,EYUP SULTAN MAH.,411,377,371,255,116
SANCAKTEPE,EYUP SULTAN MAH.,412,361,355,231,124
SANCAKTEPE,EYUP SULTAN MAH.,412,367,362,227,135
SANCAKTEPE,EYUP SULTAN MAH.,411,374,372,209,163
SANCAKTEPE,EYUP SULTAN MAH.,411,379,370,265,105
SANCAKTEPE,FATIH MAH.,415,340,333,245,88
SANCAKTEPE,FATIH MAH.,415,355,348,234,114
SANCAKTEPE,FATIH MAH.,410,369,358,212,146
SANCAKTEPE,FATIH MAH.,411,386,377,229,148
SANCAKTEPE,FATIH MAH.,410,380,367,237,130
SANCAKTEPE,FATIH MAH.,411,362,356,233,123
SANCAKTEPE,FATIH MAH.,410,354,348,220,128
SANCAKTEPE,FATIH MAH.,410,365,359,223,136
SANCAKTEPE,FATIH MAH.,411,371,365,214,151
SANCAKTEPE,FATIH MAH.,411,363,357,212,145
SANCAKTEPE,FATIH MAH.,410,374,370,241,129
SANCAKTEPE,FATIH MAH.,410,373,366,217,149
SANCAKTEPE,FATIH MAH.,410,372,367,214,153
SANCAKTEPE,FATIH MAH.,409,365,360,248,112
SANCAKTEPE,FATIH MAH.,411,379,377,260,117
SANCAKTEPE,FATIH MAH.,410,363,358,223,135
SANCAKTEPE,FATIH MAH.,411,368,362,238,124
SANCAKTEPE,FATIH MAH.,410,360,358,217,141
SANCAKTEPE,FATIH MAH.,411,364,360,230,130
SANCAKTEPE,FATIH MAH.,410,368,365,205,160
SANCAKTEPE,FATIH MAH.,410,369,365,232,133
SANCAKTEPE,FATIH MAH.,409,374,371,234,137
SANCAKTEPE,FATIH MAH.,411,373,362,223,139
SANCAKTEPE,FATIH MAH.,410,367,362,231,131
SANCAKTEPE,FATIH MAH.,410,376,371,191,180
SANCAKTEPE,FATIH MAH.,411,377,372,234,138
SANCAKTEPE,FATIH MAH.,410,357,354,225,129
SANCAKTEPE,FATIH MAH.,411,376,373,218,155
SANCAKTEPE,FATIH MAH.,409,385,378,241,137
SANCAKTEPE,FATIH MAH.,387,329,321,208,113
SANCAKTEPE,FATIH MAH.,387,359,356,220,136
SANCAKTEPE,FATIH MAH.,388,352,346,213,133
SANCAKTEPE,FATIH MAH.,387,361,360,219,141
SANCAKTEPE,FATIH MAH.,390,348,343,199,144
SANCAKTEPE,FATIH MAH.,387,345,341,226,115
SANCAKTEPE,FATIH MAH.,387,344,341,214,127
SANCAKTEPE,FATIH MAH.,387,338,337,213,124
SANCAKTEPE,FATIH MAH.,389,366,361,203,158
SANCAKTEPE,FATIH MAH.,387,345,341,194,147
SANCAKTEPE,FATIH MAH.,386,349,341,219,122
SANCAKTEPE,FATIH MAH.,386,347,337,223,114
SANCAKTEPE,FATIH MAH.,387,356,349,213,136
SANCAKTEPE,MECLIS MAH.,407,320,314,125,189
SANCAKTEPE,MECLIS MAH.,406,347,328,139,189
SANCAKTEPE,MECLIS MAH.,407,358,354,153,201
SANCAKTEPE,MECLIS MAH.,409,375,372,157,215
SANCAKTEPE,MECLIS MAH.,406,376,370,130,240
SANCAKTEPE,MECLIS MAH.,405,379,376,129,247
SANCAKTEPE,MECLIS MAH.,406,373,372,136,236
SANCAKTEPE,MECLIS MAH.,407,377,371,135,236
SANCAKTEPE,MECLIS MAH.,406,377,366,171,195
SANCAKTEPE,MECLIS MAH.,406,363,354,147,207
SANCAKTEPE,MECLIS MAH.,407,375,370,151,219
SANCAKTEPE,MECLIS MAH.,406,374,367,110,257
SANCAKTEPE,MECLIS MAH.,415,384,379,167,212
SANCAKTEPE,MECLIS MAH.,409,374,370,161,209
SANCAKTEPE,MECLIS MAH.,406,363,358,135,223
SANCAKTEPE,MECLIS MAH.,405,370,365,147,218
SANCAKTEPE,MECLIS MAH.,408,375,372,138,234
SANCAKTEPE,MECLIS MAH.,408,375,365,133,232
SANCAKTEPE,MECLIS MAH.,406,361,354,130,224
SANCAKTEPE,MECLIS MAH.,405,364,361,160,201
SANCAKTEPE,MECLIS MAH.,406,371,365,169,196
SANCAKTEPE,MECLIS MAH.,406,378,367,171,196
SANCAKTEPE,MECLIS MAH.,406,366,361,134,227
SANCAKTEPE,MECLIS MAH.,406,374,371,183,188
SANCAKTEPE,MECLIS MAH.,405,365,364,147,217
SANCAKTEPE,MECLIS MAH.,407,365,361,156,205
SANCAKTEPE,MECLIS MAH.,406,354,350,140,210
SANCAKTEPE,MECLIS MAH.,405,361,358,120,238
SANCAKTEPE,MECLIS MAH.,405,359,352,139,213
SANCAKTEPE,MECLIS MAH.,406,367,362,142,220
SANCAKTEPE,MECLIS MAH.,405,381,381,129,252
SANCAKTEPE,MECLIS MAH.,406,378,375,173,202
SANCAKTEPE,MECLIS MAH.,405,372,361,142,219
SANCAKTEPE,MECLIS MAH.,406,364,357,162,195
SANCAKTEPE,MECLIS MAH.,378,337,327,93,234
SANCAKTEPE,MECLIS MAH.,379,362,360,125,235
SANCAKTEPE,MECLIS MAH.,380,354,347,116,231
SANCAKTEPE,MECLIS MAH.,379,342,340,107,233
SANCAKTEPE,MECLIS MAH.,380,353,349,131,218
SANCAKTEPE,MECLIS MAH.,380,350,348,143,205
SANCAKTEPE,MECLIS MAH.,380,351,350,106,244
SANCAKTEPE,MECLIS MAH.,380,349,347,108,239
SANCAKTEPE,MECLIS MAH.,380,344,338,116,222
SANCAKTEPE,MECLIS MAH.,381,359,355,105,250
SANCAKTEPE,OSMANGAZI MAH.,412,360,355,237,118
SANCAKTEPE,OSMANGAZI MAH.,411,356,351,238,113
SANCAKTEPE,OSMANGAZI MAH.,413,357,355,254,101
SANCAKTEPE,OSMANGAZI MAH.,412,379,373,258,115
SANCAKTEPE,OSMANGAZI MAH.,411,393,388,271,117
SANCAKTEPE,OSMANGAZI MAH.,412,372,366,245,121
SANCAKTEPE,OSMANGAZI MAH.,412,372,362,250,112
SANCAKTEPE,OSMANGAZI MAH.,412,383,376,259,117
SANCAKTEPE,OSMANGAZI MAH.,411,385,377,272,105
SANCAKTEPE,OSMANGAZI MAH.,412,374,365,254,111
SANCAKTEPE,OSMANGAZI MAH.,412,373,366,262,104
SANCAKTEPE,OSMANGAZI MAH.,412,386,380,287,93
SANCAKTEPE,OSMANGAZI MAH.,411,382,380,278,102
SANCAKTEPE,OSMANGAZI MAH.,411,380,378,265,113
SANCAKTEPE,OSMANGAZI MAH.,411,369,363,254,109
SANCAKTEPE,OSMANGAZI MAH.,412,372,367,221,146
SANCAKTEPE,OSMANGAZI MAH.,411,370,367,255,112
SANCAKTEPE,OSMANGAZI MAH.,412,375,366,250,116
SANCAKTEPE,OSMANGAZI MAH.,411,357,351,247,104
SANCAKTEPE,OSMANGAZI MAH.,411,377,371,261,110
SANCAKTEPE,OSMANGAZI MAH.,412,383,380,240,140
SANCAKTEPE,OSMANGAZI MAH.,403,365,359,258,101
SANCAKTEPE,OSMANGAZI MAH.,403,371,363,223,140
SANCAKTEPE,OSMANGAZI MAH.,403,351,348,211,137
SANCAKTEPE,OSMANGAZI MAH.,403,367,364,244,120
SANCAKTEPE,OSMANGAZI MAH.,403,370,367,260,107
SANCAKTEPE,OSMANGAZI MAH.,403,369,358,238,120
SANCAKTEPE,OSMANGAZI MAH.,403,364,353,263,90
SANCAKTEPE,OSMANGAZI MAH.,402,350,344,249,95
SANCAKTEPE,OSMANGAZI MAH.,403,364,359,246,113
SANCAKTEPE,OSMANGAZI MAH.,404,351,339,208,131
SANCAKTEPE,OSMANGAZI MAH.,403,349,335,207,128
SANCAKTEPE,OSMANGAZI MAH.,401,363,359,244,115
SANCAKTEPE,OSMANGAZI MAH.,401,357,353,215,138
SANCAKTEPE,OSMANGAZI MAH.,400,348,345,226,119
SANCAKTEPE,OSMANGAZI MAH.,400,375,367,239,128
SANCAKTEPE,OSMANGAZI MAH.,400,357,352,220,132
SANCAKTEPE,OSMANGAZI MAH.,404,368,362,243,119
SANCAKTEPE,OSMANGAZI MAH.,401,345,338,232,106
SANCAKTEPE,OSMANGAZI MAH.,400,357,349,224,125
SANCAKTEPE,OSMANGAZI MAH.,401,360,353,222,131
SANCAKTEPE,OSMANGAZI MAH.,401,359,352,228,124
SANCAKTEPE,OSMANGAZI MAH.,401,355,348,237,111
SANCAKTEPE,OSMANGAZI MAH.,401,350,343,213,130
SANCAKTEPE,OSMANGAZI MAH.,401,364,358,241,117
SANCAKTEPE,OSMANGAZI MAH.,400,352,344,222,122
SANCAKTEPE,OSMANGAZI MAH.,401,355,349,215,134
SANCAKTEPE,OSMANGAZI MAH.,401,362,358,226,132
SANCAKTEPE,OSMANGAZI MAH.,402,367,362,241,121
SANCAKTEPE,OSMANGAZI MAH.,400,349,347,235,112
SANCAKTEPE,OSMANGAZI MAH.,378,340,337,183,154
SANCAKTEPE,OSMANGAZI MAH.,377,344,340,176,164
SANCAKTEPE,OSMANGAZI MAH.,378,335,325,189,136
SANCAKTEPE,OSMANGAZI MAH.,377,345,340,197,143
SANCAKTEPE,OSMANGAZI MAH.,379,343,337,202,135
SANCAKTEPE,OSMANGAZI MAH.,377,346,342,190,152
SANCAKTEPE,OSMANGAZI MAH.,377,331,326,201,125
SANCAKTEPE,OSMANGAZI MAH.,377,339,336,205,131
SANCAKTEPE,OSMANGAZI MAH.,377,327,324,221,103
SANCAKTEPE,OSMANGAZI MAH.,378,338,335,200,135
SANCAKTEPE,OSMANGAZI MAH.,378,335,330,199,131
SANCAKTEPE,SARIGAZI MAH.,404,336,329,124,205
SANCAKTEPE,SARIGAZI MAH.,404,360,357,133,224
SANCAKTEPE,SARIGAZI MAH.,408,381,378,110,268
SANCAKTEPE,SARIGAZI MAH.,404,375,366,134,232
SANCAKTEPE,SARIGAZI MAH.,404,374,363,131,232
SANCAKTEPE,SARIGAZI MAH.,404,370,366,122,244
SANCAKTEPE,SARIGAZI MAH.,404,367,360,132,228
SANCAKTEPE,SARIGAZI MAH.,406,370,366,128,238
SANCAKTEPE,SARIGAZI MAH.,406,375,371,143,228
SANCAKTEPE,SARIGAZI MAH.,404,373,368,134,234
SANCAKTEPE,SARIGAZI MAH.,404,367,367,138,229
SANCAKTEPE,SARIGAZI MAH.,404,365,364,124,240
SANCAKTEPE,SARIGAZI MAH.,404,367,365,115,250
SANCAKTEPE,SARIGAZI MAH.,404,374,369,135,234
SANCAKTEPE,SARIGAZI MAH.,404,372,369,139,230
SANCAKTEPE,SARIGAZI MAH.,404,356,350,125,225
SANCAKTEPE,SARIGAZI MAH.,403,368,366,130,236
SANCAKTEPE,SARIGAZI MAH.,400,349,345,111,234
SANCAKTEPE,SARIGAZI MAH.,399,363,357,134,223
SANCAKTEPE,SARIGAZI MAH.,400,367,361,146,215
SANCAKTEPE,SARIGAZI MAH.,399,369,362,104,258
SANCAKTEPE,SARIGAZI MAH.,399,362,353,142,211
SANCAKTEPE,SARIGAZI MAH.,399,370,367,112,255
SANCAKTEPE,SARIGAZI MAH.,399,372,365,113,252
SANCAKTEPE,SARIGAZI MAH.,398,365,356,121,235
SANCAKTEPE,SARIGAZI MAH.,399,356,348,118,230
SANCAKTEPE,SARIGAZI MAH.,403,360,352,112,240
SANCAKTEPE,SARIGAZI MAH.,399,360,356,153,203
SANCAKTEPE,SARIGAZI MAH.,399,365,357,114,243
SANCAKTEPE,SARIGAZI MAH.,402,364,362,133,229
SANCAKTEPE,SARIGAZI MAH.,399,344,339,135,204
SANCAKTEPE,SARIGAZI MAH.,399,369,360,113,247
SANCAKTEPE,SARIGAZI MAH.,399,369,365,130,235
SANCAKTEPE,SARIGAZI MAH.,399,365,361,126,235
SANCAKTEPE,SARIGAZI MAH.,399,366,361,115,246
SANCAKTEPE,VEYSEL KARANI MAH.,415,360,353,198,155
SANCAKTEPE,VEYSEL KARANI MAH.,415,342,333,198,135
SANCAKTEPE,VEYSEL KARANI MAH.,415,372,362,200,162
SANCAKTEPE,VEYSEL KARANI MAH.,416,372,360,192,168
SANCAKTEPE,VEYSEL KARANI MAH.,415,381,377,197,180
SANCAKTEPE,VEYSEL KARANI MAH.,416,380,369,189,180
SANCAKTEPE,VEYSEL KARANI MAH.,415,362,357,197,160
SANCAKTEPE,VEYSEL KARANI MAH.,416,365,356,200,156
SANCAKTEPE,VEYSEL KARANI MAH.,415,369,366,226,140
SANCAKTEPE,VEYSEL KARANI MAH.,416,371,366,215,151
SANCAKTEPE,VEYSEL KARANI MAH.,413,366,359,200,159
SANCAKTEPE,VEYSEL KARANI MAH.,413,375,372,194,178
SANCAKTEPE,VEYSEL KARANI MAH.,415,366,362,166,196
SANCAKTEPE,VEYSEL KARANI MAH.,413,384,374,187,187
SANCAKTEPE,VEYSEL KARANI MAH.,415,381,376,201,175
SANCAKTEPE,VEYSEL KARANI MAH.,415,361,357,180,177
SANCAKTEPE,VEYSEL KARANI MAH.,416,368,363,191,172
SANCAKTEPE,VEYSEL KARANI MAH.,415,377,376,211,165
SANCAKTEPE,VEYSEL KARANI MAH.,413,376,367,184,183
SANCAKTEPE,VEYSEL KARANI MAH.,415,359,347,165,182
SANCAKTEPE,VEYSEL KARANI MAH.,414,371,358,193,165
SANCAKTEPE,VEYSEL KARANI MAH.,414,362,354,207,147
SANCAKTEPE,VEYSEL KARANI MAH.,415,356,347,186,161
SANCAKTEPE,VEYSEL KARANI MAH.,412,351,345,205,140
SANCAKTEPE,VEYSEL KARANI MAH.,414,363,357,184,173
SANCAKTEPE,VEYSEL KARANI MAH.,413,364,356,190,166
SANCAKTEPE,VEYSEL KARANI MAH.,414,383,375,225,150
SANCAKTEPE,VEYSEL KARANI MAH.,413,372,367,214,153
SANCAKTEPE,VEYSEL KARANI MAH.,412,381,376,220,156
SANCAKTEPE,VEYSEL KARANI MAH.,413,363,355,201,154
PENDIK,BAHCELIEVLER MAH.,355,301,297,115,182
PENDIK,BAHCELIEVLER MAH.,357,330,329,140,189
PENDIK,BAHCELIEVLER MAH.,356,332,331,120,211
PENDIK,BAHCELIEVLER MAH.,359,324,317,150,167
PENDIK,BAHCELIEVLER MAH.,357,333,327,121,206
PENDIK,BAHCELIEVLER MAH.,357,328,322,152,170
PENDIK,BAHCELIEVLER MAH.,391,331,327,127,200
PENDIK,BAHCELIEVLER MAH.,391,340,335,144,191
PENDIK,BAHCELIEVLER MAH.,391,338,332,148,184
PENDIK,BAHCELIEVLER MAH.,392,372,370,156,214
PENDIK,BAHCELIEVLER MAH.,392,341,337,153,184
PENDIK,BAHCELIEVLER MAH.,392,356,351,127,224
PENDIK,BAHCELIEVLER MAH.,394,355,352,151,201
PENDIK,BAHCELIEVLER MAH.,392,350,340,157,183
PENDIK,BAHCELIEVLER MAH.,392,360,354,166,188
PENDIK,BAHCELIEVLER MAH.,383,309,301,145,156
PENDIK,BAHCELIEVLER MAH.,383,335,327,150,177
PENDIK,BAHCELIEVLER MAH.,388,341,336,159,177
PENDIK,BAHCELIEVLER MAH.,384,345,342,171,171
PENDIK,BAHCELIEVLER MAH.,383,330,328,150,178
PENDIK,BAHCELIEVLER MAH.,384,357,346,149,197
PENDIK,BAHCELIEVLER MAH.,383,333,321,133,188
PENDIK,BAHCELIEVLER MAH.,384,352,345,162,183
PENDIK,BAHCELIEVLER MAH.,382,363,359,154,205
PENDIK,BATI MAH.,409,316,314,60,254
PENDIK,BATI MAH.,408,341,328,87,241
PENDIK,BATI MAH.,409,373,371,84,287
PENDIK,BATI MAH.,409,374,369,84,285
PENDIK,BATI MAH.,408,365,359,97,262
PENDIK,BATI MAH.,408,363,363,113,250
PENDIK,BATI MAH.,408,374,369,103,266
PENDIK,BATI MAH.,408,379,377,91,286
PENDIK,BATI MAH.,408,373,369,105,264
PENDIK,BATI MAH.,408,370,367,92,275
PENDIK,BATI MAH.,407,377,374,116,258
PENDIK,BATI MAH.,407,378,376,90,286
PENDIK,BATI MAH.,411,365,359,92,267
PENDIK,BATI MAH.,408,366,356,104,252
PENDIK,BATI MAH.,407,350,347,91,256
PENDIK,BATI MAH.,406,320,316,79,237
PENDIK,BATI MAH.,407,340,338,72,266
PENDIK,BATI MAH.,407,366,362,91,271
PENDIK,BATI MAH.,409,351,349,99,250
PENDIK,BATI MAH.,408,357,351,104,247
PENDIK,BATI MAH.,410,367,363,98,265
PENDIK,BATI MAH.,407,372,370,100,270
PENDIK,BATI MAH.,407,371,368,104,264
PENDIK,BATI MAH.,407,352,345,101,244
PENDIK,BATI MAH.,407,362,361,103,258
PENDIK,BATI MAH.,408,360,356,113,243
PENDIK,BATI MAH.,409,363,358,96,262
PENDIK,BATI MAH.,406,369,364,93,271
PENDIK,BATI MAH.,406,371,368,86,282
PENDIK,BATI MAH.,407,359,355,105,250
PENDIK,CINARDERE MAH.,404,349,348,193,155
PENDIK,CINARDERE MAH.,403,347,335,183,152
PENDIK,CINARDERE MAH.,403,358,355,220,135
PENDIK,CINARDERE MAH.,403,360,351,191,160
PENDIK,CINARDERE MAH.,404,367,360,214,146
PENDIK,CINARDERE MAH.,408,347,342,197,145
PENDIK,CINARDERE MAH.,404,354,348,212,136
PENDIK,CINARDERE MAH.,402,351,344,227,117
PENDIK,CINARDERE MAH.,404,368,362,240,122
PENDIK,CINARDERE MAH.,404,363,360,217,143
PENDIK,CINARDERE MAH.,403,340,331,197,134
PENDIK,CINARDERE MAH.,403,373,367,240,127
PENDIK,CINARDERE MAH.,402,359,353,229,124
PENDIK,CINARDERE MAH.,394,325,323,197,126
PENDIK,CINARDERE MAH.,394,358,354,198,156
PENDIK,CINARDERE MAH.,394,355,351,204,147
PENDIK,CINARDERE MAH.,393,343,338,176,162
PENDIK,CINARDERE MAH.,394,354,353,207,146
PENDIK,CINARDERE MAH.,395,356,353,202,151
PENDIK,CINARDERE MAH.,392,343,340,182,158
PENDIK,CINARDERE MAH.,393,361,353,192,161
PENDIK,CINARDERE MAH.,392,343,339,166,173
PENDIK,CINARDERE MAH.,396,329,317,193,124
PENDIK,CINARDERE MAH.,395,347,336,207,129
PENDIK,CINARDERE MAH.,396,365,357,229,128
PENDIK,CINARDERE MAH.,396,343,339,218,121
PENDIK,CINARDERE MAH.,395,360,350,213,137
PENDIK,CINARDERE MAH.,395,362,361,232,129
PENDIK,CINARDERE MAH.,399,357,355,224,131
PENDIK,CINARDERE MAH.,396,347,345,210,135
PENDIK,CINARDERE MAH.,396,357,352,216,136
PENDIK,CINARDERE MAH.,395,347,344,223,121
PENDIK,CINARDERE MAH.,396,351,347,229,118
PENDIK,CINARDERE MAH.,396,370,364,220,144
PENDIK,DOGU MAH.,403,326,324,114,210
PENDIK,DOGU MAH.,402,330,324,106,218
PENDIK,DOGU MAH.,403,343,339,115,224
PENDIK,DOGU MAH.,402,356,354,131,223
PENDIK,DOGU MAH.,401,354,347,122,225
PENDIK,DOGU MAH.,402,364,357,146,211
PENDIK,DOGU MAH.,403,362,360,131,229
PENDIK,DOGU MAH.,402,354,354,126,228
PENDIK,DOGU MAH.,402,355,349,134,215
PENDIK,DOGU MAH.,402,377,374,118,256
PENDIK,DOGU MAH.,402,355,352,147,205
PENDIK,DOGU MAH.,405,367,365,140,225
PENDIK,DOGU MAH.,402,366,359,172,187
PENDIK,DOGU MAH.,403,356,352,130,222
PENDIK,DOGU MAH.,402,367,360,152,208
PENDIK,DOGU MAH.,402,354,353,141,212
PENDIK,DOGU MAH.,402,366,364,138,226
PENDIK,DOGU MAH.,401,353,351,163,188
PENDIK,DOGU MAH.,402,377,373,144,229
PENDIK,DOGU MAH.,408,342,337,149,188
PENDIK,DOGU MAH.,409,375,366,128,238
PENDIK,DOGU MAH.,409,354,349,145,204
PENDIK,DOGU MAH.,415,375,363,151,212
PENDIK,DOGU MAH.,410,383,379,140,239
PENDIK,DOGU MAH.,410,360,358,130,228
PENDIK,DOGU MAH.,410,377,372,186,186
PENDIK,DOGU MAH.,407,367,360,145,215
PENDIK,DOGU MAH.,409,366,364,135,229
PENDIK,DOGU MAH.,410,379,372,156,216
PENDIK,DOGU MAH.,410,376,370,167,203
PENDIK,DUMLUPINAR MAH.,404,339,330,229,101
PENDIK,DUMLUPINAR MAH.,407,332,322,212,110
PENDIK,DUMLUPINAR MAH.,406,346,332,208,124
PENDIK,DUMLUPINAR MAH.,408,342,338,221,117
PENDIK,DUMLUPINAR MAH.,405,364,358,245,113
PENDIK,DUMLUPINAR MAH.,404,360,350,195,155
PENDIK,DUMLUPINAR MAH.,407,368,366,222,144
PENDIK,DUMLUPINAR MAH.,406,347,339,228,111
PENDIK,DUMLUPINAR MAH.,404,358,353,242,111
PENDIK,DUMLUPINAR MAH.,404,359,352,238,114
PENDIK,DUMLUPINAR MAH.,405,356,355,240,115
PENDIK,DUMLUPINAR MAH.,404,336,332,205,127
PENDIK,DUMLUPINAR MAH.,405,359,348,252,96
PENDIK,DUMLUPINAR MAH.,404,366,361,218,143
PENDIK,DUMLUPINAR MAH.,407,370,362,236,126
PENDIK,DUMLUPINAR MAH.,405,355,350,245,105
PENDIK,DUMLUPINAR MAH.,407,361,352,225,127
PENDIK,DUMLUPINAR MAH.,405,340,333,237,96
PENDIK,DUMLUPINAR MAH.,405,347,343,222,121
PENDIK,DUMLUPINAR MAH.,405,364,358,235,123
PENDIK,DUMLUPINAR MAH.,415,333,328,228,100
PENDIK,DUMLUPINAR MAH.,415,338,326,219,107
PENDIK,DUMLUPINAR MAH.,415,371,368,256,112
PENDIK,DUMLUPINAR MAH.,415,386,382,235,147
PENDIK,DUMLUPINAR MAH.,412,359,355,244,111
PENDIK,DUMLUPINAR MAH.,409,373,371,252,119
PENDIK,DUMLUPINAR MAH.,411,384,376,252,124
PENDIK,DUMLUPINAR MAH.,415,369,364,242,122
PENDIK,DUMLUPINAR MAH.,415,386,379,266,113
PENDIK,DUMLUPINAR MAH.,411,369,362,240,122
PENDIK,DUMLUPINAR MAH.,412,364,360,249,111
PENDIK,DUMLUPINAR MAH.,415,364,361,232,129
PENDIK,DUMLUPINAR MAH.,412,386,382,255,127
PENDIK,DUMLUPINAR MAH.,410,368,366,262,104
PENDIK,DUMLUPINAR MAH.,412,379,374,258,116
PENDIK,DUMLUPINAR MAH.,411,376,374,256,118
PENDIK,DUMLUPINAR MAH.,411,372,366,262,104
PENDIK,DUMLUPINAR MAH.,415,366,363,257,106
PENDIK,DUMLUPINAR MAH.,409,365,362,277,85
PENDIK,DUMLUPINAR MAH.,412,363,360,251,109
PENDIK,DUMLUPINAR MAH.,415,381,378,257,121
PENDIK,DUMLUPINAR MAH.,415,382,376,262,114
PENDIK,DUMLUPINAR MAH.,412,366,362,271,91
PENDIK,DUMLUPINAR MAH.,415,373,365,252,113
PENDIK,DUMLUPINAR MAH.,412,372,370,234,136
PENDIK,FEVZI CAKMAK MAH.,400,344,338,257,81
PENDIK,FEVZI CAKMAK MAH.,400,326,322,256,66
PENDIK,FEVZI CAKMAK MAH.,401,359,354,264,90
PENDIK,FEVZI CAKMAK MAH.,400,351,344,269,75
PENDIK,FEVZI CAKMAK MAH.,400,352,350,234,116
PENDIK,FEVZI CAKMAK MAH.,401,362,353,259,94
PENDIK,FEVZI CAKMAK MAH.,400,354,349,214,135
PENDIK,FEVZI CAKMAK MAH.,401,364,360,249,111
PENDIK,FEVZI CAKMAK MAH.,400,379,362,270,92
PENDIK,FEVZI CAKMAK MAH.,400,361,354,261,93
PENDIK,FEVZI CAKMAK MAH.,403,359,352,236,116
PENDIK,FEVZI CAKMAK MAH.,401,361,358,255,103
PENDIK,FEVZI CAKMAK MAH.,400,341,337,261,76
PENDIK,FEVZI CAKMAK MAH.,400,367,365,277,88
PENDIK,FEVZI CAKMAK MAH.,400,354,349,255,94
PENDIK,FEVZI CAKMAK MAH.,402,358,351,251,100
PENDIK,FEVZI CAKMAK MAH.,401,363,357,279,78
PENDIK,FEVZI CAKMAK MAH.,404,363,359,267,92
PENDIK,FEVZI CAKMAK MAH.,402,366,361,252,109
PENDIK,FEVZI CAKMAK MAH.,399,357,352,237,115
PENDIK,FEVZI CAKMAK MAH.,399,364,359,238,121
PENDIK,FEVZI CAKMAK MAH.,399,362,356,265,91
PENDIK,FEVZI CAKMAK MAH.,400,346,340,239,101
PENDIK,FEVZI CAKMAK MAH.,399,349,344,249,95
PENDIK,FEVZI CAKMAK MAH.,399,366,362,267,95
PENDIK,FEVZI CAKMAK MAH.,400,363,358,267,91
PENDIK,FEVZI CAKMAK MAH.,400,346,338,235,103
PENDIK,FEVZI CAKMAK MAH.,410,349,345,268,77
PENDIK,FEVZI CAKMAK MAH.,409,368,366,272,94
PENDIK,FEVZI CAKMAK MAH.,415,376,375,272,103
PENDIK,FEVZI CAKMAK MAH.,409,365,362,285,77
PENDIK,FEVZI CAKMAK MAH.,415,373,368,262,106
PENDIK,FEVZI CAKMAK MAH.,410,370,367,280,87
PENDIK,FEVZI CAKMAK MAH.,410,374,371,305,66
PENDIK,FEVZI CAKMAK MAH.,409,356,351,256,95
PENDIK,FEVZI CAKMAK MAH.,410,380,371,291,80
PENDIK,FEVZI CAKMAK MAH.,409,367,364,271,93
PENDIK,FEVZI CAKMAK MAH.,409,360,357,272,85
PENDIK,FEVZI CAKMAK MAH.,410,369,364,276,88
PENDIK,FEVZI CAKMAK MAH.,398,350,345,268,77
PENDIK,FEVZI CAKMAK MAH.,398,347,342,256,86
PENDIK,FEVZI CAKMAK MAH.,398,351,350,267,83
PENDIK,FEVZI CAKMAK MAH.,398,368,364,273,91
PENDIK,FEVZI CAKMAK MAH.,397,364,357,287,70
PENDIK,FEVZI CAKMAK MAH.,397,352,345,275,70
PENDIK,FEVZI CAKMAK MAH.,399,365,363,279,84
PENDIK,FEVZI CAKMAK MAH.,398,353,352,271,81
PENDIK,FEVZI CAKMAK MAH.,398,377,371,291,80
PENDIK,FEVZI CAKMAK MAH.,398,357,352,257,95
PENDIK,FEVZI CAKMAK MAH.,398,353,351,260,91
PENDIK,FEVZI CAKMAK MAH.,399,356,345,282,63
PENDIK,FEVZI CAKMAK MAH.,398,351,350,261,89
PENDIK,FEVZI CAKMAK MAH.,397,354,347,281,66
PENDIK,FEVZI CAKMAK MAH.,396,367,361,275,86
PENDIK,FEVZI CAKMAK MAH.,397,353,346,252,94
PENDIK,FEVZI CAKMAK MAH.,397,348,345,263,82
PENDIK,FEVZI CAKMAK MAH.,397,357,353,260,93
PENDIK,FEVZI CAKMAK MAH.,408,331,326,235,91
PENDIK,FEVZI CAKMAK MAH.,407,367,360,233,127
PENDIK,FEVZI CAKMAK MAH.,410,371,367,238,129
PENDIK,FEVZI CAKMAK MAH.,406,370,367,227,140
PENDIK,FEVZI CAKMAK MAH.,406,360,356,226,130
PENDIK,FEVZI CAKMAK MAH.,406,349,340,210,130
PENDIK,FEVZI CAKMAK MAH.,406,354,353,228,125
PENDIK,FEVZI CAKMAK MAH.,407,353,352,232,120
PENDIK,KAYNARCA MAH.,399,308,303,179,124
PENDIK,KAYNARCA MAH.,395,359,352,178,174
PENDIK,KAYNARCA MAH.,397,351,347,174,173
PENDIK,KAYNARCA MAH.,394,360,358,184,174
PENDIK,KAYNARCA MAH.,395,359,353,183,170
PENDIK,KAYNARCA MAH.,395,369,365,176,189
PENDIK,KAYNARCA MAH.,395,356,350,177,173
PENDIK,KAYNARCA MAH.,395,345,336,163,173
PENDIK,KAYNARCA MAH.,394,361,358,170,188
PENDIK,KAYNARCA MAH.,395,357,352,183,169
PENDIK,KAYNARCA MAH.,394,343,340,203,137
PENDIK,KAYNARCA MAH.,395,344,341,181,160
PENDIK,KAYNARCA MAH.,394,360,354,198,156
PENDIK,KAYNARCA MAH.,410,367,358,187,171
PENDIK,KAYNARCA MAH.,409,342,333,177,156
PENDIK,KAYNARCA MAH.,409,372,365,194,171
PENDIK,KAYNARCA MAH.,409,378,375,197,178
PENDIK,KAYNARCA MAH.,410,372,370,222,148
PENDIK,KAYNARCA MAH.,411,364,361,188,173
PENDIK,KAYNARCA MAH.,410,373,366,203,163
PENDIK,KAYNARCA MAH.,410,363,360,192,168
PENDIK,KAYNARCA MAH.,410,376,369,203,166
PENDIK,KAYNARCA MAH.,410,371,365,186,179
PENDIK,KAYNARCA MAH.,410,371,369,201,168
PENDIK,KAYNARCA MAH.,410,368,366,198,168
PENDIK,KAYNARCA MAH.,409,376,374,225,149
PENDIK,KAYNARCA MAH.,409,359,350,187,163
PENDIK,KAYNARCA MAH.,410,369,364,206,158
PENDIK,KAYNARCA MAH.,410,367,362,202,160
PENDIK,KAYNARCA MAH.,410,366,363,198,165
PENDIK,KAYNARCA MAH.,409,361,358,186,172
PENDIK,KAYNARCA MAH.,410,343,334,188,146
PENDIK,KAYNARCA MAH.,415,369,359,177,182
PENDIK,KAYNARCA MAH.,410,374,369,211,158
PENDIK,KAYNARCA MAH.,410,369,366,203,163
PENDIK,KAYNARCA MAH.,410,374,367,181,186
PENDIK,KAYNARCA MAH.,415,349,340,244,96
PENDIK,KAYNARCA MAH.,415,361,355,217,138
PENDIK,KAYNARCA MAH.,416,357,352,216,136
PENDIK,KAYNARCA MAH.,415,376,369,230,139
PENDIK,KAYNARCA MAH.,415,362,355,197,158
PENDIK,KAYNARCA MAH.,417,358,352,208,144
PENDIK,KAYNARCA MAH.,420,372,368,222,146
PENDIK,KAYNARCA MAH.,417,370,363,233,130
PENDIK,KAYNARCA MAH.,415,361,349,201,148
PENDIK,KAYNARCA MAH.,415,378,368,234,134
PENDIK,KAYNARCA MAH.,415,382,374,235,139
PENDIK,KAYNARCA MAH.,417,366,364,217,147
PENDIK,KAYNARCA MAH.,414,361,356,201,155
PENDIK,KAYNARCA MAH.,414,365,362,195,167
PENDIK,KAYNARCA MAH.,414,361,354,209,145
PENDIK,KAYNARCA MAH.,414,371,363,216,147
PENDIK,KAYNARCA MAH.,416,366,359,205,154
PENDIK,KAYNARCA MAH.,415,370,362,210,152
PENDIK,KAYNARCA MAH.,414,353,344,218,126
PENDIK,KAYNARCA MAH.,414,369,367,220,147
PENDIK,KAYNARCA MAH.,409,335,331,199,132
PENDIK,KAYNARCA MAH.,409,366,363,231,132
PENDIK,KAYNARCA MAH.,409,361,356,212,144
PENDIK,KAYNARCA MAH.,410,362,353,230,123
PENDIK,KAYNARCA MAH.,409,361,357,214,143
PENDIK,KAYNARCA MAH.,408,356,348,234,114
PENDIK,KAYNARCA MAH.,409,369,363,212,151
PENDIK,KAYNARCA MAH.,409,369,366,234,132
PENDIK,KAYNARCA MAH.,409,355,343,229,114
PENDIK,KAYNARCA MAH.,409,355,353,227,126
PENDIK,KAYNARCA MAH.,409,365,362,230,132
PENDIK,KAYNARCA MAH.,408,350,341,213,128
PENDIK,KAYNARCA MAH.,409,361,357,230,127
PENDIK,KAYNARCA MAH.,408,370,367,236,131
PENDIK,KAYNARCA MAH.,410,366,357,195,162
PENDIK,KAYNARCA MAH.,408,360,352,213,139
PENDIK,KAYNARCA MAH.,409,360,357,231,126
PENDIK,KAYNARCA MAH.,403,338,333,207,126
PENDIK,KAYNARCA MAH.,402,362,351,226,125
PENDIK,KAYNARCA MAH.,403,375,367,235,132
PENDIK,KAYNARCA MAH.,403,366,359,218,141
PENDIK,KAYNARCA MAH.,402,367,360,234,126
PENDIK,KAYNARCA MAH.,401,371,367,228,139
PENDIK,KAYNARCA MAH.,403,353,350,218,132
PENDIK,KAYNARCA MAH.,402,352,345,226,119
PENDIK,KAYNARCA MAH.,402,358,353,239,114
PENDIK,KAYNARCA MAH.,402,372,368,230,138
PENDIK,KAYNARCA MAH.,402,358,355,242,113
PENDIK,KAYNARCA MAH.,402,353,351,223,128
PENDIK,KAYNARCA MAH.,402,353,343,196,147
PENDIK,ORTA MAH.,370,291,276,187,89
PENDIK,ORTA MAH.,367,335,331,210,121
PENDIK,ORTA MAH.,367,324,320,220,100
PENDIK,ORTA MAH.,367,312,308,185,123
PENDIK,ORTA MAH.,367,317,307,190,117
PENDIK,ORTA MAH.,367,326,322,214,108
PENDIK,ORTA MAH.,387,337,329,175,154
PENDIK,ORTA MAH.,387,353,347,203,144
PENDIK,ORTA MAH.,387,352,350,188,162
PENDIK,ORTA MAH.,390,346,337,200,137
PENDIK,ORTA MAH.,387,346,343,187,156
PENDIK,ORTA MAH.,388,348,346,223,123
PENDIK,SAPAN BAGLARI MAH.,402,345,342,127,215
PENDIK,SAPAN BAGLARI MAH.,402,329,324,113,211
PENDIK,SAPAN BAGLARI MAH.,402,363,356,120,236
PENDIK,SAPAN BAGLARI MAH.,403,357,356,138,218
PENDIK,SAPAN BAGLARI MAH.,402,360,356,123,233
PENDIK,SAPAN BAGLARI MAH.,402,378,374,112,262
PENDIK,SAPAN BAGLARI MAH.,403,373,370,107,263
PENDIK,SAPAN BAGLARI MAH.,403,355,353,126,227
PENDIK,SAPAN BAGLARI MAH.,402,352,348,126,222
PENDIK,SAPAN BAGLARI MAH.,403,359,355,119,236
PENDIK,SAPAN BAGLARI MAH.,403,363,359,111,248
PENDIK,SAPAN BAGLARI MAH.,402,362,353,136,217
PENDIK,SAPAN BAGLARI MAH.,403,362,362,129,233
PENDIK,SAPAN BAGLARI MAH.,403,372,367,113,254
PENDIK,SAPAN BAGLARI MAH.,404,367,361,134,227
PENDIK,SAPAN BAGLARI MAH.,402,365,365,147,218
PENDIK,SAPAN BAGLARI MAH.,403,369,366,127,239
PENDIK,SAPAN BAGLARI MAH.,403,378,374,159,215
PENDIK,SAPAN BAGLARI MAH.,403,349,345,137,208
PENDIK,SAPAN BAGLARI MAH.,403,365,361,131,230
PENDIK,YENI MAH.,380,317,311,132,179
PENDIK,YENI MAH.,380,334,331,114,217
PENDIK,YENI MAH.,380,358,356,119,237
PENDIK,YENI MAH.,380,356,350,141,209
PENDIK,YENI MAH.,380,351,348,120,228
PENDIK,YENI MAH.,383,360,358,134,224
PENDIK,YENI MAH.,379,347,337,127,210
PENDIK,YENI MAH.,380,355,353,103,250
PENDIK,YENI MAH.,379,343,339,115,224
PENDIK,YENI MAH.,380,355,351,108,243
PENDIK,YENI MAH.,380,333,331,105,226
PENDIK,YENI MAH.,403,335,325,104,221
PENDIK,YENI MAH.,404,321,315,100,215
PENDIK,YENI MAH.,404,350,347,83,264
PENDIK,YENI MAH.,403,366,361,117,244
PENDIK,YENI MAH.,403,376,371,117,254
PENDIK,YENI MAH.,404,363,356,122,234
PENDIK,YENI MAH.,403,359,353,108,245
PENDIK,YENI MAH.,405,375,372,112,260
PENDIK,YENI MAH.,406,364,358,110,248
PENDIK,YENI MAH.,404,371,363,136,227
PENDIK,YENI MAH.,402,361,359,126,233
PENDIK,YENI MAH.,403,378,373,127,246
PENDIK,YENI MAH.,402,372,370,121,249
PENDIK,YENI MAH.,402,367,362,111,251
PENDIK,YENI MAH.,402,358,354,112,242
PENDIK,YENI MAH.,403,361,353,112,241
PENDIK,YENI MAH.,402,373,365,124,241
PENDIK,YENI MAH.,403,368,366,141,225
PENDIK,YESILBAGLAR MAH.,412,357,351,143,208
PENDIK,YESILBAGLAR MAH.,409,369,359,128,231
PENDIK,YESILBAGLAR MAH.,409,365,363,118,245
PENDIK,YESILBAGLAR MAH.,409,376,373,155,218
PENDIK,YESILBAGLAR MAH.,410,372,367,135,232
PENDIK,YESILBAGLAR MAH.,409,378,376,172,204
PENDIK,YESILBAGLAR MAH.,408,376,374,162,212
PENDIK,YESILBAGLAR MAH.,408,378,373,181,192
PENDIK,YESILBAGLAR MAH.,408,367,361,190,171
PENDIK,YESILBAGLAR MAH.,408,381,375,153,222
PENDIK,YESILBAGLAR MAH.,409,362,359,161,198
PENDIK,AHMET YESEVI MAH.,398,333,329,190,139
PENDIK,AHMET YESEVI MAH.,397,337,328,137,191
PENDIK,AHMET YESEVI MAH.,397,358,355,214,141
PENDIK,AHMET YESEVI MAH.,397,346,340,201,139
PENDIK,AHMET YESEVI MAH.,398,348,342,187,155
PENDIK,AHMET YESEVI MAH.,397,344,340,187,153
PENDIK,AHMET YESEVI MAH.,396,351,341,203,138
PENDIK,AHMET YESEVI MAH.,397,347,346,178,168
PENDIK,AHMET YESEVI MAH.,396,349,347,208,139
PENDIK,AHMET YESEVI MAH.,397,341,334,172,162
PENDIK,AHMET YESEVI MAH.,396,338,327,170,157
PENDIK,AHMET YESEVI MAH.,396,340,339,155,184
PENDIK,AHMET YESEVI MAH.,398,339,333,170,163
PENDIK,AHMET YESEVI MAH.,397,342,336,173,163
PENDIK,AHMET YESEVI MAH.,396,358,354,195,159
PENDIK,AHMET YESEVI MAH.,396,354,348,194,154
PENDIK,AHMET YESEVI MAH.,397,354,350,171,179
PENDIK,AHMET YESEVI MAH.,397,356,353,184,169
PENDIK,AHMET YESEVI MAH.,397,338,329,173,156
PENDIK,AHMET YESEVI MAH.,396,354,348,175,173
PENDIK,AHMET YESEVI MAH.,397,356,353,187,166
PENDIK,AHMET YESEVI MAH.,397,351,346,205,141
PENDIK,AHMET YESEVI MAH.,407,351,348,152,196
PENDIK,AHMET YESEVI MAH.,407,358,354,149,205
PENDIK,AHMET YESEVI MAH.,407,376,366,179,187
PENDIK,AHMET YESEVI MAH.,407,367,362,188,174
PENDIK,AHMET YESEVI MAH.,407,357,356,177,179
PENDIK,AHMET YESEVI MAH.,407,371,367,173,194
PENDIK,AHMET YESEVI MAH.,406,364,358,189,169
PENDIK,AHMET YESEVI MAH.,407,352,348,158,190
PENDIK,AHMET YESEVI MAH.,408,353,342,180,162
PENDIK,AHMET YESEVI MAH.,409,359,357,164,193
PENDIK,AHMET YESEVI MAH.,407,362,352,153,199
PENDIK,AHMET YESEVI MAH.,407,339,335,152,183
PENDIK,AHMET YESEVI MAH.,407,339,337,150,187
PENDIK,AHMET YESEVI MAH.,411,358,352,164,188
PENDIK,AHMET YESEVI MAH.,408,343,339,152,187
PENDIK,AHMET YESEVI MAH.,407,351,342,160,182
PENDIK,AHMET YESEVI MAH.,406,357,353,182,171
PENDIK,AHMET YESEVI MAH.,406,353,343,148,195
PENDIK,AHMET YESEVI MAH.,407,369,365,178,187
PENDIK,AHMET YESEVI MAH.,406,369,364,180,184
PENDIK,AHMET YESEVI MAH.,407,355,350,195,155
PENDIK,AHMET YESEVI MAH.,406,353,345,180,165
PENDIK,AHMET YESEVI MAH.,406,367,364,200,164
PENDIK,CAMCESME MAH.,415,356,343,243,100
PENDIK,CAMCESME MAH.,410,338,332,225,107
PENDIK,CAMCESME MAH.,415,370,366,251,115
PENDIK,CAMCESME MAH.,410,381,378,250,128
PENDIK,CAMCESME MAH.,411,361,359,248,111
PENDIK,CAMCESME MAH.,410,366,364,264,100
PENDIK,CAMCESME MAH.,410,351,340,233,107
PENDIK,CAMCESME MAH.,410,375,370,247,123
PENDIK,CAMCESME MAH.,410,368,365,244,121
PENDIK,CAMCESME MAH.,415,383,374,293,81
PENDIK,CAMCESME MAH.,409,356,352,241,111
PENDIK,CAMCESME MAH.,410,363,362,263,99
PENDIK,CAMCESME MAH.,410,364,357,246,111
PENDIK,CAMCESME MAH.,411,367,363,244,119
PENDIK,CAMCESME MAH.,411,369,360,232,128
PENDIK,CAMCESME MAH.,411,367,353,252,101
PENDIK,CAMCESME MAH.,409,370,368,258,110
PENDIK,CAMCESME MAH.,409,362,358,249,109
PENDIK,CAMCESME MAH.,410,375,371,275,96
PENDIK,CAMCESME MAH.,409,382,375,255,120
PENDIK,CAMCESME MAH.,410,368,365,257,108
PENDIK,CAMCESME MAH.,410,365,358,241,117
PENDIK,CAMCESME MAH.,410,376,367,241,126
PENDIK,CAMCESME MAH.,409,378,377,242,135
PENDIK,CAMCESME MAH.,409,355,348,254,94
PENDIK,CAMCESME MAH.,409,354,350,229,121
PENDIK,CAMCESME MAH.,410,365,363,245,118
PENDIK,CAMCESME MAH.,410,362,356,255,101
PENDIK,CAMCESME MAH.,409,349,340,259,81
PENDIK,CAMCESME MAH.,415,367,361,277,84
PENDIK,CAMCESME MAH.,408,330,326,249,77
PENDIK,CAMCESME MAH.,415,364,359,273,86
PENDIK,CAMCESME MAH.,410,368,364,270,94
PENDIK,CAMCESME MAH.,409,375,369,277,92
PENDIK,CAMCESME MAH.,409,367,361,281,80
PENDIK,CAMCESME MAH.,409,372,366,271,95
PENDIK,CAMCESME MAH.,415,384,378,271,107
PENDIK,CAMCESME MAH.,410,358,352,244,108
PENDIK,CAMCESME MAH.,410,364,361,277,84
PENDIK,CAMCESME MAH.,410,359,349,268,81
PENDIK,CAMCESME MAH.,410,373,369,288,81
PENDIK,CAMCESME MAH.,409,367,366,286,80
PENDIK,CAMCESME MAH.,409,375,372,296,76
PENDIK,CAMCESME MAH.,410,361,358,281,77
PENDIK,CAMCESME MAH.,415,378,368,310,58
PENDIK,CAMCESME MAH.,410,376,372,263,109
PENDIK,CAMCESME MAH.,410,379,372,261,111
PENDIK,CAMCESME MAH.,410,369,367,285,82
PENDIK,CAMCESME MAH.,408,364,357,264,93
PENDIK,CAMCESME MAH.,410,366,359,277,82
PENDIK,CAMCESME MAH.,409,376,373,278,95
PENDIK,CAMCESME MAH.,409,363,362,283,79
PENDIK,CAMCESME MAH.,410,375,372,279,93
PENDIK,CAMCESME MAH.,409,348,343,266,77
PENDIK,CAMCESME MAH.,409,378,375,265,110
PENDIK,ESENLER MAH.,410,357,351,250,101
PENDIK,ESENLER MAH.,408,356,350,216,134
PENDIK,ESENLER MAH.,408,366,361,250,111
PENDIK,ESENLER MAH.,409,371,360,241,119
PENDIK,ESENLER MAH.,409,367,365,244,121
PENDIK,ESENLER MAH.,408,354,349,224,125
PENDIK,ESENLER MAH.,409,388,384,268,116
PENDIK,ESENLER MAH.,408,375,370,239,131
PENDIK,ESENLER MAH.,408,370,363,258,105
PENDIK,ESENLER MAH.,415,386,380,248,132
PENDIK,ESENLER MAH.,409,372,371,270,101
PENDIK,ESENLER MAH.,409,355,350,232,118
PENDIK,ESENLER MAH.,408,373,367,224,143
PENDIK,ESENLER MAH.,407,356,350,207,143
PENDIK,ESENLER MAH.,409,371,368,235,133
PENDIK,ESENLER MAH.,408,383,382,267,115
PENDIK,ESENLER MAH.,408,376,369,234,135
PENDIK,ESENLER MAH.,408,368,363,240,123
PENDIK,ESENLER MAH.,408,363,359,238,121
PENDIK,ESENLER MAH.,407,361,358,252,106
PENDIK,ESENLER MAH.,408,361,356,231,125
PENDIK,ESENLER MAH.,408,372,366,253,113
PENDIK,ESENLER MAH.,407,374,361,219,142
PENDIK,ESENLER MAH.,407,355,352,249,103
PENDIK,ESENLER MAH.,408,380,374,262,112
PENDIK,ESENLER MAH.,408,367,365,250,115
PENDIK,ESENLER MAH.,408,368,361,259,102
PENDIK,ESENLER MAH.,407,367,364,258,106
PENDIK,ESENLER MAH.,408,373,368,220,148
PENDIK,ESENLER MAH.,408,361,358,235,123
PENDIK,ESENLER MAH.,408,369,365,228,137
PENDIK,ESENLER MAH.,401,355,349,259,90
PENDIK,ESENLER MAH.,401,351,344,242,102
PENDIK,ESENLER MAH.,401,363,357,241,116
PENDIK,ESENLER MAH.,400,370,368,278,90
PENDIK,ESENLER MAH.,402,363,354,275,79
PENDIK,ESENLER MAH.,404,389,384,291,93
PENDIK,ESENLER MAH.,401,373,370,260,110
PENDIK,ESENLER MAH.,400,366,363,272,91
PENDIK,ESENLER MAH.,402,358,352,230,122
PENDIK,ESENLER MAH.,400,357,355,248,107
PENDIK,ESENLER MAH.,400,349,342,268,74
PENDIK,ESENLER MAH.,400,361,355,251,104
PENDIK,ESENLER MAH.,400,357,352,249,103
PENDIK,ESENLER MAH.,403,363,360,256,104
PENDIK,ESENLER MAH.,401,370,368,263,105
PENDIK,ESENLER MAH.,399,357,352,269,83
PENDIK,ESENLER MAH.,399,365,357,263,94
PENDIK,ESENLER MAH.,401,374,370,281,89
PENDIK,ESENLER MAH.,399,351,342,246,96
PENDIK,ESENLER MAH.,400,353,346,264,82
PENDIK,ESENLER MAH.,401,371,367,274,93
PENDIK,ESENLER MAH.,401,364,359,254,105
PENDIK,ESENYALI MAH.,399,352,341,205,136
PENDIK,ESENYALI MAH.,399,350,342,227,115
PENDIK,ESENYALI MAH.,399,358,354,242,112
PENDIK,ESENYALI MAH.,399,335,334,206,128
PENDIK,ESENYALI MAH.,399,366,358,236,122
PENDIK,ESENYALI MAH.,401,352,349,249,100
PENDIK,ESENYALI MAH.,400,355,352,250,102
PENDIK,ESENYALI MAH.,402,357,352,236,116
PENDIK,ESENYALI MAH.,399,357,351,250,101
PENDIK,ESENYALI MAH.,399,346,344,245,99
PENDIK,ESENYALI MAH.,399,362,355,261,94
PENDIK,ESENYALI MAH.,399,351,340,232,108
PENDIK,ESENYALI MAH.,399,357,350,276,74
PENDIK,ESENYALI MAH.,399,362,357,243,114
PENDIK,ESENYALI MAH.,399,352,347,249,98
PENDIK,ESENYALI MAH.,398,351,347,233,114
PENDIK,ESENYALI MAH.,398,356,354,248,106
PENDIK,ESENYALI MAH.,399,363,354,251,103
PENDIK,ESENYALI MAH.,398,359,354,234,120
PENDIK,ESENYALI MAH.,400,357,352,251,101
PENDIK,ESENYALI MAH.,399,338,332,232,100
PENDIK,ESENYALI MAH.,399,355,349,247,102
PENDIK,ESENYALI MAH.,399,357,354,233,121
PENDIK,ESENYALI MAH.,399,354,347,238,109
PENDIK,FATIH MAH.,404,360,352,203,149
PENDIK,FATIH MAH.,404,353,346,209,137
PENDIK,FATIH MAH.,405,345,342,210,132
PENDIK,FATIH MAH.,404,339,337,232,105
PENDIK,FATIH MAH.,406,365,360,230,130
PENDIK,FATIH MAH.,405,369,369,225,144
PENDIK,FATIH MAH.,404,368,365,204,161
PENDIK,FATIH MAH.,406,364,358,245,113
PENDIK,FATIH MAH.,404,362,356,200,156
PENDIK,FATIH MAH.,404,360,351,208,143
PENDIK,FATIH MAH.,405,356,351,228,123
PENDIK,FATIH MAH.,405,348,347,204,143
PENDIK,FATIH MAH.,404,352,347,214,133
PENDIK,FATIH MAH.,403,352,347,205,142
PENDIK,FATIH MAH.,404,342,339,202,137
PENDIK,FATIH MAH.,403,351,344,226,118
PENDIK,FATIH MAH.,405,368,365,254,111
PENDIK,FATIH MAH.,404,358,354,219,135
PENDIK,FATIH MAH.,402,331,325,212,113
PENDIK,FATIH MAH.,402,347,340,196,144
PENDIK,FATIH MAH.,403,338,336,210,126
PENDIK,FATIH MAH.,402,352,348,250,98
PENDIK,FATIH MAH.,406,354,348,250,98
PENDIK,FATIH MAH.,402,339,338,220,118
PENDIK,FATIH MAH.,402,354,351,217,134
PENDIK,FATIH MAH.,403,340,338,218,120
PENDIK,FATIH MAH.,403,353,349,248,101
PENDIK,FATIH MAH.,403,359,358,241,117
PENDIK,FATIH MAH.,402,347,345,222,123
PENDIK,FATIH MAH.,402,361,359,242,117
PENDIK,FATIH MAH.,403,340,335,203,132
PENDIK,FATIH MAH.,403,336,331,226,105
PENDIK,FATIH MAH.,407,364,361,249,112
PENDIK,FATIH MAH.,403,355,349,202,147
PENDIK,FATIH MAH.,403,347,343,207,136
PENDIK,FATIH MAH.,402,357,351,241,110
PENDIK,GUZELYALI MAH.,380,333,325,196,129
PENDIK,GUZELYALI MAH.,379,333,331,213,118
PENDIK,GUZELYALI MAH.,382,341,339,183,156
PENDIK,GUZELYALI MAH.,378,346,345,195,150
PENDIK,GUZELYALI MAH.,378,350,350,213,137
PENDIK,GUZELYALI MAH.,378,339,330,193,137
PENDIK,GUZELYALI MAH.,378,346,345,202,143
PENDIK,GUZELYALI MAH.,379,342,338,211,127
PENDIK,GUZELYALI MAH.,378,334,332,217,115
PENDIK,GUZELYALI MAH.,378,350,347,217,130
PENDIK,GUZELYALI MAH.,407,346,338,209,129
PENDIK,GUZELYALI MAH.,408,350,344,215,129
PENDIK,GUZELYALI MAH.,408,370,362,230,132
PENDIK,GUZELYALI MAH.,406,379,375,233,142
PENDIK,GUZELYALI MAH.,407,365,360,222,138
PENDIK,GUZELYALI MAH.,407,357,347,209,138
PENDIK,GUZELYALI MAH.,408,373,368,231,137
PENDIK,GUZELYALI MAH.,406,362,361,221,140
PENDIK,GUZELYALI MAH.,415,367,365,217,148
PENDIK,GUZELYALI MAH.,408,364,359,231,128
PENDIK,GUZELYALI MAH.,406,364,359,209,150
PENDIK,GUZELYALI MAH.,406,355,351,223,128
PENDIK,GUZELYALI MAH.,406,355,347,219,128
PENDIK,GUZELYALI MAH.,408,378,374,227,147
PENDIK,GUZELYALI MAH.,408,367,365,208,157
PENDIK,GUZELYALI MAH.,407,372,364,212,152
PENDIK,GUZELYALI MAH.,408,364,360,232,128
PENDIK,GUZELYALI MAH.,407,365,362,221,141
PENDIK,GUZELYALI MAH.,408,376,370,233,137
PENDIK,GUZELYALI MAH.,407,362,355,234,121
PENDIK,GUZELYALI MAH.,395,331,324,137,187
PENDIK,GUZELYALI MAH.,395,356,353,188,165
PENDIK,GUZELYALI MAH.,395,354,349,201,148
PENDIK,GUZELYALI MAH.,395,363,358,198,160
PENDIK,GUZELYALI MAH.,395,352,352,171,181
PENDIK,GUZELYALI MAH.,394,355,351,177,174
PENDIK,GUZELYALI MAH.,396,366,360,157,203
PENDIK,GUZELYALI MAH.,394,347,340,143,197
PENDIK,GUZELYALI MAH.,395,360,357,185,172
PENDIK,GUZELYALI MAH.,395,367,359,157,202
PENDIK,GUZELYALI MAH.,397,361,357,200,157
PENDIK,GUZELYALI MAH.,394,366,361,187,174
PENDIK,GUZELYALI MAH.,394,355,352,178,174
PENDIK,GUZELYALI MAH.,395,375,370,201,169
PENDIK,GUZELYALI MAH.,399,337,336,224,112
PENDIK,GUZELYALI MAH.,400,341,339,177,162
PENDIK,GUZELYALI MAH.,403,359,349,207,142
PENDIK,GUZELYALI MAH.,399,371,366,220,146
PENDIK,GUZELYALI MAH.,399,349,345,193,152
PENDIK,GUZELYALI MAH.,399,337,333,203,130
PENDIK,GUZELYALI MAH.,399,354,349,188,161
PENDIK,GUZELYALI MAH.,400,346,342,183,159
PENDIK,GUZELYALI MAH.,399,345,341,212,129
PENDIK,GUZELYALI MAH.,401,353,346,187,159
PENDIK,GUZELYALI MAH.,399,332,328,179,149
PENDIK,GUZELYALI MAH.,399,365,354,207,147
PENDIK,GUZELYALI MAH.,399,362,359,229,130
PENDIK,GUZELYALI MAH.,400,356,354,215,139
PENDIK,GUZELYALI MAH.,399,352,351,213,138
PENDIK,GUZELYALI MAH.,399,337,333,201,132
PENDIK,KAVAKPINAR MAH.,403,349,338,193,145
PENDIK,KAVAKPINAR MAH.,406,358,351,247,104
PENDIK,KAVAKPINAR MAH.,405,368,367,226,141
PENDIK,KAVAKPINAR MAH.,403,377,371,235,136
PENDIK,KAVAKPINAR MAH.,403,369,366,229,137
PENDIK,KAVAKPINAR MAH.,406,384,382,269,113
PENDIK,KAVAKPINAR MAH.,404,373,365,255,110
PENDIK,KAVAKPINAR MAH.,404,380,378,252,126
PENDIK,KAVAKPINAR MAH.,403,366,363,215,148
PENDIK,KAVAKPINAR MAH.,404,357,351,238,113
PENDIK,KAVAKPINAR MAH.,404,365,363,263,100
PENDIK,KAVAKPINAR MAH.,403,373,366,246,120
PENDIK,KAVAKPINAR MAH.,405,356,350,240,110
PENDIK,KAVAKPINAR MAH.,406,360,356,218,138
PENDIK,KAVAKPINAR MAH.,403,354,350,251,99
PENDIK,KAVAKPINAR MAH.,404,366,358,229,129
PENDIK,KAVAKPINAR MAH.,404,363,350,240,110
PENDIK,KAVAKPINAR MAH.,407,365,361,232,129
PENDIK,KAVAKPINAR MAH.,404,362,359,240,119
PENDIK,KAVAKPINAR MAH.,404,355,353,220,133
PENDIK,KAVAKPINAR MAH.,414,357,352,211,141
PENDIK,KAVAKPINAR MAH.,415,351,346,177,169
PENDIK,KAVAKPINAR MAH.,415,349,344,211,133
PENDIK,KAVAKPINAR MAH.,415,378,374,200,174
PENDIK,KAVAKPINAR MAH.,414,379,372,226,146
PENDIK,KAVAKPINAR MAH.,415,371,359,228,131
PENDIK,KAVAKPINAR MAH.,414,365,359,237,122
PENDIK,KAVAKPINAR MAH.,415,373,370,253,117
PENDIK,KAVAKPINAR MAH.,415,383,377,237,140
PENDIK,KAVAKPINAR MAH.,414,363,358,238,120
PENDIK,KAVAKPINAR MAH.,414,351,336,205,131
PENDIK,KAVAKPINAR MAH.,415,365,362,222,140
PENDIK,KAVAKPINAR MAH.,415,378,374,246,128
PENDIK,KAVAKPINAR MAH.,413,359,358,217,141
PENDIK,KAVAKPINAR MAH.,415,380,378,241,137
PENDIK,KAVAKPINAR MAH.,414,372,359,207,152
PENDIK,KAVAKPINAR MAH.,414,372,366,236,130
PENDIK,KAVAKPINAR MAH.,414,372,366,233,133
PENDIK,KAVAKPINAR MAH.,414,352,348,227,121
PENDIK,KAVAKPINAR MAH.,415,380,375,223,152
PENDIK,KAVAKPINAR MAH.,413,382,375,245,130
PENDIK,KAVAKPINAR MAH.,415,357,352,217,135
PENDIK,KAVAKPINAR MAH.,415,379,373,253,120
PENDIK,KAVAKPINAR MAH.,415,376,370,240,130
PENDIK,KAVAKPINAR MAH.,415,374,371,226,145
PENDIK,KAVAKPINAR MAH.,414,374,369,231,138
PENDIK,KAVAKPINAR MAH.,414,365,354,199,155
PENDIK,KAVAKPINAR MAH.,414,365,351,227,124
PENDIK,KAVAKPINAR MAH.,414,374,368,218,150
PENDIK,KAVAKPINAR MAH.,414,369,362,218,144
PENDIK,KAVAKPINAR MAH.,415,349,341,193,148
PENDIK,KAVAKPINAR MAH.,415,362,356,215,141
PENDIK,KAVAKPINAR MAH.,408,373,366,200,166
PENDIK,KAVAKPINAR MAH.,415,369,363,214,149
PENDIK,KAVAKPINAR MAH.,415,368,364,221,143
PENDIK,KAVAKPINAR MAH.,415,370,367,229,138
PENDIK,KAVAKPINAR MAH.,412,377,373,244,129
PENDIK,KAVAKPINAR MAH.,415,375,371,232,139
PENDIK,KAVAKPINAR MAH.,415,376,367,209,158
PENDIK,KAVAKPINAR MAH.,415,373,364,239,125
PENDIK,KAVAKPINAR MAH.,414,362,359,221,138
PENDIK,KAVAKPINAR MAH.,415,383,377,228,149
PENDIK,KAVAKPINAR MAH.,413,377,370,210,160
PENDIK,KAVAKPINAR MAH.,412,374,362,223,139
PENDIK,KAVAKPINAR MAH.,414,384,378,263,115
PENDIK,KAVAKPINAR MAH.,414,380,374,237,137
PENDIK,KAVAKPINAR MAH.,414,373,368,204,164
PENDIK,KAVAKPINAR MAH.,410,358,354,189,165
PENDIK,KAVAKPINAR MAH.,411,370,361,198,163
PENDIK,KAVAKPINAR MAH.,414,382,374,234,140
PENDIK,KAVAKPINAR MAH.,412,364,360,182,178
PENDIK,KAVAKPINAR MAH.,414,372,369,225,144
PENDIK,KAVAKPINAR MAH.,413,352,352,209,143
PENDIK,KAVAKPINAR MAH.,414,381,378,234,144
PENDIK,KAVAKPINAR MAH.,410,375,366,246,120
PENDIK,KAVAKPINAR MAH.,415,366,357,253,104
PENDIK,KAVAKPINAR MAH.,415,361,354,198,156
PENDIK,KAVAKPINAR MAH.,415,379,375,236,139
PENDIK,KAVAKPINAR MAH.,415,364,359,184,175
PENDIK,KAVAKPINAR MAH.,415,384,380,234,146
PENDIK,KAVAKPINAR MAH.,415,370,362,249,113
PENDIK,KAVAKPINAR MAH.,415,374,364,226,138
PENDIK,KAVAKPINAR MAH.,415,373,369,230,139
PENDIK,KAVAKPINAR MAH.,415,391,386,252,134
PENDIK,KAVAKPINAR MAH.,412,362,346,226,120
PENDIK,KAVAKPINAR MAH.,412,381,376,234,142
PENDIK,KAVAKPINAR MAH.,412,362,356,233,123
PENDIK,KAVAKPINAR MAH.,415,378,373,217,156
PENDIK,KAVAKPINAR MAH.,415,358,349,219,130
PENDIK,KAVAKPINAR MAH.,415,375,365,235,130
PENDIK,KAVAKPINAR MAH.,413,380,375,218,157
PENDIK,KAVAKPINAR MAH.,412,384,382,246,136
PENDIK,KAVAKPINAR MAH.,411,392,385,240,145
PENDIK,KAVAKPINAR MAH.,413,381,373,234,139
PENDIK,KAVAKPINAR MAH.,412,376,372,243,129
PENDIK,KAVAKPINAR MAH.,413,378,374,239,135
PENDIK,KAVAKPINAR MAH.,412,380,373,226,147
PENDIK,KAVAKPINAR MAH.,411,361,349,199,150
PENDIK,ORHANGAZI MAH.,407,352,337,227,110
PENDIK,ORHANGAZI MAH.,404,346,337,223,114
PENDIK,ORHANGAZI MAH.,405,360,350,248,102
PENDIK,ORHANGAZI MAH.,404,371,363,253,110
PENDIK,ORHANGAZI MAH.,403,359,350,219,131
PENDIK,ORHANGAZI MAH.,403,371,366,238,128
PENDIK,ORHANGAZI MAH.,404,363,360,248,112
PENDIK,ORHANGAZI MAH.,405,355,350,228,122
PENDIK,ORHANGAZI MAH.,407,365,362,269,93
PENDIK,ORHANGAZI MAH.,405,357,350,260,90
PENDIK,ORHANGAZI MAH.,406,377,375,305,70
PENDIK,ORHANGAZI MAH.,403,371,368,269,99
PENDIK,ORHANGAZI MAH.,404,351,347,237,110
PENDIK,ORHANGAZI MAH.,405,342,337,232,105
PENDIK,ORHANGAZI MAH.,403,364,358,255,103
PENDIK,ORHANGAZI MAH.,404,369,364,272,92
PENDIK,ORHANGAZI MAH.,404,367,362,248,114
PENDIK,ORHANGAZI MAH.,405,362,357,250,107
PENDIK,ORHANGAZI MAH.,404,367,364,243,121
PENDIK,ORHANGAZI MAH.,404,357,350,212,138
PENDIK,ORHANGAZI MAH.,405,353,350,231,119
PENDIK,ORHANGAZI MAH.,405,359,353,232,121
PENDIK,ORHANGAZI MAH.,407,360,355,240,115
PENDIK,ORHANGAZI MAH.,404,368,367,256,111
PENDIK,ORHANGAZI MAH.,403,364,360,264,96
PENDIK,ORHANGAZI MAH.,404,362,359,257,102
PENDIK,ORHANGAZI MAH.,403,336,329,236,93
PENDIK,ORHANGAZI MAH.,404,369,359,239,120
PENDIK,ORHANGAZI MAH.,404,355,350,267,83
PENDIK,ORHANGAZI MAH.,404,362,359,262,97
PENDIK,ORHANGAZI MAH.,415,356,351,215,136
PENDIK,ORHANGAZI MAH.,414,381,377,267,110
PENDIK,ORHANGAZI MAH.,415,379,374,230,144
PENDIK,ORHANGAZI MAH.,417,381,377,243,134
PENDIK,ORHANGAZI MAH.,416,379,373,269,104
PENDIK,ORHANGAZI MAH.,415,367,360,235,125
PENDIK,ORHANGAZI MAH.,414,361,354,242,112
PENDIK,ORHANGAZI MAH.,416,377,368,214,154
PENDIK,ORHANGAZI MAH.,417,371,363,226,137
PENDIK,ORHANGAZI MAH.,416,368,365,252,113
PENDIK,ORHANGAZI MAH.,416,368,363,254,109
PENDIK,ORHANGAZI MAH.,415,361,355,229,126
PENDIK,ORHANGAZI MAH.,415,365,360,240,120
PENDIK,ORHANGAZI MAH.,415,375,371,255,116
PENDIK,ORHANGAZI MAH.,414,374,365,231,134
PENDIK,ORHANGAZI MAH.,415,367,364,232,132
PENDIK,ORHANGAZI MAH.,415,366,360,235,125
PENDIK,BALLICA MAH.,325,301,298,187,111
PENDIK,CAMLIK MAH.,383,342,336,209,127
PENDIK,CAMLIK MAH.,383,352,349,187,162
PENDIK,CAMLIK MAH.,383,340,334,191,143
PENDIK,CAMLIK MAH.,385,359,355,189,166
PENDIK,CAMLIK MAH.,383,333,330,182,148
PENDIK,CAMLIK MAH.,385,347,344,151,193
PENDIK,CAMLIK MAH.,383,352,349,193,156
PENDIK,CAMLIK MAH.,384,355,351,202,149
PENDIK,CAMLIK MAH.,383,348,340,160,180
PENDIK,CAMLIK MAH.,382,346,343,169,174
PENDIK,CAMLIK MAH.,382,347,341,166,175
PENDIK,CAMLIK MAH.,382,355,351,173,178
PENDIK,CAMLIK MAH.,406,358,356,198,158
PENDIK,CAMLIK MAH.,406,365,357,174,183
PENDIK,CAMLIK MAH.,405,356,345,171,174
PENDIK,CAMLIK MAH.,405,360,347,184,163
PENDIK,CAMLIK MAH.,405,368,365,187,178
PENDIK,CAMLIK MAH.,406,359,356,211,145
PENDIK,CAMLIK MAH.,405,358,353,186,167
PENDIK,CAMLIK MAH.,405,366,358,187,171
PENDIK,CAMLIK MAH.,406,357,353,221,132
PENDIK,CAMLIK MAH.,404,364,360,197,163
PENDIK,CAMLIK MAH.,408,360,357,200,157
PENDIK,CAMLIK MAH.,406,369,367,201,166
PENDIK,EMIRLI MAH.,195,172,170,104,66
PENDIK,ERTUGRUL GAZI MAH.,391,335,324,177,147
PENDIK,ERTUGRUL GAZI MAH.,392,347,340,203,137
PENDIK,ERTUGRUL GAZI MAH.,390,356,353,200,153
PENDIK,ERTUGRUL GAZI MAH.,390,343,336,176,160
PENDIK,ERTUGRUL GAZI MAH.,392,344,333,182,151
PENDIK,ERTUGRUL GAZI MAH.,390,340,330,203,127
PENDIK,ERTUGRUL GAZI MAH.,389,347,335,204,131
PENDIK,ERTUGRUL GAZI MAH.,389,333,325,193,132
PENDIK,ERTUGRUL GAZI MAH.,390,343,341,223,118
PENDIK,ERTUGRUL GAZI MAH.,390,346,340,188,152
PENDIK,ERTUGRUL GAZI MAH.,390,346,342,237,105
PENDIK,ERTUGRUL GAZI MAH.,402,349,341,187,154
PENDIK,ERTUGRUL GAZI MAH.,404,339,326,192,134
PENDIK,ERTUGRUL GAZI MAH.,403,352,341,199,142
PENDIK,ERTUGRUL GAZI MAH.,403,346,337,204,133
PENDIK,ERTUGRUL GAZI MAH.,403,356,351,187,164
PENDIK,ERTUGRUL GAZI MAH.,403,350,345,225,120
PENDIK,ERTUGRUL GAZI MAH.,406,367,357,216,141
PENDIK,ERTUGRUL GAZI MAH.,402,358,350,186,164
PENDIK,ERTUGRUL GAZI MAH.,403,356,350,223,127
PENDIK,ERTUGRUL GAZI MAH.,402,379,368,247,121
PENDIK,ERTUGRUL GAZI MAH.,403,360,351,213,138
PENDIK,ERTUGRUL GAZI MAH.,402,352,347,158,189
PENDIK,ERTUGRUL GAZI MAH.,405,354,349,174,175
PENDIK,ERTUGRUL GAZI MAH.,402,350,345,185,160
PENDIK,ERTUGRUL GAZI MAH.,402,368,358,198,160
PENDIK,ERTUGRUL GAZI MAH.,401,354,350,204,146
PENDIK,GOCBEYLI MAH.,369,334,333,285,48
PENDIK,GOCBEYLI MAH.,369,336,332,287,45
PENDIK,GULLU BAGLAR MAH.,415,359,347,236,111
PENDIK,GULLU BAGLAR MAH.,415,388,381,259,122
PENDIK,GULLU BAGLAR MAH.,414,383,379,257,122
PENDIK,GULLU BAGLAR MAH.,416,384,380,268,112
PENDIK,GULLU BAGLAR MAH.,415,377,373,273,100
PENDIK,GULLU BAGLAR MAH.,413,382,374,264,110
PENDIK,GULLU BAGLAR MAH.,416,385,375,263,112
PENDIK,GULLU BAGLAR MAH.,413,369,362,242,120
PENDIK,GULLU BAGLAR MAH.,415,384,378,283,95
PENDIK,GULLU BAGLAR MAH.,416,387,380,246,134
PENDIK,GULLU BAGLAR MAH.,413,388,383,253,130
PENDIK,GULLU BAGLAR MAH.,413,389,382,249,133
PENDIK,GULLU BAGLAR MAH.,413,389,383,279,104
PENDIK,GULLU BAGLAR MAH.,415,364,360,222,138
PENDIK,GULLU BAGLAR MAH.,411,375,363,231,132
PENDIK,GULLU BAGLAR MAH.,412,372,363,242,121
PENDIK,GULLU BAGLAR MAH.,415,380,373,231,142
PENDIK,GULLU BAGLAR MAH.,411,370,366,245,121
PENDIK,GULLU BAGLAR MAH.,411,362,358,224,134
PENDIK,GULLU BAGLAR MAH.,415,382,378,238,140
PENDIK,GULLU BAGLAR MAH.,410,378,373,221,152
PENDIK,GULLU BAGLAR MAH.,412,372,364,235,129
PENDIK,GULLU BAGLAR MAH.,410,371,370,231,139
PENDIK,HARMANDERE MAH.,410,351,348,136,212
PENDIK,HARMANDERE MAH.,408,374,369,156,213
PENDIK,HARMANDERE MAH.,407,374,374,147,227
PENDIK,HARMANDERE MAH.,413,349,349,138,211
PENDIK,HARMANDERE MAH.,408,356,349,145,204
PENDIK,HARMANDERE MAH.,407,368,366,148,218
PENDIK,HARMANDERE MAH.,407,367,359,138,221
PENDIK,HARMANDERE MAH.,408,364,358,168,190
PENDIK,HARMANDERE MAH.,407,366,362,137,225
PENDIK,HARMANDERE MAH.,408,366,362,171,191
PENDIK,HARMANDERE MAH.,407,365,359,145,214
PENDIK,HARMANDERE MAH.,407,371,370,149,221
PENDIK,HARMANDERE MAH.,408,359,351,144,207
PENDIK,KURNA MAH.,298,262,251,155,96
PENDIK,KURNA MAH.,297,260,254,175,79
PENDIK,KURNA MAH.,297,282,279,143,136
PENDIK,KURTDOGMUS MAH.,346,314,309,161,148
PENDIK,KURTKOY MAH.,393,325,313,180,133
PENDIK,KURTKOY MAH.,392,344,341,192,149
PENDIK,KURTKOY MAH.,393,336,334,186,148
PENDIK,KURTKOY MAH.,394,344,340,214,126
PENDIK,KURTKOY MAH.,392,344,337,204,133
PENDIK,KURTKOY MAH.,393,334,327,196,131
PENDIK,KURTKOY MAH.,393,344,341,195,146
PENDIK,KURTKOY MAH.,391,335,327,215,112
PENDIK,KURTKOY MAH.,392,351,348,215,133
PENDIK,KURTKOY MAH.,391,366,361,204,157
PENDIK,KURTKOY MAH.,392,332,326,183,143
PENDIK,KURTKOY MAH.,392,345,335,194,141
PENDIK,KURTKOY MAH.,411,348,341,205,136
PENDIK,KURTKOY MAH.,411,371,366,210,156
PENDIK,KURTKOY MAH.,411,355,349,166,183
PENDIK,KURTKOY MAH.,411,375,368,209,159
PENDIK,KURTKOY MAH.,410,353,349,167,182
PENDIK,KURTKOY MAH.,410,368,361,203,158
PENDIK,KURTKOY MAH.,411,368,364,207,157
PENDIK,KURTKOY MAH.,410,370,366,224,142
PENDIK,KURTKOY MAH.,410,378,373,167,206
PENDIK,KURTKOY MAH.,411,368,362,199,163
PENDIK,KURTKOY MAH.,410,367,364,194,170
PENDIK,KURTKOY MAH.,410,364,363,179,184
PENDIK,KURTKOY MAH.,411,359,355,183,172
PENDIK,KURTKOY MAH.,411,362,358,214,144
PENDIK,KURTKOY MAH.,411,354,349,191,158
PENDIK,KURTKOY MAH.,411,365,357,208,149
PENDIK,KURTKOY MAH.,410,369,367,208,159
PENDIK,KURTKOY MAH.,410,369,364,202,162
PENDIK,KURTKOY MAH.,406,337,335,186,149
PENDIK,KURTKOY MAH.,405,346,337,216,121
PENDIK,KURTKOY MAH.,405,377,366,243,123
PENDIK,KURTKOY MAH.,405,358,356,233,123
PENDIK,KURTKOY MAH.,406,359,356,233,123
PENDIK,KURTKOY MAH.,405,357,350,216,134
PENDIK,KURTKOY MAH.,406,364,356,225,131
PENDIK,KURTKOY MAH.,409,365,358,224,134
PENDIK,KURTKOY MAH.,406,350,339,217,122
PENDIK,KURTKOY MAH.,404,369,361,205,156
PENDIK,KURTKOY MAH.,405,369,363,198,165
PENDIK,KURTKOY MAH.,405,361,358,230,128
PENDIK,KURTKOY MAH.,405,364,362,207,155
PENDIK,KURTKOY MAH.,405,364,360,236,124
PENDIK,KURTKOY MAH.,406,356,356,229,127
PENDIK,KURTKOY MAH.,406,360,351,207,144
PENDIK,KURTKOY MAH.,406,369,362,237,125
PENDIK,KURTKOY MAH.,405,370,365,234,131
PENDIK,KURTKOY MAH.,405,342,338,197,141
PENDIK,KURTKOY MAH.,405,360,356,220,136
PENDIK,KURTKOY MAH.,406,353,347,205,142
PENDIK,RAMAZANOGLU MAH.,359,322,315,151,164
PENDIK,RAMAZANOGLU MAH.,358,321,316,164,152
PENDIK,RAMAZANOGLU MAH.,357,328,320,155,165
PENDIK,RAMAZANOGLU MAH.,357,334,325,167,158
PENDIK,RAMAZANOGLU MAH.,360,308,303,147,156
PENDIK,RAMAZANOGLU MAH.,357,323,318,170,148
PENDIK,SANAYI MAH.,396,362,352,200,152
PENDIK,SANAYI MAH.,396,343,336,189,147
PENDIK,SANAYI MAH.,395,351,344,191,153
PENDIK,SANAYI MAH.,395,364,359,211,148
PENDIK,SANAYI MAH.,395,354,350,190,160
PENDIK,SANAYI MAH.,398,359,353,190,163
PENDIK,SULUNTEPE MAH.,408,367,364,202,162
PENDIK,SULUNTEPE MAH.,408,352,348,188,160
PENDIK,SULUNTEPE MAH.,407,363,355,204,151
PENDIK,SULUNTEPE MAH.,409,363,361,218,143
PENDIK,SULUNTEPE MAH.,407,366,362,207,155
PENDIK,SULUNTEPE MAH.,407,365,361,201,160
PENDIK,SULUNTEPE MAH.,407,358,354,205,149
PENDIK,SULUNTEPE MAH.,407,363,360,186,174
PENDIK,SULUNTEPE MAH.,408,373,371,195,176
PENDIK,SULUNTEPE MAH.,408,364,358,240,118
PENDIK,SULUNTEPE MAH.,406,363,354,179,175
PENDIK,SULUNTEPE MAH.,407,363,355,164,191
PENDIK,SULUNTEPE MAH.,407,357,350,208,142
PENDIK,SULUNTEPE MAH.,406,361,356,184,172
PENDIK,SULUNTEPE MAH.,406,355,345,190,155
PENDIK,SULUNTEPE MAH.,406,354,348,189,159
PENDIK,SULUNTEPE MAH.,407,360,353,201,152
PENDIK,SULUNTEPE MAH.,407,356,350,198,152
PENDIK,SULUNTEPE MAH.,407,356,353,196,157
PENDIK,SULUNTEPE MAH.,406,359,354,195,159
PENDIK,SULUNTEPE MAH.,415,365,360,184,176
PENDIK,SULUNTEPE MAH.,415,354,343,146,197
PENDIK,SULUNTEPE MAH.,415,368,365,179,186
PENDIK,SULUNTEPE MAH.,415,358,352,172,180
PENDIK,SULUNTEPE MAH.,415,363,350,159,191
PENDIK,SULUNTEPE MAH.,415,367,353,160,193
PENDIK,SULUNTEPE MAH.,414,369,362,157,205
PENDIK,SULUNTEPE MAH.,414,374,364,188,176
PENDIK,SULUNTEPE MAH.,414,368,361,169,192
PENDIK,SULUNTEPE MAH.,415,370,364,176,188
PENDIK,SULUNTEPE MAH.,415,379,370,175,195
PENDIK,SULUNTEPE MAH.,415,380,373,197,176
PENDIK,SULUNTEPE MAH.,414,373,367,170,197
PENDIK,SULUNTEPE MAH.,415,350,342,163,179
PENDIK,SULUNTEPE MAH.,415,365,363,180,183
PENDIK,SULUNTEPE MAH.,415,367,359,169,190
PENDIK,SULUNTEPE MAH.,415,379,373,172,201
PENDIK,SULUNTEPE MAH.,414,383,381,171,210
PENDIK,SULUNTEPE MAH.,414,380,365,179,186
PENDIK,SULUNTEPE MAH.,414,373,368,183,185
PENDIK,SEYHLI MAH.,403,338,330,222,108
PENDIK,SEYHLI MAH.,402,353,346,202,144
PENDIK,SEYHLI MAH.,402,341,336,212,124
PENDIK,SEYHLI MAH.,401,368,362,240,122
PENDIK,SEYHLI MAH.,402,370,362,230,132
PENDIK,SEYHLI MAH.,401,372,367,227,140
PENDIK,SEYHLI MAH.,402,364,357,222,135
PENDIK,SEYHLI MAH.,401,350,342,232,110
PENDIK,SEYHLI MAH.,402,360,352,236,116
PENDIK,SEYHLI MAH.,401,369,364,244,120
PENDIK,SEYHLI MAH.,402,352,346,209,137
PENDIK,SEYHLI MAH.,401,357,350,227,123
PENDIK,SEYHLI MAH.,402,365,356,238,118
PENDIK,SEYHLI MAH.,402,365,363,238,125
PENDIK,SEYHLI MAH.,401,357,348,197,151
PENDIK,SEYHLI MAH.,402,363,360,223,137
PENDIK,SEYHLI MAH.,402,355,347,217,130
PENDIK,SEYHLI MAH.,398,325,319,189,130
PENDIK,SEYHLI MAH.,399,358,351,207,144
PENDIK,SEYHLI MAH.,397,353,352,198,154
PENDIK,SEYHLI MAH.,398,351,342,194,148
PENDIK,SEYHLI MAH.,397,354,353,198,155
PENDIK,SEYHLI MAH.,398,355,349,194,155
PENDIK,SEYHLI MAH.,397,368,363,203,160
PENDIK,SEYHLI MAH.,398,369,368,226,142
PENDIK,SEYHLI MAH.,397,364,358,185,173
PENDIK,SEYHLI MAH.,397,370,364,229,135
PENDIK,SEYHLI MAH.,397,360,353,208,145
PENDIK,VELIBABA MAH.,410,351,342,200,142
PENDIK,VELIBABA MAH.,415,365,360,197,163
PENDIK,VELIBABA MAH.,409,373,368,212,156
PENDIK,VELIBABA MAH.,411,371,364,230,134
PENDIK,VELIBABA MAH.,411,365,360,217,143
PENDIK,VELIBABA MAH.,411,361,357,234,123
PENDIK,VELIBABA MAH.,411,371,367,210,157
PENDIK,VELIBABA MAH.,411,371,367,219,148
PENDIK,VELIBABA MAH.,411,374,369,224,145
PENDIK,VELIBABA MAH.,411,375,370,218,152
PENDIK,VELIBABA MAH.,410,370,365,247,118
PENDIK,VELIBABA MAH.,410,368,367,232,135
PENDIK,VELIBABA MAH.,408,378,372,222,150
PENDIK,VELIBABA MAH.,406,347,343,214,129
PENDIK,VELIBABA MAH.,405,373,368,226,142
PENDIK,VELIBABA MAH.,406,362,360,202,158
PENDIK,VELIBABA MAH.,406,359,354,206,148
PENDIK,VELIBABA MAH.,406,372,367,234,133
PENDIK,VELIBABA MAH.,408,367,365,217,148
PENDIK,VELIBABA MAH.,405,371,357,221,136
PENDIK,VELIBABA MAH.,405,360,357,208,149
PENDIK,VELIBABA MAH.,405,380,374,202,172
PENDIK,VELIBABA MAH.,406,359,355,221,134
PENDIK,VELIBABA MAH.,408,362,353,207,146
PENDIK,VELIBABA MAH.,405,359,354,228,126
PENDIK,VELIBABA MAH.,387,332,325,238,87
PENDIK,VELIBABA MAH.,386,334,326,239,87
PENDIK,VELIBABA MAH.,387,348,343,241,102
PENDIK,VELIBABA MAH.,386,341,340,236,104
PENDIK,VELIBABA MAH.,386,337,331,228,103
PENDIK,VELIBABA MAH.,386,349,347,230,117
PENDIK,VELIBABA MAH.,386,342,336,236,100
PENDIK,VELIBABA MAH.,386,349,343,223,120
PENDIK,VELIBABA MAH.,386,346,344,234,110
PENDIK,VELIBABA MAH.,385,359,357,235,122
PENDIK,VELIBABA MAH.,386,340,334,238,96
PENDIK,VELIBABA MAH.,385,358,357,248,109
PENDIK,VELIBABA MAH.,404,352,347,261,86
PENDIK,VELIBABA MAH.,405,370,362,262,100
PENDIK,VELIBABA MAH.,405,372,368,251,117
PENDIK,VELIBABA MAH.,404,375,368,258,110
PENDIK,VELIBABA MAH.,405,380,376,256,120
PENDIK,VELIBABA MAH.,403,377,371,281,90
PENDIK,VELIBABA MAH.,406,374,370,259,111
PENDIK,VELIBABA MAH.,405,370,365,265,100
PENDIK,VELIBABA MAH.,404,368,363,246,117
PENDIK,VELIBABA MAH.,404,370,368,281,87
PENDIK,VELIBABA MAH.,404,380,373,272,101
PENDIK,VELIBABA MAH.,404,364,359,277,82
PENDIK,VELIBABA MAH.,403,363,357,252,105
PENDIK,VELIBABA MAH.,390,337,328,222,106
PENDIK,VELIBABA MAH.,388,345,340,223,117
PENDIK,VELIBABA MAH.,389,349,343,225,118
PENDIK,VELIBABA MAH.,389,348,341,208,133
PENDIK,VELIBABA MAH.,389,362,354,251,103
PENDIK,VELIBABA MAH.,389,352,344,234,110
PENDIK,VELIBABA MAH.,390,351,347,235,112
PENDIK,VELIBABA MAH.,390,346,342,241,101
PENDIK,VELIBABA MAH.,389,345,338,229,109
PENDIK,VELIBABA MAH.,390,336,332,221,111
PENDIK,VELIBABA MAH.,393,338,333,223,110
PENDIK,YAYALAR MAH.,403,336,328,179,149
PENDIK,YAYALAR MAH.,404,334,331,185,146
PENDIK,YAYALAR MAH.,404,366,364,198,166
PENDIK,YAYALAR MAH.,405,365,358,201,157
PENDIK,YAYALAR MAH.,403,362,358,211,147
PENDIK,YAYALAR MAH.,404,370,361,197,164
PENDIK,YAYALAR MAH.,403,361,355,205,150
PENDIK,YAYALAR MAH.,404,357,347,208,139
PENDIK,YAYALAR MAH.,403,369,363,217,146
PENDIK,YAYALAR MAH.,403,371,367,185,182
PENDIK,YAYALAR MAH.,404,372,368,213,155
PENDIK,YAYALAR MAH.,403,352,348,204,144
PENDIK,YAYALAR MAH.,403,348,341,156,185
PENDIK,YAYALAR MAH.,404,365,360,174,186
PENDIK,YAYALAR MAH.,403,372,370,181,189
PENDIK,YAYALAR MAH.,403,364,357,169,188
PENDIK,YAYALAR MAH.,404,358,354,177,177
PENDIK,YAYALAR MAH.,404,363,359,204,155
PENDIK,YAYALAR MAH.,404,365,363,218,145
PENDIK,YAYALAR MAH.,404,355,353,202,151
PENDIK,YENISEHIR MAH.,418,354,349,148,201
PENDIK,YENISEHIR MAH.,415,345,342,123,219
PENDIK,YENISEHIR MAH.,415,382,380,141,239
PENDIK,YENISEHIR MAH.,415,371,367,127,240
PENDIK,YENISEHIR MAH.,418,380,374,122,252
PENDIK,YENISEHIR MAH.,418,377,371,145,226
PENDIK,YENISEHIR MAH.,415,382,380,140,240
PENDIK,YENISEHIR MAH.,415,377,376,133,243
PENDIK,YENISEHIR MAH.,415,355,353,135,218
PENDIK,YENISEHIR MAH.,415,359,357,121,236
PENDIK,YENISEHIR MAH.,414,359,359,129,230
PENDIK,YENISEHIR MAH.,414,378,362,121,241
PENDIK,YENISEHIR MAH.,414,356,352,113,239
PENDIK,YENISEHIR MAH.,414,372,365,149,216
PENDIK,YENISEHIR MAH.,414,356,348,92,256
PENDIK,YENISEHIR MAH.,415,366,361,125,236
PENDIK,YENISEHIR MAH.,414,375,370,124,246
PENDIK,YENISEHIR MAH.,415,373,369,122,247
PENDIK,YENISEHIR MAH.,414,376,372,133,239
PENDIK,YENISEHIR MAH.,415,374,368,141,227
PENDIK,YENISEHIR MAH.,415,378,372,148,224
PENDIK,YENISEHIR MAH.,415,365,361,138,223
PENDIK,YENISEHIR MAH.,415,370,365,122,243
PENDIK,YENISEHIR MAH.,413,364,364,146,218
PENDIK,YENISEHIR MAH.,414,368,363,142,221
PENDIK,YENISEHIR MAH.,415,367,363,103,260
PENDIK,YENISEHIR MAH.,413,364,361,120,241
PENDIK,YENISEHIR MAH.,414,361,354,122,232
PENDIK,YENISEHIR MAH.,415,364,360,114,246
PENDIK,YENISEHIR MAH.,415,358,356,128,228
PENDIK,YENISEHIR MAH.,415,335,330,122,208
PENDIK,YENISEHIR MAH.,415,350,342,102,240
PENDIK,YENISEHIR MAH.,415,340,336,147,189
PENDIK,YENISEHIR MAH.,411,374,372,147,225
PENDIK,YENISEHIR MAH.,415,377,373,135,238
PENDIK,YENISEHIR MAH.,411,372,370,166,204
PENDIK,YENISEHIR MAH.,412,354,352,136,216
PENDIK,YENISEHIR MAH.,415,363,357,166,191
PENDIK,YENISEHIR MAH.,415,368,359,150,209
PENDIK,YENISEHIR MAH.,411,368,361,149,212
PENDIK,YENISEHIR MAH.,410,367,363,131,232
PENDIK,YENISEHIR MAH.,415,366,360,175,185
PENDIK,YENISEHIR MAH.,411,362,360,151,209
PENDIK,YENISEHIR MAH.,415,374,371,128,243
PENDIK,YENISEHIR MAH.,412,378,372,183,189
PENDIK,YENISEHIR MAH.,411,348,346,144,202
PENDIK,YENISEHIR MAH.,411,356,352,164,188
PENDIK,YENISEHIR MAH.,412,355,353,160,193
PENDIK,YENISEHIR MAH.,412,350,347,145,202
PENDIK,YENISEHIR MAH.,412,364,358,139,219
PENDIK,YENISEHIR MAH.,412,381,380,139,241
PENDIK,YENISEHIR MAH.,411,355,350,143,207
PENDIK,YENISEHIR MAH.,412,361,356,157,199
PENDIK,YENISEHIR MAH.,412,363,358,131,227
PENDIK,YENISEHIR MAH.,410,361,359,150,209
PENDIK,YENISEHIR MAH.,411,361,356,159,197
PENDIK,YENISEHIR MAH.,411,364,358,134,224
PENDIK,YENISEHIR MAH.,412,367,360,162,198
PENDIK,YENISEHIR MAH.,412,377,369,174,195
PENDIK,YENISEHIR MAH.,411,356,351,140,211
PENDIK,YENISEHIR MAH.,411,376,371,166,205
PENDIK,YENISEHIR MAH.,411,369,365,143,222
PENDIK,YENISEHIR MAH.,411,363,359,167,192
PENDIK,YENISEHIR MAH.,411,364,364,158,206
PENDIK,YENISEHIR MAH.,411,356,354,128,226
PENDIK,YENISEHIR MAH.,410,351,348,133,215
PENDIK,YENISEHIR MAH.,411,363,359,149,210
PENDIK,YENISEHIR MAH.,411,372,366,158,208
PENDIK,YENISEHIR MAH.,405,325,322,129,193
PENDIK,YENISEHIR MAH.,408,326,320,117,203
PENDIK,YENISEHIR MAH.,405,343,337,101,236
PENDIK,YENISEHIR MAH.,404,363,360,124,236
PENDIK,YENISEHIR MAH.,405,358,356,116,240
PENDIK,YENISEHIR MAH.,407,354,343,119,224
PENDIK,YENISEHIR MAH.,405,364,359,114,245
PENDIK,YENISEHIR MAH.,405,346,341,107,234
PENDIK,YENISEHIR MAH.,405,359,356,127,229
PENDIK,YENISEHIR MAH.,405,346,340,123,217
PENDIK,YENISEHIR MAH.,405,358,356,110,246
PENDIK,YENISEHIR MAH.,405,367,363,141,222
PENDIK,YENISEHIR MAH.,405,360,357,138,219
PENDIK,YENISEHIR MAH.,405,349,344,118,226
PENDIK,YENISEHIR MAH.,404,369,367,139,228
PENDIK,YENISEHIR MAH.,406,348,343,122,221
PENDIK,YENISEHIR MAH.,405,343,341,129,212
PENDIK,YENISEHIR MAH.,405,338,334,113,221
PENDIK,YENISEHIR MAH.,405,353,352,113,239
PENDIK,YENISEHIR MAH.,405,350,345,121,224
PENDIK,YENISEHIR MAH.,405,350,343,117,226
PENDIK,YENISEHIR MAH.,406,351,351,120,231
PENDIK,YENISEHIR MAH.,405,350,350,129,221
PENDIK,YENISEHIR MAH.,405,358,357,120,237
PENDIK,YENISEHIR MAH.,404,348,347,135,212
PENDIK,YENISEHIR MAH.,406,367,363,125,238
PENDIK,YENISEHIR MAH.,405,361,354,99,255
PENDIK,YENISEHIR MAH.,404,355,351,113,238
PENDIK,KARTAL H TIPI KAPALI CEZA INFAZ KURUMU,75,81,80,36,44
KUCUKCEKMECE,CENNET MAH.,395,349,343,152,191
KUCUKCEKMECE,CENNET MAH.,398,331,320,135,185
KUCUKCEKMECE,CENNET MAH.,396,359,355,170,185
KUCUKCEKMECE,CENNET MAH.,396,353,348,149,199
KUCUKCEKMECE,CENNET MAH.,394,374,370,156,214
KUCUKCEKMECE,CENNET MAH.,394,368,364,157,207
KUCUKCEKMECE,CENNET MAH.,394,366,361,153,208
KUCUKCEKMECE,CENNET MAH.,395,362,360,178,182
KUCUKCEKMECE,CENNET MAH.,395,362,362,151,211
KUCUKCEKMECE,CENNET MAH.,396,350,348,141,207
KUCUKCEKMECE,CENNET MAH.,395,364,360,168,192
KUCUKCEKMECE,CENNET MAH.,394,349,341,145,196
KUCUKCEKMECE,CENNET MAH.,395,361,358,155,203
KUCUKCEKMECE,CENNET MAH.,395,365,362,153,209
KUCUKCEKMECE,CENNET MAH.,395,353,346,172,174
KUCUKCEKMECE,CENNET MAH.,416,335,333,136,197
KUCUKCEKMECE,CENNET MAH.,416,362,350,158,192
KUCUKCEKMECE,CENNET MAH.,416,373,369,140,229
KUCUKCEKMECE,CENNET MAH.,416,386,383,198,185
KUCUKCEKMECE,CENNET MAH.,416,360,355,161,194
KUCUKCEKMECE,CENNET MAH.,417,369,363,162,201
KUCUKCEKMECE,CENNET MAH.,404,339,339,99,240
KUCUKCEKMECE,CENNET MAH.,404,327,322,109,213
KUCUKCEKMECE,CENNET MAH.,404,345,341,124,217
KUCUKCEKMECE,CENNET MAH.,407,377,373,115,258
KUCUKCEKMECE,CENNET MAH.,404,355,350,122,228
KUCUKCEKMECE,CENNET MAH.,403,373,373,142,231
KUCUKCEKMECE,CENNET MAH.,403,357,348,135,213
KUCUKCEKMECE,CENNET MAH.,404,364,359,117,242
KUCUKCEKMECE,CENNET MAH.,403,361,360,162,198
KUCUKCEKMECE,CENNET MAH.,404,364,359,129,230
KUCUKCEKMECE,CENNET MAH.,404,369,367,121,246
KUCUKCEKMECE,CENNET MAH.,404,358,355,123,232
KUCUKCEKMECE,CENNET MAH.,404,358,351,121,230
KUCUKCEKMECE,CENNET MAH.,404,357,353,115,238
KUCUKCEKMECE,CENNET MAH.,404,358,355,118,237
KUCUKCEKMECE,CENNET MAH.,404,359,356,123,233
KUCUKCEKMECE,CENNET MAH.,403,371,362,127,235
KUCUKCEKMECE,CENNET MAH.,410,337,331,98,233
KUCUKCEKMECE,CENNET MAH.,415,319,315,102,213
KUCUKCEKMECE,CENNET MAH.,411,342,338,128,210
KUCUKCEKMECE,CENNET MAH.,412,365,362,143,219
KUCUKCEKMECE,CENNET MAH.,415,364,362,124,238
KUCUKCEKMECE,CENNET MAH.,410,378,373,161,212
KUCUKCEKMECE,CENNET MAH.,412,365,363,140,223
KUCUKCEKMECE,CENNET MAH.,411,367,366,135,231
KUCUKCEKMECE,CENNET MAH.,411,362,356,129,227
KUCUKCEKMECE,CENNET MAH.,412,375,372,128,244
KUCUKCEKMECE,CENNET MAH.,411,374,366,151,215
KUCUKCEKMECE,CENNET MAH.,411,371,367,160,207
KUCUKCEKMECE,CENNET MAH.,410,368,363,135,228
KUCUKCEKMECE,CENNET MAH.,410,367,361,119,242
KUCUKCEKMECE,CENNET MAH.,410,364,360,134,226
KUCUKCEKMECE,CENNET MAH.,411,367,362,118,244
KUCUKCEKMECE,CENNET MAH.,411,368,366,134,232
KUCUKCEKMECE,CENNET MAH.,410,360,359,103,256
KUCUKCEKMECE,CENNET MAH.,411,356,352,133,219
KUCUKCEKMECE,CENNET MAH.,410,365,360,148,212
KUCUKCEKMECE,CUMHURIYET MAH.,415,336,330,143,187
KUCUKCEKMECE,CUMHURIYET MAH.,415,334,329,128,201
KUCUKCEKMECE,CUMHURIYET MAH.,415,341,339,145,194
KUCUKCEKMECE,CUMHURIYET MAH.,415,372,370,178,192
KUCUKCEKMECE,CUMHURIYET MAH.,415,382,377,173,204
KUCUKCEKMECE,CUMHURIYET MAH.,415,382,373,174,199
KUCUKCEKMECE,CUMHURIYET MAH.,415,363,355,161,194
KUCUKCEKMECE,CUMHURIYET MAH.,415,384,379,169,210
KUCUKCEKMECE,CUMHURIYET MAH.,414,382,376,172,204
KUCUKCEKMECE,CUMHURIYET MAH.,414,388,381,183,198
KUCUKCEKMECE,CUMHURIYET MAH.,415,359,353,179,174
KUCUKCEKMECE,CUMHURIYET MAH.,415,362,357,179,178
KUCUKCEKMECE,CUMHURIYET MAH.,414,380,374,194,180
KUCUKCEKMECE,CUMHURIYET MAH.,415,374,364,152,212
KUCUKCEKMECE,CUMHURIYET MAH.,415,384,378,189,189
KUCUKCEKMECE,CUMHURIYET MAH.,415,373,369,180,189
KUCUKCEKMECE,CUMHURIYET MAH.,413,365,361,163,198
KUCUKCEKMECE,CUMHURIYET MAH.,415,376,369,185,184
KUCUKCEKMECE,CUMHURIYET MAH.,414,374,368,149,219
KUCUKCEKMECE,CUMHURIYET MAH.,415,384,381,172,209
KUCUKCEKMECE,CUMHURIYET MAH.,414,368,365,201,164
KUCUKCEKMECE,CUMHURIYET MAH.,415,355,353,163,190
KUCUKCEKMECE,CUMHURIYET MAH.,415,365,360,183,177
KUCUKCEKMECE,CUMHURIYET MAH.,414,380,376,176,200
KUCUKCEKMECE,CUMHURIYET MAH.,415,383,381,149,232
KUCUKCEKMECE,CUMHURIYET MAH.,414,380,373,170,203
KUCUKCEKMECE,CUMHURIYET MAH.,415,381,374,179,195
KUCUKCEKMECE,CUMHURIYET MAH.,413,374,371,169,202
KUCUKCEKMECE,CUMHURIYET MAH.,415,371,364,184,180
KUCUKCEKMECE,CUMHURIYET MAH.,414,373,370,218,152
KUCUKCEKMECE,CUMHURIYET MAH.,415,330,317,123,194
KUCUKCEKMECE,CUMHURIYET MAH.,411,339,333,148,185
KUCUKCEKMECE,CUMHURIYET MAH.,415,378,373,178,195
KUCUKCEKMECE,CUMHURIYET MAH.,410,355,350,168,182
KUCUKCEKMECE,CUMHURIYET MAH.,409,386,379,192,187
KUCUKCEKMECE,CUMHURIYET MAH.,410,355,351,152,199
KUCUKCEKMECE,CUMHURIYET MAH.,412,377,377,165,212
KUCUKCEKMECE,CUMHURIYET MAH.,409,359,358,170,188
KUCUKCEKMECE,CUMHURIYET MAH.,409,359,353,150,203
KUCUKCEKMECE,CUMHURIYET MAH.,410,372,367,153,214
KUCUKCEKMECE,CUMHURIYET MAH.,410,370,365,158,207
KUCUKCEKMECE,CUMHURIYET MAH.,409,359,355,156,199
KUCUKCEKMECE,CUMHURIYET MAH.,409,369,363,161,202
KUCUKCEKMECE,CUMHURIYET MAH.,410,362,361,165,196
KUCUKCEKMECE,CUMHURIYET MAH.,410,367,365,170,195
KUCUKCEKMECE,CUMHURIYET MAH.,409,361,355,158,197
KUCUKCEKMECE,CUMHURIYET MAH.,409,345,340,136,204
KUCUKCEKMECE,CUMHURIYET MAH.,410,369,366,174,192
KUCUKCEKMECE,CUMHURIYET MAH.,391,329,322,138,184
KUCUKCEKMECE,CUMHURIYET MAH.,393,347,343,158,185
KUCUKCEKMECE,CUMHURIYET MAH.,390,350,347,179,168
KUCUKCEKMECE,CUMHURIYET MAH.,390,349,341,162,179
KUCUKCEKMECE,CUMHURIYET MAH.,391,350,342,156,186
KUCUKCEKMECE,CUMHURIYET MAH.,391,351,342,178,164
KUCUKCEKMECE,CUMHURIYET MAH.,408,332,324,153,171
KUCUKCEKMECE,CUMHURIYET MAH.,404,346,341,177,164
KUCUKCEKMECE,CUMHURIYET MAH.,404,355,350,175,175
KUCUKCEKMECE,CUMHURIYET MAH.,405,353,346,161,185
KUCUKCEKMECE,CUMHURIYET MAH.,405,354,352,161,191
KUCUKCEKMECE,CUMHURIYET MAH.,404,352,349,166,183
KUCUKCEKMECE,CUMHURIYET MAH.,405,350,347,160,187
KUCUKCEKMECE,CUMHURIYET MAH.,404,356,356,152,204
KUCUKCEKMECE,CUMHURIYET MAH.,405,374,371,157,214
KUCUKCEKMECE,CUMHURIYET MAH.,404,342,341,145,196
KUCUKCEKMECE,CUMHURIYET MAH.,405,359,356,187,169
KUCUKCEKMECE,CUMHURIYET MAH.,404,362,356,172,184
KUCUKCEKMECE,CUMHURIYET MAH.,405,367,359,155,204
KUCUKCEKMECE,CUMHURIYET MAH.,405,358,357,163,194
KUCUKCEKMECE,CUMHURIYET MAH.,404,353,350,153,197
KUCUKCEKMECE,CUMHURIYET MAH.,403,353,352,141,211
KUCUKCEKMECE,CUMHURIYET MAH.,410,343,340,144,196
KUCUKCEKMECE,CUMHURIYET MAH.,415,338,328,150,178
KUCUKCEKMECE,CUMHURIYET MAH.,410,364,357,150,207
KUCUKCEKMECE,CUMHURIYET MAH.,410,364,362,195,167
KUCUKCEKMECE,CUMHURIYET MAH.,411,358,352,182,170
KUCUKCEKMECE,CUMHURIYET MAH.,409,358,352,168,184
KUCUKCEKMECE,CUMHURIYET MAH.,410,366,362,173,189
KUCUKCEKMECE,CUMHURIYET MAH.,410,360,355,190,165
KUCUKCEKMECE,CUMHURIYET MAH.,412,360,359,176,183
KUCUKCEKMECE,CUMHURIYET MAH.,410,383,377,182,195
KUCUKCEKMECE,CUMHURIYET MAH.,409,379,375,182,193
KUCUKCEKMECE,CUMHURIYET MAH.,409,380,373,177,196
KUCUKCEKMECE,CUMHURIYET MAH.,409,348,343,150,193
KUCUKCEKMECE,CUMHURIYET MAH.,409,378,373,195,178
KUCUKCEKMECE,CUMHURIYET MAH.,410,366,363,173,190
KUCUKCEKMECE,CUMHURIYET MAH.,410,357,346,172,174
KUCUKCEKMECE,CUMHURIYET MAH.,410,362,354,202,152
KUCUKCEKMECE,CUMHURIYET MAH.,409,374,365,183,182
KUCUKCEKMECE,CUMHURIYET MAH.,409,357,353,179,174
KUCUKCEKMECE,CUMHURIYET MAH.,410,380,377,171,206
KUCUKCEKMECE,CUMHURIYET MAH.,410,377,372,191,181
KUCUKCEKMECE,FATIH MAH.,348,285,284,68,216
KUCUKCEKMECE,FATIH MAH.,347,306,305,109,196
KUCUKCEKMECE,FATIH MAH.,346,299,292,84,208
KUCUKCEKMECE,FATIH MAH.,349,303,298,103,195
KUCUKCEKMECE,FATIH MAH.,394,337,334,120,214
KUCUKCEKMECE,FATIH MAH.,394,297,293,77,216
KUCUKCEKMECE,FATIH MAH.,393,305,302,102,200
KUCUKCEKMECE,FATIH MAH.,394,367,360,144,216
KUCUKCEKMECE,FATIH MAH.,394,348,341,127,214
KUCUKCEKMECE,FATIH MAH.,395,354,348,92,256
KUCUKCEKMECE,FATIH MAH.,394,349,344,140,204
KUCUKCEKMECE,FATIH MAH.,394,353,349,133,216
KUCUKCEKMECE,FATIH MAH.,393,338,335,149,186
KUCUKCEKMECE,FATIH MAH.,394,352,347,133,214
KUCUKCEKMECE,FATIH MAH.,393,346,337,117,220
KUCUKCEKMECE,FATIH MAH.,395,348,345,114,231
KUCUKCEKMECE,FATIH MAH.,394,345,334,112,222
KUCUKCEKMECE,FATIH MAH.,393,332,331,141,190
KUCUKCEKMECE,FATIH MAH.,393,350,347,150,197
KUCUKCEKMECE,FATIH MAH.,394,344,343,126,217
KUCUKCEKMECE,FATIH MAH.,394,341,336,127,209
KUCUKCEKMECE,FATIH MAH.,394,354,350,131,219
KUCUKCEKMECE,ISTASYON MAH.,415,354,348,138,210
KUCUKCEKMECE,ISTASYON MAH.,408,340,331,156,175
KUCUKCEKMECE,ISTASYON MAH.,407,376,372,149,223
KUCUKCEKMECE,ISTASYON MAH.,407,350,346,183,163
KUCUKCEKMECE,ISTASYON MAH.,407,375,372,160,212
KUCUKCEKMECE,ISTASYON MAH.,407,369,365,158,207
KUCUKCEKMECE,ISTASYON MAH.,407,365,362,151,211
KUCUKCEKMECE,ISTASYON MAH.,407,371,368,178,190
KUCUKCEKMECE,ISTASYON MAH.,408,358,355,147,208
KUCUKCEKMECE,ISTASYON MAH.,409,373,371,153,218
KUCUKCEKMECE,ISTASYON MAH.,407,363,360,153,207
KUCUKCEKMECE,ISTASYON MAH.,406,362,360,149,211
KUCUKCEKMECE,ISTASYON MAH.,408,378,375,199,176
KUCUKCEKMECE,ISTASYON MAH.,407,359,354,152,202
KUCUKCEKMECE,ISTASYON MAH.,406,363,361,152,209
KUCUKCEKMECE,ISTASYON MAH.,407,364,359,163,196
KUCUKCEKMECE,ISTASYON MAH.,406,367,362,148,214
KUCUKCEKMECE,ISTASYON MAH.,407,363,361,166,195
KUCUKCEKMECE,ISTASYON MAH.,410,375,370,150,220
KUCUKCEKMECE,ISTASYON MAH.,407,353,346,163,183
KUCUKCEKMECE,ISTASYON MAH.,406,367,364,157,207
KUCUKCEKMECE,ISTASYON MAH.,405,346,336,144,192
KUCUKCEKMECE,ISTASYON MAH.,406,369,365,164,201
KUCUKCEKMECE,ISTASYON MAH.,407,363,355,169,186
KUCUKCEKMECE,ISTASYON MAH.,399,333,332,182,150
KUCUKCEKMECE,ISTASYON MAH.,400,359,356,189,167
KUCUKCEKMECE,ISTASYON MAH.,399,358,350,182,168
KUCUKCEKMECE,ISTASYON MAH.,399,348,342,172,170
KUCUKCEKMECE,ISTASYON MAH.,399,363,355,160,195
KUCUKCEKMECE,ISTASYON MAH.,403,370,364,208,156
KUCUKCEKMECE,ISTASYON MAH.,400,367,358,201,157
KUCUKCEKMECE,ISTASYON MAH.,399,367,364,210,154
KUCUKCEKMECE,ISTASYON MAH.,399,363,357,199,158
KUCUKCEKMECE,ISTASYON MAH.,398,368,367,196,171
KUCUKCEKMECE,ISTASYON MAH.,398,355,349,188,161
KUCUKCEKMECE,ISTASYON MAH.,415,343,338,158,180
KUCUKCEKMECE,ISTASYON MAH.,413,361,354,172,182
KUCUKCEKMECE,ISTASYON MAH.,415,358,355,194,161
KUCUKCEKMECE,ISTASYON MAH.,415,363,360,184,176
KUCUKCEKMECE,ISTASYON MAH.,415,352,348,181,167
KUCUKCEKMECE,ISTASYON MAH.,415,363,359,143,216
KUCUKCEKMECE,ISTASYON MAH.,415,376,370,176,194
KUCUKCEKMECE,ISTASYON MAH.,415,366,359,184,175
KUCUKCEKMECE,ISTASYON MAH.,413,370,363,157,206
KUCUKCEKMECE,ISTASYON MAH.,415,362,355,162,193
KUCUKCEKMECE,ISTASYON MAH.,415,365,357,189,168
KUCUKCEKMECE,ISTASYON MAH.,415,344,336,172,164
KUCUKCEKMECE,ISTASYON MAH.,414,360,358,193,165
KUCUKCEKMECE,ISTASYON MAH.,414,377,371,187,184
KUCUKCEKMECE,ISTASYON MAH.,415,358,352,165,187
KUCUKCEKMECE,ISTASYON MAH.,415,368,363,183,180
KUCUKCEKMECE,ISTASYON MAH.,415,377,375,160,215
KUCUKCEKMECE,ISTASYON MAH.,415,358,352,176,176
KUCUKCEKMECE,ISTASYON MAH.,415,367,364,178,186
KUCUKCEKMECE,ISTASYON MAH.,415,358,352,190,162
KUCUKCEKMECE,ISTASYON MAH.,415,378,371,169,202
KUCUKCEKMECE,ISTASYON MAH.,415,357,354,163,191
KUCUKCEKMECE,ISTASYON MAH.,414,366,363,161,202
KUCUKCEKMECE,ISTASYON MAH.,415,370,361,164,197
KUCUKCEKMECE,ISTASYON MAH.,414,373,363,182,181
KUCUKCEKMECE,ISTASYON MAH.,415,376,371,182,189
KUCUKCEKMECE,ISTASYON MAH.,414,374,368,154,214
KUCUKCEKMECE,ISTASYON MAH.,413,352,347,170,177
KUCUKCEKMECE,ISTASYON MAH.,415,375,372,170,202
KUCUKCEKMECE,ISTASYON MAH.,413,355,353,183,170
KUCUKCEKMECE,KANARYA MAH.,388,314,298,142,156
KUCUKCEKMECE,KANARYA MAH.,386,318,308,132,176
KUCUKCEKMECE,KANARYA MAH.,388,337,333,131,202
KUCUKCEKMECE,KANARYA MAH.,387,332,332,172,160
KUCUKCEKMECE,KANARYA MAH.,388,331,325,133,192
KUCUKCEKMECE,KANARYA MAH.,386,330,322,152,170
KUCUKCEKMECE,KANARYA MAH.,388,347,343,141,202
KUCUKCEKMECE,KANARYA MAH.,386,348,345,146,199
KUCUKCEKMECE,KANARYA MAH.,388,343,341,175,166
KUCUKCEKMECE,KANARYA MAH.,388,332,327,150,177
KUCUKCEKMECE,KANARYA MAH.,388,329,321,115,206
KUCUKCEKMECE,KANARYA MAH.,388,339,334,126,208
KUCUKCEKMECE,KANARYA MAH.,388,327,319,168,151
KUCUKCEKMECE,KANARYA MAH.,388,341,335,128,207
KUCUKCEKMECE,KANARYA MAH.,388,336,334,160,174
KUCUKCEKMECE,KANARYA MAH.,395,332,328,131,197
KUCUKCEKMECE,KANARYA MAH.,396,347,334,107,227
KUCUKCEKMECE,KANARYA MAH.,397,342,338,137,201
KUCUKCEKMECE,KANARYA MAH.,395,341,335,116,219
KUCUKCEKMECE,KANARYA MAH.,394,350,350,99,251
KUCUKCEKMECE,KANARYA MAH.,394,341,334,130,204
KUCUKCEKMECE,KANARYA MAH.,395,335,326,130,196
KUCUKCEKMECE,KANARYA MAH.,415,341,324,141,183
KUCUKCEKMECE,KANARYA MAH.,412,323,317,152,165
KUCUKCEKMECE,KANARYA MAH.,408,318,312,128,184
KUCUKCEKMECE,KANARYA MAH.,415,316,312,113,199
KUCUKCEKMECE,KANARYA MAH.,415,352,349,118,231
KUCUKCEKMECE,KANARYA MAH.,415,348,343,131,212
KUCUKCEKMECE,KANARYA MAH.,415,361,359,128,231
KUCUKCEKMECE,KANARYA MAH.,412,354,353,127,226
KUCUKCEKMECE,KANARYA MAH.,415,373,365,162,203
KUCUKCEKMECE,KANARYA MAH.,415,370,367,180,187
KUCUKCEKMECE,KANARYA MAH.,415,365,363,136,227
KUCUKCEKMECE,KANARYA MAH.,415,372,368,125,243
KUCUKCEKMECE,KANARYA MAH.,415,376,374,135,239
KUCUKCEKMECE,KANARYA MAH.,412,363,359,133,226
KUCUKCEKMECE,KANARYA MAH.,408,358,355,130,225
KUCUKCEKMECE,KANARYA MAH.,408,362,357,155,202
KUCUKCEKMECE,KANARYA MAH.,415,362,360,148,212
KUCUKCEKMECE,KANARYA MAH.,415,354,346,145,201
KUCUKCEKMECE,KANARYA MAH.,412,352,349,142,207
KUCUKCEKMECE,KANARYA MAH.,412,348,346,167,179
KUCUKCEKMECE,KANARYA MAH.,415,372,369,153,216
KUCUKCEKMECE,KANARYA MAH.,412,362,356,141,215
KUCUKCEKMECE,KANARYA MAH.,415,362,358,139,219
KUCUKCEKMECE,KANARYA MAH.,415,370,369,129,240
KUCUKCEKMECE,KANARYA MAH.,409,354,350,144,206
KUCUKCEKMECE,KANARYA MAH.,415,359,355,143,212
KUCUKCEKMECE,KANARYA MAH.,415,381,370,155,215
KUCUKCEKMECE,KANARYA MAH.,408,368,365,132,233
KUCUKCEKMECE,KANARYA MAH.,412,364,357,146,211
KUCUKCEKMECE,KANARYA MAH.,410,366,357,140,217
KUCUKCEKMECE,KANARYA MAH.,415,368,363,162,201
KUCUKCEKMECE,KANARYA MAH.,412,372,368,153,215
KUCUKCEKMECE,KANARYA MAH.,414,374,366,129,237
KUCUKCEKMECE,KANARYA MAH.,412,360,352,127,225
KUCUKCEKMECE,KANARYA MAH.,415,360,357,132,225
KUCUKCEKMECE,KANARYA MAH.,413,361,354,147,207
KUCUKCEKMECE,KANARYA MAH.,413,360,356,138,218
KUCUKCEKMECE,KANARYA MAH.,412,371,366,108,258
KUCUKCEKMECE,KANARYA MAH.,412,339,335,145,190
KUCUKCEKMECE,KANARYA MAH.,413,347,345,136,209
KUCUKCEKMECE,KANARYA MAH.,411,348,338,130,208
KUCUKCEKMECE,KANARYA MAH.,410,355,354,138,216
KUCUKCEKMECE,KANARYA MAH.,413,362,359,132,227
KUCUKCEKMECE,KANARYA MAH.,413,372,367,148,219
KUCUKCEKMECE,KANARYA MAH.,411,362,352,135,217
KUCUKCEKMECE,KANARYA MAH.,412,359,353,146,207
KUCUKCEKMECE,KANARYA MAH.,393,339,333,114,219
KUCUKCEKMECE,KANARYA MAH.,393,323,323,135,188
KUCUKCEKMECE,KANARYA MAH.,393,336,332,119,213
KUCUKCEKMECE,KANARYA MAH.,394,342,332,130,202
KUCUKCEKMECE,KANARYA MAH.,392,337,330,112,218
KUCUKCEKMECE,KANARYA MAH.,393,341,332,116,216
KUCUKCEKMECE,KANARYA MAH.,393,336,328,100,228
KUCUKCEKMECE,KANARYA MAH.,394,332,325,107,218
KUCUKCEKMECE,KANARYA MAH.,393,346,338,109,229
KUCUKCEKMECE,KANARYA MAH.,396,331,325,94,231
KUCUKCEKMECE,KANARYA MAH.,393,342,337,140,197
KUCUKCEKMECE,KANARYA MAH.,392,341,337,103,234
KUCUKCEKMECE,KANARYA MAH.,393,340,334,128,206
KUCUKCEKMECE,KANARYA MAH.,394,348,344,101,243
KUCUKCEKMECE,KANARYA MAH.,392,353,346,106,240
KUCUKCEKMECE,KANARYA MAH.,393,351,344,123,221
KUCUKCEKMECE,KANARYA MAH.,393,342,335,103,232
KUCUKCEKMECE,KANARYA MAH.,395,313,306,99,207
KUCUKCEKMECE,KANARYA MAH.,394,332,327,114,213
KUCUKCEKMECE,KANARYA MAH.,395,355,352,119,233
KUCUKCEKMECE,KANARYA MAH.,395,340,335,89,246
KUCUKCEKMECE,KANARYA MAH.,394,334,329,134,195
KUCUKCEKMECE,KANARYA MAH.,393,338,335,109,226
KUCUKCEKMECE,KANARYA MAH.,397,335,331,121,210
KUCUKCEKMECE,KANARYA MAH.,393,325,321,82,239
KUCUKCEKMECE,KANARYA MAH.,394,345,343,111,232
KUCUKCEKMECE,KANARYA MAH.,395,346,338,111,227
KUCUKCEKMECE,KANARYA MAH.,395,341,339,104,235
KUCUKCEKMECE,KANARYA MAH.,395,339,332,130,202
KUCUKCEKMECE,KANARYA MAH.,400,331,330,105,225
KUCUKCEKMECE,KANARYA MAH.,398,349,349,123,226
KUCUKCEKMECE,KANARYA MAH.,393,343,335,93,242
KUCUKCEKMECE,KANARYA MAH.,412,323,319,161,158
KUCUKCEKMECE,KANARYA MAH.,412,353,351,176,175
KUCUKCEKMECE,KANARYA MAH.,415,371,367,180,187
KUCUKCEKMECE,KANARYA MAH.,412,362,355,176,179
KUCUKCEKMECE,KANARYA MAH.,412,360,356,166,190
KUCUKCEKMECE,KANARYA MAH.,412,370,365,186,179
KUCUKCEKMECE,KANARYA MAH.,412,360,358,226,132
KUCUKCEKMECE,KANARYA MAH.,415,365,362,183,179
KUCUKCEKMECE,KANARYA MAH.,412,351,349,170,179
KUCUKCEKMECE,YENI MAHALLE MAH.,403,323,315,130,185
KUCUKCEKMECE,YENI MAHALLE MAH.,404,336,335,157,178
KUCUKCEKMECE,YENI MAHALLE MAH.,403,334,331,136,195
KUCUKCEKMECE,YENI MAHALLE MAH.,403,334,328,131,197
KUCUKCEKMECE,YENI MAHALLE MAH.,405,379,376,169,207
KUCUKCEKMECE,YENI MAHALLE MAH.,403,356,351,169,182
KUCUKCEKMECE,YENI MAHALLE MAH.,406,373,368,160,208
KUCUKCEKMECE,YENI MAHALLE MAH.,406,367,362,146,216
KUCUKCEKMECE,YENI MAHALLE MAH.,404,369,368,151,217
KUCUKCEKMECE,YENI MAHALLE MAH.,403,348,348,169,179
KUCUKCEKMECE,YENI MAHALLE MAH.,404,359,358,145,213
KUCUKCEKMECE,YENI MAHALLE MAH.,403,359,357,181,176
KUCUKCEKMECE,YENI MAHALLE MAH.,403,364,362,165,197
KUCUKCEKMECE,YENI MAHALLE MAH.,404,361,355,165,190
KUCUKCEKMECE,YENI MAHALLE MAH.,402,357,356,185,171
KUCUKCEKMECE,YENI MAHALLE MAH.,404,363,358,129,229
KUCUKCEKMECE,YENI MAHALLE MAH.,402,341,339,143,196
KUCUKCEKMECE,YENI MAHALLE MAH.,402,375,368,147,221
KUCUKCEKMECE,YENI MAHALLE MAH.,403,363,357,143,214
KUCUKCEKMECE,YENI MAHALLE MAH.,403,351,343,154,189
KUCUKCEKMECE,YENI MAHALLE MAH.,403,361,357,138,219
KUCUKCEKMECE,YENI MAHALLE MAH.,402,371,363,153,210
KUCUKCEKMECE,YENI MAHALLE MAH.,402,370,364,149,215
KUCUKCEKMECE,YENI MAHALLE MAH.,402,369,363,153,210
KUCUKCEKMECE,YENI MAHALLE MAH.,402,350,345,152,193
KUCUKCEKMECE,YENI MAHALLE MAH.,402,365,356,162,194
KUCUKCEKMECE,YENI MAHALLE MAH.,403,370,366,161,205
KUCUKCEKMECE,YENI MAHALLE MAH.,402,369,364,154,210
KUCUKCEKMECE,YENI MAHALLE MAH.,403,372,362,171,191
KUCUKCEKMECE,YENI MAHALLE MAH.,388,336,327,141,186
KUCUKCEKMECE,YENI MAHALLE MAH.,393,354,351,146,205
KUCUKCEKMECE,YENI MAHALLE MAH.,388,351,349,132,217
KUCUKCEKMECE,YENI MAHALLE MAH.,388,356,350,143,207
KUCUKCEKMECE,YENI MAHALLE MAH.,389,341,338,182,156
KUCUKCEKMECE,YENI MAHALLE MAH.,388,364,359,136,223
KUCUKCEKMECE,YENI MAHALLE MAH.,389,360,356,181,175
KUCUKCEKMECE,YESILOVA MAH.,402,321,311,127,184
KUCUKCEKMECE,YESILOVA MAH.,403,353,348,166,182
KUCUKCEKMECE,YESILOVA MAH.,402,380,379,141,238
KUCUKCEKMECE,YESILOVA MAH.,402,373,368,127,241
KUCUKCEKMECE,YESILOVA MAH.,401,357,356,144,212
KUCUKCEKMECE,YESILOVA MAH.,406,370,360,157,203
KUCUKCEKMECE,YESILOVA MAH.,401,360,354,139,215
KUCUKCEKMECE,YESILOVA MAH.,402,354,351,151,200
KUCUKCEKMECE,YESILOVA MAH.,403,364,361,149,212
KUCUKCEKMECE,YESILOVA MAH.,402,365,364,128,236
KUCUKCEKMECE,YESILOVA MAH.,403,358,356,162,194
KUCUKCEKMECE,YESILOVA MAH.,402,358,356,150,206
KUCUKCEKMECE,YESILOVA MAH.,402,367,363,159,204
KUCUKCEKMECE,YESILOVA MAH.,403,361,356,176,180
KUCUKCEKMECE,YESILOVA MAH.,402,363,358,148,210
KUCUKCEKMECE,YESILOVA MAH.,415,344,338,158,180
KUCUKCEKMECE,YESILOVA MAH.,415,365,360,153,207
KUCUKCEKMECE,YESILOVA MAH.,415,380,377,149,228
KUCUKCEKMECE,YESILOVA MAH.,415,356,355,167,188
KUCUKCEKMECE,YESILOVA MAH.,412,378,371,172,199
KUCUKCEKMECE,YESILOVA MAH.,412,377,374,159,215
KUCUKCEKMECE,YESILOVA MAH.,412,367,363,128,235
KUCUKCEKMECE,YESILOVA MAH.,415,378,374,168,206
KUCUKCEKMECE,YESILOVA MAH.,412,360,354,167,187
KUCUKCEKMECE,YESILOVA MAH.,412,354,347,185,162
KUCUKCEKMECE,YESILOVA MAH.,412,347,340,150,190
KUCUKCEKMECE,YESILOVA MAH.,415,374,370,155,215
KUCUKCEKMECE,YESILOVA MAH.,414,373,367,165,202
KUCUKCEKMECE,YESILOVA MAH.,413,369,368,176,192
KUCUKCEKMECE,YESILOVA MAH.,413,371,367,179,188
KUCUKCEKMECE,YESILOVA MAH.,409,345,338,169,169
KUCUKCEKMECE,YESILOVA MAH.,409,357,349,163,186
KUCUKCEKMECE,YESILOVA MAH.,410,364,358,209,149
KUCUKCEKMECE,YESILOVA MAH.,410,373,366,206,160
KUCUKCEKMECE,YESILOVA MAH.,409,369,363,178,185
KUCUKCEKMECE,YESILOVA MAH.,409,369,364,179,185
KUCUKCEKMECE,YESILOVA MAH.,409,349,345,188,157
KUCUKCEKMECE,YESILOVA MAH.,410,358,352,206,146
KUCUKCEKMECE,YESILOVA MAH.,411,366,359,212,147
KUCUKCEKMECE,YESILOVA MAH.,408,375,370,171,199
KUCUKCEKMECE,YESILOVA MAH.,409,357,348,160,188
KUCUKCEKMECE,YESILOVA MAH.,410,357,356,167,189
KUCUKCEKMECE,YESILOVA MAH.,409,369,364,170,194
KUCUKCEKMECE,YESILOVA MAH.,409,352,343,176,167
KUCUKCEKMECE,YESILOVA MAH.,409,365,358,183,175
KUCUKCEKMECE,YESILOVA MAH.,410,371,365,182,183
KUCUKCEKMECE,YESILOVA MAH.,406,327,318,121,197
KUCUKCEKMECE,YESILOVA MAH.,405,355,353,134,219
KUCUKCEKMECE,YESILOVA MAH.,406,384,379,148,231
KUCUKCEKMECE,YESILOVA MAH.,406,350,346,156,190
KUCUKCEKMECE,YESILOVA MAH.,405,358,356,143,213
KUCUKCEKMECE,YESILOVA MAH.,404,366,362,143,219
KUCUKCEKMECE,YESILOVA MAH.,404,355,352,143,209
KUCUKCEKMECE,YESILOVA MAH.,405,350,344,136,208
KUCUKCEKMECE,YESILOVA MAH.,405,375,370,167,203
KUCUKCEKMECE,YESILOVA MAH.,404,362,360,149,211
KUCUKCEKMECE,YESILOVA MAH.,405,368,363,150,213
KUCUKCEKMECE,YESILOVA MAH.,405,380,374,153,221
KUCUKCEKMECE,YESILOVA MAH.,405,355,352,160,192
KUCUKCEKMECE,YESILOVA MAH.,405,351,348,146,202
KUCUKCEKMECE,YESILOVA MAH.,405,368,363,152,211
KUCUKCEKMECE,YESILOVA MAH.,405,371,370,175,195
KUCUKCEKMECE,BESYOL MAH.,379,323,319,94,225
KUCUKCEKMECE,BESYOL MAH.,378,325,323,140,183
KUCUKCEKMECE,BESYOL MAH.,379,340,329,157,172
KUCUKCEKMECE,BESYOL MAH.,377,322,317,157,160
KUCUKCEKMECE,FEVZI CAKMAK MAH.,388,352,347,156,191
KUCUKCEKMECE,FEVZI CAKMAK MAH.,387,341,335,166,169
KUCUKCEKMECE,FEVZI CAKMAK MAH.,388,357,352,152,200
KUCUKCEKMECE,FEVZI CAKMAK MAH.,388,347,339,151,188
KUCUKCEKMECE,FEVZI CAKMAK MAH.,387,339,336,155,181
KUCUKCEKMECE,FEVZI CAKMAK MAH.,387,363,360,153,207
KUCUKCEKMECE,FEVZI CAKMAK MAH.,386,352,347,181,166
KUCUKCEKMECE,FEVZI CAKMAK MAH.,389,346,335,168,167
KUCUKCEKMECE,FEVZI CAKMAK MAH.,402,328,321,101,220
KUCUKCEKMECE,FEVZI CAKMAK MAH.,402,352,337,126,211
KUCUKCEKMECE,FEVZI CAKMAK MAH.,401,361,359,145,214
KUCUKCEKMECE,FEVZI CAKMAK MAH.,402,354,352,136,216
KUCUKCEKMECE,FEVZI CAKMAK MAH.,403,354,350,157,193
KUCUKCEKMECE,FEVZI CAKMAK MAH.,401,366,359,139,220
KUCUKCEKMECE,FEVZI CAKMAK MAH.,402,358,353,139,214
KUCUKCEKMECE,FEVZI CAKMAK MAH.,402,350,348,112,236
KUCUKCEKMECE,FEVZI CAKMAK MAH.,404,362,358,159,199
KUCUKCEKMECE,FEVZI CAKMAK MAH.,401,363,356,135,221
KUCUKCEKMECE,FEVZI CAKMAK MAH.,402,368,362,130,232
KUCUKCEKMECE,FEVZI CAKMAK MAH.,402,375,368,136,232
KUCUKCEKMECE,FEVZI CAKMAK MAH.,402,348,341,129,212
KUCUKCEKMECE,FEVZI CAKMAK MAH.,402,359,354,134,220
KUCUKCEKMECE,FEVZI CAKMAK MAH.,402,358,354,106,248
KUCUKCEKMECE,FEVZI CAKMAK MAH.,402,360,355,141,214
KUCUKCEKMECE,FEVZI CAKMAK MAH.,402,365,362,145,217
KUCUKCEKMECE,FEVZI CAKMAK MAH.,405,312,306,140,166
KUCUKCEKMECE,FEVZI CAKMAK MAH.,408,320,315,111,204
KUCUKCEKMECE,FEVZI CAKMAK MAH.,405,367,363,163,200
KUCUKCEKMECE,FEVZI CAKMAK MAH.,404,357,350,130,220
KUCUKCEKMECE,FEVZI CAKMAK MAH.,404,366,357,153,204
KUCUKCEKMECE,FEVZI CAKMAK MAH.,405,358,349,130,219
KUCUKCEKMECE,FEVZI CAKMAK MAH.,404,362,361,158,203
KUCUKCEKMECE,FEVZI CAKMAK MAH.,405,362,359,152,207
KUCUKCEKMECE,FEVZI CAKMAK MAH.,405,364,360,148,212
KUCUKCEKMECE,FEVZI CAKMAK MAH.,405,368,361,119,242
KUCUKCEKMECE,FEVZI CAKMAK MAH.,405,358,353,161,192
KUCUKCEKMECE,FEVZI CAKMAK MAH.,404,364,361,164,197
KUCUKCEKMECE,FEVZI CAKMAK MAH.,405,370,367,145,222
KUCUKCEKMECE,FEVZI CAKMAK MAH.,405,364,362,127,235
KUCUKCEKMECE,FEVZI CAKMAK MAH.,405,362,359,142,217
KUCUKCEKMECE,FEVZI CAKMAK MAH.,405,364,362,159,203
KUCUKCEKMECE,FEVZI CAKMAK MAH.,405,376,373,165,208
KUCUKCEKMECE,FEVZI CAKMAK MAH.,404,370,366,148,218
KUCUKCEKMECE,FEVZI CAKMAK MAH.,404,363,357,165,192
KUCUKCEKMECE,FEVZI CAKMAK MAH.,405,364,359,160,199
KUCUKCEKMECE,FEVZI CAKMAK MAH.,404,371,370,155,215
KUCUKCEKMECE,GULTEPE MAH.,405,330,326,133,193
KUCUKCEKMECE,GULTEPE MAH.,405,369,365,147,218
KUCUKCEKMECE,GULTEPE MAH.,405,353,353,161,192
KUCUKCEKMECE,GULTEPE MAH.,406,367,360,159,201
KUCUKCEKMECE,GULTEPE MAH.,405,366,363,151,212
KUCUKCEKMECE,GULTEPE MAH.,405,369,367,168,199
KUCUKCEKMECE,GULTEPE MAH.,405,385,385,201,184
KUCUKCEKMECE,GULTEPE MAH.,405,364,360,176,184
KUCUKCEKMECE,GULTEPE MAH.,405,371,368,184,184
KUCUKCEKMECE,GULTEPE MAH.,408,373,372,138,234
KUCUKCEKMECE,GULTEPE MAH.,406,358,355,142,213
KUCUKCEKMECE,GULTEPE MAH.,405,369,365,142,223
KUCUKCEKMECE,GULTEPE MAH.,409,343,338,151,187
KUCUKCEKMECE,GULTEPE MAH.,409,366,363,145,218
KUCUKCEKMECE,GULTEPE MAH.,415,376,367,161,206
KUCUKCEKMECE,GULTEPE MAH.,409,368,365,162,203
KUCUKCEKMECE,GULTEPE MAH.,408,369,366,182,184
KUCUKCEKMECE,GULTEPE MAH.,415,378,376,159,217
KUCUKCEKMECE,GULTEPE MAH.,410,367,363,146,217
KUCUKCEKMECE,GULTEPE MAH.,411,370,362,155,207
KUCUKCEKMECE,GULTEPE MAH.,410,380,375,148,227
KUCUKCEKMECE,GULTEPE MAH.,410,380,378,119,259
KUCUKCEKMECE,GULTEPE MAH.,411,380,378,175,203
KUCUKCEKMECE,GULTEPE MAH.,404,314,307,109,198
KUCUKCEKMECE,GULTEPE MAH.,405,356,355,138,217
KUCUKCEKMECE,GULTEPE MAH.,404,364,358,156,202
KUCUKCEKMECE,GULTEPE MAH.,404,363,358,184,174
KUCUKCEKMECE,GULTEPE MAH.,404,360,355,112,243
KUCUKCEKMECE,GULTEPE MAH.,404,359,354,134,220
KUCUKCEKMECE,GULTEPE MAH.,404,346,345,123,222
KUCUKCEKMECE,GULTEPE MAH.,404,361,356,136,220
KUCUKCEKMECE,GULTEPE MAH.,407,353,346,167,179
KUCUKCEKMECE,GULTEPE MAH.,404,370,369,160,209
KUCUKCEKMECE,GULTEPE MAH.,407,338,326,159,167
KUCUKCEKMECE,GULTEPE MAH.,409,349,345,124,221
KUCUKCEKMECE,GULTEPE MAH.,408,376,374,184,190
KUCUKCEKMECE,GULTEPE MAH.,410,358,351,167,184
KUCUKCEKMECE,GULTEPE MAH.,408,367,364,156,208
KUCUKCEKMECE,GULTEPE MAH.,408,370,365,149,216
KUCUKCEKMECE,GULTEPE MAH.,408,376,373,141,232
KUCUKCEKMECE,GULTEPE MAH.,407,370,367,154,213
KUCUKCEKMECE,GULTEPE MAH.,408,358,347,132,215
KUCUKCEKMECE,GULTEPE MAH.,408,365,361,149,212
KUCUKCEKMECE,GULTEPE MAH.,407,353,350,147,203
KUCUKCEKMECE,GULTEPE MAH.,408,362,357,138,219
KUCUKCEKMECE,GULTEPE MAH.,408,367,362,147,215
KUCUKCEKMECE,GULTEPE MAH.,408,373,367,171,196
KUCUKCEKMECE,GULTEPE MAH.,407,359,355,154,201
KUCUKCEKMECE,GULTEPE MAH.,407,364,362,174,188
KUCUKCEKMECE,GULTEPE MAH.,408,359,354,140,214
KUCUKCEKMECE,GULTEPE MAH.,407,372,371,144,227
KUCUKCEKMECE,GULTEPE MAH.,408,356,354,169,185
KUCUKCEKMECE,GULTEPE MAH.,408,368,366,165,201
KUCUKCEKMECE,GULTEPE MAH.,408,354,348,150,198
KUCUKCEKMECE,GULTEPE MAH.,408,364,363,140,223
KUCUKCEKMECE,INONU MAH.,403,339,331,183,148
KUCUKCEKMECE,INONU MAH.,406,341,334,192,142
KUCUKCEKMECE,INONU MAH.,405,366,356,192,164
KUCUKCEKMECE,INONU MAH.,404,355,352,216,136
KUCUKCEKMECE,INONU MAH.,404,353,351,175,176
KUCUKCEKMECE,INONU MAH.,404,375,371,207,164
KUCUKCEKMECE,INONU MAH.,404,378,374,204,170
KUCUKCEKMECE,INONU MAH.,404,362,354,187,167
KUCUKCEKMECE,INONU MAH.,403,367,363,218,145
KUCUKCEKMECE,INONU MAH.,403,367,365,219,146
KUCUKCEKMECE,INONU MAH.,404,364,363,191,172
KUCUKCEKMECE,INONU MAH.,403,350,344,191,153
KUCUKCEKMECE,INONU MAH.,404,365,361,195,166
KUCUKCEKMECE,INONU MAH.,404,358,350,188,162
KUCUKCEKMECE,INONU MAH.,403,353,348,175,173
KUCUKCEKMECE,INONU MAH.,403,347,338,171,167
KUCUKCEKMECE,INONU MAH.,404,360,355,202,153
KUCUKCEKMECE,INONU MAH.,407,372,361,186,175
KUCUKCEKMECE,INONU MAH.,403,355,347,202,145
KUCUKCEKMECE,INONU MAH.,403,364,358,198,160
KUCUKCEKMECE,INONU MAH.,403,366,362,201,161
KUCUKCEKMECE,INONU MAH.,404,359,354,200,154
KUCUKCEKMECE,INONU MAH.,403,360,354,192,162
KUCUKCEKMECE,INONU MAH.,403,348,345,198,147
KUCUKCEKMECE,INONU MAH.,404,356,352,200,152
KUCUKCEKMECE,INONU MAH.,404,364,359,217,142
KUCUKCEKMECE,INONU MAH.,403,358,351,174,177
KUCUKCEKMECE,INONU MAH.,404,364,359,186,173
KUCUKCEKMECE,INONU MAH.,415,387,380,232,148
KUCUKCEKMECE,INONU MAH.,403,363,355,185,170
KUCUKCEKMECE,INONU MAH.,398,330,320,178,142
KUCUKCEKMECE,INONU MAH.,401,355,349,205,144
KUCUKCEKMECE,INONU MAH.,400,338,333,180,153
KUCUKCEKMECE,INONU MAH.,398,345,337,178,159
KUCUKCEKMECE,INONU MAH.,399,356,352,192,160
KUCUKCEKMECE,INONU MAH.,401,346,340,208,132
KUCUKCEKMECE,INONU MAH.,398,342,338,191,147
KUCUKCEKMECE,INONU MAH.,398,356,354,194,160
KUCUKCEKMECE,INONU MAH.,399,375,367,198,169
KUCUKCEKMECE,INONU MAH.,398,352,349,181,168
KUCUKCEKMECE,INONU MAH.,399,368,359,212,147
KUCUKCEKMECE,INONU MAH.,399,353,348,207,141
KUCUKCEKMECE,INONU MAH.,398,356,348,190,158
KUCUKCEKMECE,INONU MAH.,399,344,342,187,155
KUCUKCEKMECE,INONU MAH.,398,347,344,201,143
KUCUKCEKMECE,INONU MAH.,399,363,353,224,129
KUCUKCEKMECE,INONU MAH.,398,353,348,240,108
KUCUKCEKMECE,INONU MAH.,398,353,349,204,145
KUCUKCEKMECE,INONU MAH.,399,357,351,201,150
KUCUKCEKMECE,INONU MAH.,398,357,355,192,163
KUCUKCEKMECE,INONU MAH.,399,358,351,215,136
KUCUKCEKMECE,INONU MAH.,397,339,335,207,128
KUCUKCEKMECE,INONU MAH.,397,361,357,210,147
KUCUKCEKMECE,INONU MAH.,397,360,352,200,152
KUCUKCEKMECE,INONU MAH.,403,340,335,190,145
KUCUKCEKMECE,INONU MAH.,405,342,336,176,160
KUCUKCEKMECE,INONU MAH.,407,375,368,180,188
KUCUKCEKMECE,INONU MAH.,404,354,352,205,147
KUCUKCEKMECE,INONU MAH.,407,361,358,212,146
KUCUKCEKMECE,INONU MAH.,404,365,359,183,176
KUCUKCEKMECE,INONU MAH.,403,359,356,196,160
KUCUKCEKMECE,INONU MAH.,404,364,361,183,178
KUCUKCEKMECE,INONU MAH.,404,364,357,191,166
KUCUKCEKMECE,INONU MAH.,404,358,352,179,173
KUCUKCEKMECE,INONU MAH.,403,363,355,198,157
KUCUKCEKMECE,INONU MAH.,404,363,358,200,158
KUCUKCEKMECE,INONU MAH.,403,367,362,188,174
KUCUKCEKMECE,INONU MAH.,403,349,345,203,142
KUCUKCEKMECE,INONU MAH.,404,371,369,204,165
KUCUKCEKMECE,INONU MAH.,403,366,356,208,148
KUCUKCEKMECE,INONU MAH.,404,357,354,180,174
KUCUKCEKMECE,INONU MAH.,403,346,342,169,173
KUCUKCEKMECE,INONU MAH.,403,367,361,159,202
KUCUKCEKMECE,INONU MAH.,403,374,368,179,189
KUCUKCEKMECE,INONU MAH.,404,352,350,176,174
KUCUKCEKMECE,INONU MAH.,404,353,349,180,169
KUCUKCEKMECE,INONU MAH.,403,354,349,183,166
KUCUKCEKMECE,INONU MAH.,415,350,342,194,148
KUCUKCEKMECE,INONU MAH.,415,355,354,163,191
KUCUKCEKMECE,INONU MAH.,415,377,365,191,174
KUCUKCEKMECE,INONU MAH.,415,375,372,182,190
KUCUKCEKMECE,INONU MAH.,415,360,356,223,133
KUCUKCEKMECE,INONU MAH.,415,368,363,207,156
KUCUKCEKMECE,INONU MAH.,415,366,361,219,142
KUCUKCEKMECE,INONU MAH.,415,382,371,177,194
KUCUKCEKMECE,INONU MAH.,415,350,346,170,176
KUCUKCEKMECE,INONU MAH.,415,365,359,209,150
KUCUKCEKMECE,INONU MAH.,415,368,361,189,172
KUCUKCEKMECE,INONU MAH.,412,369,363,181,182
KUCUKCEKMECE,INONU MAH.,415,352,344,182,162
KUCUKCEKMECE,INONU MAH.,415,367,361,187,174
KUCUKCEKMECE,INONU MAH.,415,367,364,173,191
KUCUKCEKMECE,INONU MAH.,412,363,362,186,176
KUCUKCEKMECE,INONU MAH.,412,375,369,213,156
KUCUKCEKMECE,INONU MAH.,415,367,361,202,159
KUCUKCEKMECE,INONU MAH.,411,378,373,193,180
KUCUKCEKMECE,INONU MAH.,415,345,342,195,147
KUCUKCEKMECE,INONU MAH.,415,352,346,147,199
KUCUKCEKMECE,INONU MAH.,415,375,368,197,171
KUCUKCEKMECE,INONU MAH.,415,362,354,190,164
KUCUKCEKMECE,INONU MAH.,415,372,367,175,192
KUCUKCEKMECE,INONU MAH.,412,389,384,228,156
KUCUKCEKMECE,INONU MAH.,415,362,357,187,170
KUCUKCEKMECE,INONU MAH.,415,373,365,222,143
KUCUKCEKMECE,INONU MAH.,415,367,364,213,151
KUCUKCEKMECE,INONU MAH.,415,364,357,193,164
KUCUKCEKMECE,INONU MAH.,415,370,364,216,148
KUCUKCEKMECE,INONU MAH.,415,371,366,200,166
KUCUKCEKMECE,INONU MAH.,415,365,354,201,153
KUCUKCEKMECE,INONU MAH.,415,365,362,199,163
KUCUKCEKMECE,INONU MAH.,415,366,362,189,173
KUCUKCEKMECE,INONU MAH.,413,361,356,179,177
KUCUKCEKMECE,INONU MAH.,415,369,364,205,159
KUCUKCEKMECE,INONU MAH.,415,363,359,181,178
KUCUKCEKMECE,INONU MAH.,415,374,368,211,157
KUCUKCEKMECE,INONU MAH.,415,369,362,214,148
KUCUKCEKMECE,INONU MAH.,415,369,357,183,174
KUCUKCEKMECE,INONU MAH.,414,375,368,209,159
KUCUKCEKMECE,INONU MAH.,413,367,362,191,171
KUCUKCEKMECE,INONU MAH.,413,376,372,208,164
KUCUKCEKMECE,INONU MAH.,415,376,375,233,142
KUCUKCEKMECE,INONU MAH.,415,376,370,215,155
KUCUKCEKMECE,INONU MAH.,415,377,373,191,182
KUCUKCEKMECE,INONU MAH.,414,382,376,190,186
KUCUKCEKMECE,INONU MAH.,415,383,379,181,198
KUCUKCEKMECE,INONU MAH.,414,370,359,197,162
KUCUKCEKMECE,KARTALTEPE MAH.,409,346,337,149,188
KUCUKCEKMECE,KARTALTEPE MAH.,409,346,340,167,173
KUCUKCEKMECE,KARTALTEPE MAH.,410,366,366,153,213
KUCUKCEKMECE,KARTALTEPE MAH.,409,365,357,168,189
KUCUKCEKMECE,KARTALTEPE MAH.,410,365,357,152,205
KUCUKCEKMECE,KARTALTEPE MAH.,408,364,363,156,207
KUCUKCEKMECE,KARTALTEPE MAH.,409,362,361,177,184
KUCUKCEKMECE,KARTALTEPE MAH.,409,368,364,227,137
KUCUKCEKMECE,KARTALTEPE MAH.,409,355,349,158,191
KUCUKCEKMECE,KARTALTEPE MAH.,408,347,342,152,190
KUCUKCEKMECE,KARTALTEPE MAH.,415,384,381,175,206
KUCUKCEKMECE,KARTALTEPE MAH.,409,363,358,161,197
KUCUKCEKMECE,KARTALTEPE MAH.,409,364,362,160,202
KUCUKCEKMECE,KARTALTEPE MAH.,409,364,359,179,180
KUCUKCEKMECE,KARTALTEPE MAH.,408,369,363,143,220
KUCUKCEKMECE,KARTALTEPE MAH.,398,345,339,160,179
KUCUKCEKMECE,KARTALTEPE MAH.,397,337,336,171,165
KUCUKCEKMECE,KARTALTEPE MAH.,397,348,343,150,193
KUCUKCEKMECE,KARTALTEPE MAH.,396,339,334,171,163
KUCUKCEKMECE,KARTALTEPE MAH.,396,336,327,177,150
KUCUKCEKMECE,KARTALTEPE MAH.,396,352,346,176,170
KUCUKCEKMECE,KARTALTEPE MAH.,396,343,339,190,149
KUCUKCEKMECE,KEMALPASA MAH.,391,327,321,143,178
KUCUKCEKMECE,KEMALPASA MAH.,388,326,318,111,207
KUCUKCEKMECE,KEMALPASA MAH.,392,353,350,131,219
KUCUKCEKMECE,KEMALPASA MAH.,389,347,339,138,201
KUCUKCEKMECE,KEMALPASA MAH.,388,349,344,137,207
KUCUKCEKMECE,KEMALPASA MAH.,390,342,340,141,199
KUCUKCEKMECE,KEMALPASA MAH.,388,345,343,142,201
KUCUKCEKMECE,KEMALPASA MAH.,388,340,335,133,202
KUCUKCEKMECE,KEMALPASA MAH.,388,350,347,157,190
KUCUKCEKMECE,KEMALPASA MAH.,389,357,345,151,194
KUCUKCEKMECE,KEMALPASA MAH.,389,363,361,150,211
KUCUKCEKMECE,KEMALPASA MAH.,388,336,332,119,213
KUCUKCEKMECE,KEMALPASA MAH.,388,341,340,144,196
KUCUKCEKMECE,KEMALPASA MAH.,388,346,346,154,192
KUCUKCEKMECE,KEMALPASA MAH.,391,314,310,139,171
KUCUKCEKMECE,KEMALPASA MAH.,392,323,318,107,211
KUCUKCEKMECE,KEMALPASA MAH.,392,338,336,122,214
KUCUKCEKMECE,KEMALPASA MAH.,391,343,338,161,177
KUCUKCEKMECE,KEMALPASA MAH.,390,360,357,141,216
KUCUKCEKMECE,KEMALPASA MAH.,390,347,343,147,196
KUCUKCEKMECE,KEMALPASA MAH.,390,346,343,154,189
KUCUKCEKMECE,KEMALPASA MAH.,391,325,315,118,197
KUCUKCEKMECE,KEMALPASA MAH.,391,358,350,133,217
KUCUKCEKMECE,KEMALPASA MAH.,391,355,352,169,183
KUCUKCEKMECE,KEMALPASA MAH.,390,345,341,122,219
KUCUKCEKMECE,KEMALPASA MAH.,390,338,335,146,189
KUCUKCEKMECE,KEMALPASA MAH.,391,345,342,144,198
KUCUKCEKMECE,KEMALPASA MAH.,393,354,350,146,204
KUCUKCEKMECE,SOGUTLU CESME MAH.,409,325,316,159,157
KUCUKCEKMECE,SOGUTLU CESME MAH.,409,358,352,180,172
KUCUKCEKMECE,SOGUTLU CESME MAH.,412,357,349,210,139
KUCUKCEKMECE,SOGUTLU CESME MAH.,410,370,363,198,165
KUCUKCEKMECE,SOGUTLU CESME MAH.,408,356,349,201,148
KUCUKCEKMECE,SOGUTLU CESME MAH.,409,357,354,188,166
KUCUKCEKMECE,SOGUTLU CESME MAH.,409,361,358,219,139
KUCUKCEKMECE,SOGUTLU CESME MAH.,409,364,358,227,131
KUCUKCEKMECE,SOGUTLU CESME MAH.,409,371,364,200,164
KUCUKCEKMECE,SOGUTLU CESME MAH.,409,369,363,226,137
KUCUKCEKMECE,SOGUTLU CESME MAH.,409,358,354,224,130
KUCUKCEKMECE,SOGUTLU CESME MAH.,408,360,350,201,149
KUCUKCEKMECE,SOGUTLU CESME MAH.,408,353,346,214,132
KUCUKCEKMECE,SOGUTLU CESME MAH.,408,366,362,174,188
KUCUKCEKMECE,SOGUTLU CESME MAH.,408,358,354,187,167
KUCUKCEKMECE,SOGUTLU CESME MAH.,408,348,342,182,160
KUCUKCEKMECE,SOGUTLU CESME MAH.,408,347,341,192,149
KUCUKCEKMECE,SOGUTLU CESME MAH.,405,329,327,235,92
KUCUKCEKMECE,SOGUTLU CESME MAH.,399,325,315,195,120
KUCUKCEKMECE,SOGUTLU CESME MAH.,399,336,332,171,161
KUCUKCEKMECE,SOGUTLU CESME MAH.,402,347,337,191,146
KUCUKCEKMECE,SOGUTLU CESME MAH.,400,345,337,201,136
KUCUKCEKMECE,SOGUTLU CESME MAH.,402,366,357,201,156
KUCUKCEKMECE,SOGUTLU CESME MAH.,398,343,340,192,148
KUCUKCEKMECE,SOGUTLU CESME MAH.,398,330,325,188,137
KUCUKCEKMECE,SOGUTLU CESME MAH.,398,347,340,181,159
KUCUKCEKMECE,SOGUTLU CESME MAH.,398,336,333,190,143
KUCUKCEKMECE,SOGUTLU CESME MAH.,398,351,347,214,133
KUCUKCEKMECE,SOGUTLU CESME MAH.,398,342,339,190,149
KUCUKCEKMECE,SOGUTLU CESME MAH.,399,336,334,182,152
KUCUKCEKMECE,SOGUTLU CESME MAH.,399,344,334,206,128
KUCUKCEKMECE,SOGUTLU CESME MAH.,398,352,341,203,138
KUCUKCEKMECE,SOGUTLU CESME MAH.,399,347,344,197,147
KUCUKCEKMECE,SOGUTLU CESME MAH.,398,348,342,208,134
KUCUKCEKMECE,SOGUTLU CESME MAH.,399,351,347,187,160
KUCUKCEKMECE,SOGUTLU CESME MAH.,399,344,330,185,145
KUCUKCEKMECE,SOGUTLU CESME MAH.,398,358,354,202,152
KUCUKCEKMECE,SOGUTLU CESME MAH.,398,342,329,200,129
KUCUKCEKMECE,SOGUTLU CESME MAH.,399,351,340,194,146
KUCUKCEKMECE,SOGUTLU CESME MAH.,398,355,353,216,137
KUCUKCEKMECE,SOGUTLU CESME MAH.,406,334,323,203,120
KUCUKCEKMECE,SOGUTLU CESME MAH.,406,352,347,220,127
KUCUKCEKMECE,SOGUTLU CESME MAH.,405,356,351,198,153
KUCUKCEKMECE,SOGUTLU CESME MAH.,406,374,370,237,133
KUCUKCEKMECE,SOGUTLU CESME MAH.,407,372,369,206,163
KUCUKCEKMECE,SOGUTLU CESME MAH.,406,374,366,211,155
KUCUKCEKMECE,SOGUTLU CESME MAH.,406,357,353,219,134
KUCUKCEKMECE,SOGUTLU CESME MAH.,406,370,368,226,142
KUCUKCEKMECE,SOGUTLU CESME MAH.,406,363,358,226,132
KUCUKCEKMECE,SOGUTLU CESME MAH.,406,378,376,222,154
KUCUKCEKMECE,SOGUTLU CESME MAH.,406,365,355,191,164
KUCUKCEKMECE,SOGUTLU CESME MAH.,406,364,358,194,164
KUCUKCEKMECE,SOGUTLU CESME MAH.,406,366,357,212,145
KUCUKCEKMECE,SOGUTLU CESME MAH.,406,364,361,230,131
KUCUKCEKMECE,SOGUTLU CESME MAH.,407,372,366,230,136
KUCUKCEKMECE,SOGUTLU CESME MAH.,407,373,360,196,164
KUCUKCEKMECE,SOGUTLU CESME MAH.,407,352,345,195,150
KUCUKCEKMECE,SOGUTLU CESME MAH.,407,361,358,210,148
KUCUKCEKMECE,SULTAN MURAT MAH.,408,320,309,158,151
KUCUKCEKMECE,SULTAN MURAT MAH.,408,364,359,180,179
KUCUKCEKMECE,SULTAN MURAT MAH.,408,373,370,173,197
KUCUKCEKMECE,SULTAN MURAT MAH.,408,359,357,194,163
KUCUKCEKMECE,SULTAN MURAT MAH.,407,378,377,189,188
KUCUKCEKMECE,SULTAN MURAT MAH.,408,374,367,172,195
KUCUKCEKMECE,SULTAN MURAT MAH.,410,378,373,188,185
KUCUKCEKMECE,SULTAN MURAT MAH.,408,373,370,154,216
KUCUKCEKMECE,SULTAN MURAT MAH.,407,376,374,196,178
KUCUKCEKMECE,SULTAN MURAT MAH.,402,332,327,183,144
KUCUKCEKMECE,SULTAN MURAT MAH.,400,337,336,180,156
KUCUKCEKMECE,SULTAN MURAT MAH.,401,350,343,176,167
KUCUKCEKMECE,SULTAN MURAT MAH.,401,365,362,182,180
KUCUKCEKMECE,SULTAN MURAT MAH.,401,366,359,183,176
KUCUKCEKMECE,SULTAN MURAT MAH.,400,350,350,190,160
KUCUKCEKMECE,SULTAN MURAT MAH.,400,361,358,205,153
KUCUKCEKMECE,SULTAN MURAT MAH.,400,366,363,213,150
KUCUKCEKMECE,SULTAN MURAT MAH.,401,366,363,191,172
KUCUKCEKMECE,SULTAN MURAT MAH.,400,346,341,181,160
KUCUKCEKMECE,SULTAN MURAT MAH.,401,370,368,200,168
KUCUKCEKMECE,SULTAN MURAT MAH.,400,344,338,168,170
KUCUKCEKMECE,SULTAN MURAT MAH.,401,365,363,191,172
KUCUKCEKMECE,SULTAN MURAT MAH.,401,347,345,178,167
KUCUKCEKMECE,SULTAN MURAT MAH.,400,353,350,189,161
KUCUKCEKMECE,SULTAN MURAT MAH.,400,350,347,162,185
KUCUKCEKMECE,TEVFIKBEY MAH.,395,329,320,152,168
KUCUKCEKMECE,TEVFIKBEY MAH.,395,345,342,185,157
KUCUKCEKMECE,TEVFIKBEY MAH.,395,358,350,185,165
KUCUKCEKMECE,TEVFIKBEY MAH.,395,354,349,192,157
KUCUKCEKMECE,TEVFIKBEY MAH.,395,355,353,168,185
KUCUKCEKMECE,TEVFIKBEY MAH.,399,367,362,200,162
KUCUKCEKMECE,TEVFIKBEY MAH.,397,357,345,169,176
KUCUKCEKMECE,TEVFIKBEY MAH.,395,362,360,190,170
KUCUKCEKMECE,TEVFIKBEY MAH.,394,342,342,177,165
KUCUKCEKMECE,TEVFIKBEY MAH.,394,357,355,193,162
KUCUKCEKMECE,TEVFIKBEY MAH.,394,353,347,194,153
KUCUKCEKMECE,TEVFIKBEY MAH.,395,357,354,188,166
KUCUKCEKMECE,TEVFIKBEY MAH.,395,369,366,188,178
KUCUKCEKMECE,TEVFIKBEY MAH.,410,316,308,140,168
KUCUKCEKMECE,TEVFIKBEY MAH.,411,343,336,124,212
KUCUKCEKMECE,TEVFIKBEY MAH.,415,371,366,154,212
KUCUKCEKMECE,TEVFIKBEY MAH.,410,360,360,180,180
KUCUKCEKMECE,TEVFIKBEY MAH.,415,373,369,178,191
KUCUKCEKMECE,TEVFIKBEY MAH.,411,353,348,162,186
KUCUKCEKMECE,TEVFIKBEY MAH.,411,377,373,161,212
KUCUKCEKMECE,TEVFIKBEY MAH.,411,376,369,173,196
KUCUKCEKMECE,TEVFIKBEY MAH.,415,379,371,160,211
KUCUKCEKMECE,TEVFIKBEY MAH.,411,378,373,189,184
KUCUKCEKMECE,TEVFIKBEY MAH.,410,357,355,163,192
KUCUKCEKMECE,TEVFIKBEY MAH.,410,352,350,164,186
KUCUKCEKMECE,TEVFIKBEY MAH.,411,366,365,154,211
KUCUKCEKMECE,TEVFIKBEY MAH.,410,360,355,152,203
KUCUKCEKMECE,TEVFIKBEY MAH.,411,359,353,185,168
KUCUKCEKMECE,TEVFIKBEY MAH.,410,360,359,178,181
KUCUKCEKMECE,TEVFIKBEY MAH.,410,358,355,182,173
KUCUKCEKMECE,TEVFIKBEY MAH.,410,359,354,176,178
KUCUKCEKMECE,TEVFIKBEY MAH.,410,362,359,192,167
KUCUKCEKMECE,TEVFIKBEY MAH.,415,370,367,166,201
KUCUKCEKMECE,TEVFIKBEY MAH.,410,377,369,195,174
KUCUKCEKMECE,TEVFIKBEY MAH.,415,351,342,163,179
KUCUKCEKMECE,TEVFIKBEY MAH.,415,351,344,157,187
KUCUKCEKMECE,TEVFIKBEY MAH.,415,366,361,197,164
KUCUKCEKMECE,TEVFIKBEY MAH.,415,375,368,208,160
KUCUKCEKMECE,TEVFIKBEY MAH.,415,376,369,179,190
KUCUKCEKMECE,TEVFIKBEY MAH.,415,380,373,216,157
KUCUKCEKMECE,TEVFIKBEY MAH.,409,372,369,206,163
KUCUKCEKMECE,TEVFIKBEY MAH.,412,361,359,191,168
KUCUKCEKMECE,TEVFIKBEY MAH.,412,347,344,174,170
KUCUKCEKMECE,TEVFIKBEY MAH.,415,378,368,173,195
KUCUKCEKMECE,TEVFIKBEY MAH.,411,367,365,148,217
KUCUKCEKMECE,TEVFIKBEY MAH.,415,366,358,181,177
KUCUKCEKMECE,TEVFIKBEY MAH.,410,368,365,149,216
KUCUKCEKMECE,TEVFIKBEY MAH.,412,369,367,165,202
KUCUKCEKMECE,TEVFIKBEY MAH.,412,370,367,165,202
KUCUKCEKMECE,TEVFIKBEY MAH.,412,362,356,186,170
KUCUKCEKMECE,TEVFIKBEY MAH.,412,367,361,194,167
KUCUKCEKMECE,TEVFIKBEY MAH.,415,371,368,200,168
KUCUKCEKMECE,TEVFIKBEY MAH.,412,364,358,174,184
KUCUKCEKMECE,TEVFIKBEY MAH.,412,364,362,156,206
KUCUKCEKMECE,TEVFIKBEY MAH.,408,330,320,172,148
KUCUKCEKMECE,TEVFIKBEY MAH.,409,358,353,214,139
KUCUKCEKMECE,TEVFIKBEY MAH.,411,378,374,175,199
KUCUKCEKMECE,TEVFIKBEY MAH.,408,363,358,201,157
KUCUKCEKMECE,TEVFIKBEY MAH.,408,361,357,193,164
KUCUKCEKMECE,TEVFIKBEY MAH.,408,360,352,202,150
KUCUKCEKMECE,TEVFIKBEY MAH.,407,352,346,184,162
KUCUKCEKMECE,TEVFIKBEY MAH.,407,358,352,204,148
KUCUKCEKMECE,TEVFIKBEY MAH.,407,354,349,211,138
KUCUKCEKMECE,TEVFIKBEY MAH.,408,363,353,168,185
KUCUKCEKMECE,TEVFIKBEY MAH.,409,354,348,176,172
KUCUKCEKMECE,ATAKENT MAH.,398,355,351,98,253
KUCUKCEKMECE,ATAKENT MAH.,398,340,338,75,263
KUCUKCEKMECE,ATAKENT MAH.,398,359,355,78,277
KUCUKCEKMECE,ATAKENT MAH.,399,353,349,84,265
KUCUKCEKMECE,ATAKENT MAH.,399,357,353,81,272
KUCUKCEKMECE,ATAKENT MAH.,397,349,346,89,257
KUCUKCEKMECE,ATAKENT MAH.,398,350,347,95,252
KUCUKCEKMECE,ATAKENT MAH.,397,348,345,81,264
KUCUKCEKMECE,ATAKENT MAH.,398,346,344,84,260
KUCUKCEKMECE,ATAKENT MAH.,398,343,336,84,252
KUCUKCEKMECE,ATAKENT MAH.,397,340,337,73,264
KUCUKCEKMECE,ATAKENT MAH.,398,352,345,84,261
KUCUKCEKMECE,ATAKENT MAH.,398,356,355,71,284
KUCUKCEKMECE,ATAKENT MAH.,398,353,351,102,249
KUCUKCEKMECE,ATAKENT MAH.,397,353,352,83,269
KUCUKCEKMECE,ATAKENT MAH.,397,367,364,94,270
KUCUKCEKMECE,ATAKENT MAH.,398,376,371,96,275
KUCUKCEKMECE,ATAKENT MAH.,394,344,344,46,298
KUCUKCEKMECE,ATAKENT MAH.,395,366,364,65,299
KUCUKCEKMECE,ATAKENT MAH.,394,365,360,82,278
KUCUKCEKMECE,ATAKENT MAH.,394,361,356,54,302
KUCUKCEKMECE,ATAKENT MAH.,394,360,359,58,301
KUCUKCEKMECE,ATAKENT MAH.,396,367,365,78,287
KUCUKCEKMECE,ATAKENT MAH.,393,349,345,96,249
KUCUKCEKMECE,ATAKENT MAH.,394,364,363,47,316
KUCUKCEKMECE,ATAKENT MAH.,393,360,358,69,289
KUCUKCEKMECE,ATAKENT MAH.,393,365,362,76,286
KUCUKCEKMECE,ATAKENT MAH.,393,356,351,62,289
KUCUKCEKMECE,ATAKENT MAH.,393,371,368,50,318
KUCUKCEKMECE,ATAKENT MAH.,405,356,353,84,269
KUCUKCEKMECE,ATAKENT MAH.,405,381,375,97,278
KUCUKCEKMECE,ATAKENT MAH.,404,370,365,74,291
KUCUKCEKMECE,ATAKENT MAH.,404,379,379,121,258
KUCUKCEKMECE,ATAKENT MAH.,405,372,369,96,273
KUCUKCEKMECE,ATAKENT MAH.,404,382,378,112,266
KUCUKCEKMECE,ATAKENT MAH.,405,379,374,108,266
KUCUKCEKMECE,ATAKENT MAH.,405,380,375,73,302
KUCUKCEKMECE,ATAKENT MAH.,415,376,373,70,303
KUCUKCEKMECE,ATAKENT MAH.,412,383,381,54,327
KUCUKCEKMECE,ATAKENT MAH.,415,386,386,58,328
KUCUKCEKMECE,ATAKENT MAH.,415,380,375,72,303
KUCUKCEKMECE,ATAKENT MAH.,414,386,381,42,339
KUCUKCEKMECE,ATAKENT MAH.,410,384,378,75,303
KUCUKCEKMECE,ATAKENT MAH.,414,400,396,68,328
KUCUKCEKMECE,ATAKENT MAH.,414,384,381,68,313
KUCUKCEKMECE,ATAKENT MAH.,414,388,383,59,324
KUCUKCEKMECE,ATAKENT MAH.,414,388,383,47,336
KUCUKCEKMECE,ATAKENT MAH.,415,389,389,73,316
KUCUKCEKMECE,ATAKENT MAH.,415,375,371,60,311
KUCUKCEKMECE,ATAKENT MAH.,414,381,373,47,326
KUCUKCEKMECE,ATAKENT MAH.,414,372,370,53,317
KUCUKCEKMECE,ATAKENT MAH.,414,388,385,68,317
KUCUKCEKMECE,ATAKENT MAH.,415,374,369,62,307
KUCUKCEKMECE,ATAKENT MAH.,414,392,385,63,322
KUCUKCEKMECE,ATAKENT MAH.,414,375,370,45,325
KUCUKCEKMECE,ATAKENT MAH.,414,385,384,84,300
KUCUKCEKMECE,ATAKENT MAH.,412,353,350,82,268
KUCUKCEKMECE,ATAKENT MAH.,415,376,371,112,259
KUCUKCEKMECE,ATAKENT MAH.,413,358,356,123,233
KUCUKCEKMECE,ATAKENT MAH.,415,351,348,105,243
KUCUKCEKMECE,ATAKENT MAH.,412,359,353,109,244
KUCUKCEKMECE,ATAKENT MAH.,411,363,358,131,227
KUCUKCEKMECE,ATAKENT MAH.,411,369,364,128,236
KUCUKCEKMECE,ATAKENT MAH.,412,359,355,100,255
KUCUKCEKMECE,ATAKENT MAH.,411,363,359,104,255
KUCUKCEKMECE,ATAKENT MAH.,411,357,352,109,243
KUCUKCEKMECE,ATAKENT MAH.,412,366,359,128,231
KUCUKCEKMECE,ATAKENT MAH.,394,347,344,68,276
KUCUKCEKMECE,ATAKENT MAH.,393,339,330,121,209
KUCUKCEKMECE,ATAKENT MAH.,395,351,345,122,223
KUCUKCEKMECE,ATAKENT MAH.,394,348,344,124,220
KUCUKCEKMECE,ATAKENT MAH.,394,349,349,155,194
KUCUKCEKMECE,ATAKENT MAH.,395,343,340,123,217
KUCUKCEKMECE,ATAKENT MAH.,394,333,326,119,207
KUCUKCEKMECE,ATAKENT MAH.,395,334,329,128,201
KUCUKCEKMECE,ATAKENT MAH.,394,350,348,141,207
KUCUKCEKMECE,ATAKENT MAH.,394,348,342,127,215
KUCUKCEKMECE,ATAKENT MAH.,371,326,324,42,282
KUCUKCEKMECE,ATAKENT MAH.,371,344,340,59,281
KUCUKCEKMECE,ATAKENT MAH.,371,338,333,47,286
KUCUKCEKMECE,ATAKENT MAH.,371,320,318,49,269
KUCUKCEKMECE,ATAKENT MAH.,373,330,329,68,261
KUCUKCEKMECE,ATAKENT MAH.,371,339,338,66,272
KUCUKCEKMECE,ATAKENT MAH.,371,332,329,64,265
KUCUKCEKMECE,ATAKENT MAH.,371,344,342,60,282
KUCUKCEKMECE,ATAKENT MAH.,408,348,347,99,248
KUCUKCEKMECE,ATAKENT MAH.,406,354,352,119,233
KUCUKCEKMECE,ATAKENT MAH.,407,351,348,85,263
KUCUKCEKMECE,ATAKENT MAH.,406,358,355,82,273
KUCUKCEKMECE,ATAKENT MAH.,406,343,343,81,262
KUCUKCEKMECE,ATAKENT MAH.,406,344,341,83,258
KUCUKCEKMECE,ATAKENT MAH.,406,361,360,105,255
KUCUKCEKMECE,ATAKENT MAH.,406,348,346,91,255
KUCUKCEKMECE,ATAKENT MAH.,406,342,338,68,270
KUCUKCEKMECE,ATAKENT MAH.,406,347,347,106,241
KUCUKCEKMECE,ATAKENT MAH.,406,362,359,92,267
KUCUKCEKMECE,ATAKENT MAH.,406,355,354,82,272
KUCUKCEKMECE,ATAKENT MAH.,406,352,349,103,246
KUCUKCEKMECE,ATAKENT MAH.,406,323,321,77,244
KUCUKCEKMECE,ATAKENT MAH.,407,359,355,92,263
KUCUKCEKMECE,ATAKENT MAH.,406,356,354,85,269
KUCUKCEKMECE,ATAKENT MAH.,406,348,345,80,265
KUCUKCEKMECE,ATAKENT MAH.,408,364,360,77,283
KUCUKCEKMECE,ATAKENT MAH.,384,359,355,63,292
KUCUKCEKMECE,ATAKENT MAH.,385,356,355,52,303
KUCUKCEKMECE,ATAKENT MAH.,384,356,354,51,303
KUCUKCEKMECE,ATAKENT MAH.,385,362,360,49,311
KUCUKCEKMECE,ATAKENT MAH.,384,353,348,53,295
KUCUKCEKMECE,ATAKENT MAH.,386,357,356,56,300
KUCUKCEKMECE,ATAKENT MAH.,385,354,350,57,293
KUCUKCEKMECE,ATAKENT MAH.,385,365,363,38,325
KUCUKCEKMECE,ATAKENT MAH.,383,364,359,36,323
KUCUKCEKMECE,ATAKENT MAH.,385,365,361,55,306
KUCUKCEKMECE,ATAKENT MAH.,384,367,365,53,312
KUCUKCEKMECE,ATAKENT MAH.,385,368,363,46,317
KUCUKCEKMECE,ATAKENT MAH.,403,362,356,94,262
KUCUKCEKMECE,ATAKENT MAH.,402,382,377,102,275
KUCUKCEKMECE,ATAKENT MAH.,403,378,374,80,294
KUCUKCEKMECE,ATAKENT MAH.,404,394,387,79,308
KUCUKCEKMECE,ATAKENT MAH.,402,372,366,95,271
KUCUKCEKMECE,ATAKENT MAH.,403,372,370,94,276
KUCUKCEKMECE,ATAKENT MAH.,403,365,363,89,274
KUCUKCEKMECE,ATAKENT MAH.,403,373,370,100,270
KUCUKCEKMECE,ATAKENT MAH.,404,369,363,97,266
KUCUKCEKMECE,ATAKENT MAH.,403,375,368,99,269
KUCUKCEKMECE,ATAKENT MAH.,403,373,368,78,290
KUCUKCEKMECE,ATAKENT MAH.,404,379,375,77,298
KUCUKCEKMECE,ATAKENT MAH.,402,379,376,91,285
KUCUKCEKMECE,ATAKENT MAH.,403,378,377,89,288
KUCUKCEKMECE,ATAKENT MAH.,403,366,361,67,294
KUCUKCEKMECE,ATAKENT MAH.,410,352,350,119,231
KUCUKCEKMECE,ATAKENT MAH.,410,371,370,138,232
KUCUKCEKMECE,ATAKENT MAH.,410,371,367,139,228
KUCUKCEKMECE,ATAKENT MAH.,410,370,364,128,236
KUCUKCEKMECE,ATAKENT MAH.,410,370,365,121,244
KUCUKCEKMECE,ATAKENT MAH.,410,363,361,124,237
KUCUKCEKMECE,ATAKENT MAH.,411,364,359,110,249
KUCUKCEKMECE,ATAKENT MAH.,415,376,373,108,265
KUCUKCEKMECE,ATAKENT MAH.,411,366,365,119,246
KUCUKCEKMECE,ATAKENT MAH.,411,376,368,117,251
KUCUKCEKMECE,ATAKENT MAH.,410,374,367,115,252
KUCUKCEKMECE,ATAKENT MAH.,410,372,368,146,222
KUCUKCEKMECE,ATAKENT MAH.,410,381,380,111,269
KUCUKCEKMECE,ATAKENT MAH.,410,361,360,121,239
KUCUKCEKMECE,ATAKENT MAH.,411,364,360,110,250
KUCUKCEKMECE,ATAKENT MAH.,409,372,370,129,241
KUCUKCEKMECE,ATAKENT MAH.,411,371,368,134,234
KUCUKCEKMECE,ATAKENT MAH.,409,365,363,122,241
KUCUKCEKMECE,ATAKENT MAH.,409,364,361,126,235
KUCUKCEKMECE,ATAKENT MAH.,409,381,377,142,235
KUCUKCEKMECE,ATAKENT MAH.,415,380,374,120,254
KUCUKCEKMECE,ATAKENT MAH.,410,375,369,124,245
KUCUKCEKMECE,ATAKENT MAH.,409,375,371,123,248
KUCUKCEKMECE,ATATURK MAH.,358,300,290,168,122
KUCUKCEKMECE,ATATURK MAH.,360,306,303,150,153
KUCUKCEKMECE,ATATURK MAH.,361,306,301,203,98
KUCUKCEKMECE,ATATURK MAH.,402,355,352,175,177
KUCUKCEKMECE,ATATURK MAH.,402,349,348,171,177
KUCUKCEKMECE,ATATURK MAH.,404,366,357,157,200
KUCUKCEKMECE,ATATURK MAH.,403,364,355,154,201
KUCUKCEKMECE,ATATURK MAH.,403,344,342,161,181
KUCUKCEKMECE,ATATURK MAH.,402,362,360,145,215
KUCUKCEKMECE,ATATURK MAH.,400,355,352,146,206
KUCUKCEKMECE,ATATURK MAH.,400,338,333,141,192
KUCUKCEKMECE,ATATURK MAH.,403,351,342,147,195
KUCUKCEKMECE,ATATURK MAH.,405,358,348,151,197
KUCUKCEKMECE,ATATURK MAH.,401,364,361,159,202
KUCUKCEKMECE,ATATURK MAH.,402,333,325,144,181
KUCUKCEKMECE,ATATURK MAH.,401,349,345,160,185
KUCUKCEKMECE,ATATURK MAH.,402,368,354,150,204
KUCUKCEKMECE,ATATURK MAH.,402,350,340,158,182
KUCUKCEKMECE,ATATURK MAH.,402,360,354,173,181
KUCUKCEKMECE,ATATURK MAH.,402,354,348,135,213
KUCUKCEKMECE,ATATURK MAH.,401,351,348,163,185
KUCUKCEKMECE,ATATURK MAH.,401,347,343,176,167
KUCUKCEKMECE,ATATURK MAH.,402,366,358,143,215
KUCUKCEKMECE,ATATURK MAH.,402,342,334,148,186
KUCUKCEKMECE,ATATURK MAH.,401,359,356,152,204
KUCUKCEKMECE,ATATURK MAH.,402,362,362,129,233
KUCUKCEKMECE,ATATURK MAH.,402,356,351,165,186
KUCUKCEKMECE,ATATURK MAH.,407,335,328,196,132
KUCUKCEKMECE,ATATURK MAH.,406,351,347,198,149
KUCUKCEKMECE,ATATURK MAH.,407,360,354,221,133
KUCUKCEKMECE,ATATURK MAH.,407,362,360,235,125
KUCUKCEKMECE,ATATURK MAH.,407,357,351,201,150
KUCUKCEKMECE,ATATURK MAH.,410,344,339,208,131
KUCUKCEKMECE,ATATURK MAH.,407,363,357,208,149
KUCUKCEKMECE,ATATURK MAH.,407,370,364,209,155
KUCUKCEKMECE,ATATURK MAH.,407,357,353,223,130
KUCUKCEKMECE,ATATURK MAH.,407,346,339,224,115
KUCUKCEKMECE,ATATURK MAH.,407,354,348,219,129
KUCUKCEKMECE,ATATURK MAH.,408,363,359,234,125
KUCUKCEKMECE,ATATURK MAH.,407,366,362,207,155
KUCUKCEKMECE,ATATURK MAH.,407,351,348,208,140
KUCUKCEKMECE,ATATURK MAH.,407,353,351,210,141
KUCUKCEKMECE,ATATURK MAH.,405,367,361,220,141
KUCUKCEKMECE,ATATURK MAH.,407,357,348,195,153
KUCUKCEKMECE,ATATURK MAH.,405,353,350,212,138
KUCUKCEKMECE,ATATURK MAH.,405,364,364,237,127
KUCUKCEKMECE,ATATURK MAH.,405,371,365,218,147
KUCUKCEKMECE,ATATURK MAH.,406,355,349,220,129
KUCUKCEKMECE,ATATURK MAH.,404,360,345,124,221
KUCUKCEKMECE,ATATURK MAH.,402,359,355,134,221
KUCUKCEKMECE,ATATURK MAH.,400,360,355,130,225
KUCUKCEKMECE,ATATURK MAH.,401,345,339,127,212
KUCUKCEKMECE,ATATURK MAH.,401,363,356,153,203
KUCUKCEKMECE,ATATURK MAH.,401,358,356,158,198
KUCUKCEKMECE,ATATURK MAH.,402,372,362,129,233
KUCUKCEKMECE,ATATURK MAH.,400,367,363,129,234
KUCUKCEKMECE,ATATURK MAH.,400,356,353,123,230
KUCUKCEKMECE,ATATURK MAH.,401,368,364,136,228
KUCUKCEKMECE,ATATURK MAH.,400,357,353,132,221
KUCUKCEKMECE,ATATURK MAH.,400,355,352,119,233
KUCUKCEKMECE,ATATURK MAH.,400,361,354,144,210
KUCUKCEKMECE,ATATURK MAH.,401,363,359,137,222
KUCUKCEKMECE,ATATURK MAH.,401,357,354,136,218
KUCUKCEKMECE,ATATURK MAH.,401,364,359,148,211
KUCUKCEKMECE,ATATURK MAH.,401,352,344,127,217
KUCUKCEKMECE,ATATURK MAH.,400,358,352,150,202
KUCUKCEKMECE,ATATURK MAH.,401,366,358,137,221
KUCUKCEKMECE,ATATURK MAH.,400,362,356,120,236
KUCUKCEKMECE,ATATURK MAH.,401,350,346,114,232
KUCUKCEKMECE,ATATURK MAH.,401,361,355,136,219
KUCUKCEKMECE,ATATURK MAH.,401,342,332,122,210
KUCUKCEKMECE,ATATURK MAH.,401,344,337,118,219
KUCUKCEKMECE,ATATURK MAH.,400,355,353,119,234
KUCUKCEKMECE,ATATURK MAH.,401,367,359,152,207
KUCUKCEKMECE,ATATURK MAH.,401,347,341,128,213
KUCUKCEKMECE,HALKALI MERKEZ MAH.,415,337,330,139,191
KUCUKCEKMECE,HALKALI MERKEZ MAH.,412,359,345,165,180
KUCUKCEKMECE,HALKALI MERKEZ MAH.,412,379,367,161,206
KUCUKCEKMECE,HALKALI MERKEZ MAH.,415,372,367,145,222
KUCUKCEKMECE,HALKALI MERKEZ MAH.,415,372,362,175,187
KUCUKCEKMECE,HALKALI MERKEZ MAH.,412,372,369,160,209
KUCUKCEKMECE,HALKALI MERKEZ MAH.,415,365,360,156,204
KUCUKCEKMECE,HALKALI MERKEZ MAH.,415,355,353,167,186
KUCUKCEKMECE,HALKALI MERKEZ MAH.,412,376,368,162,206
KUCUKCEKMECE,HALKALI MERKEZ MAH.,411,370,366,172,194
KUCUKCEKMECE,HALKALI MERKEZ MAH.,412,372,367,180,187
KUCUKCEKMECE,HALKALI MERKEZ MAH.,411,379,370,198,172
KUCUKCEKMECE,HALKALI MERKEZ MAH.,413,365,359,179,180
KUCUKCEKMECE,HALKALI MERKEZ MAH.,407,312,304,122,182
KUCUKCEKMECE,HALKALI MERKEZ MAH.,407,298,290,117,173
KUCUKCEKMECE,HALKALI MERKEZ MAH.,406,348,344,145,199
KUCUKCEKMECE,HALKALI MERKEZ MAH.,407,352,339,127,212
KUCUKCEKMECE,HALKALI MERKEZ MAH.,407,368,363,148,215
KUCUKCEKMECE,HALKALI MERKEZ MAH.,405,358,352,163,189
KUCUKCEKMECE,HALKALI MERKEZ MAH.,407,352,345,148,197
KUCUKCEKMECE,HALKALI MERKEZ MAH.,407,370,364,155,209
KUCUKCEKMECE,HALKALI MERKEZ MAH.,408,352,348,143,205
KUCUKCEKMECE,HALKALI MERKEZ MAH.,407,345,342,140,202
KUCUKCEKMECE,HALKALI MERKEZ MAH.,406,353,349,120,229
KUCUKCEKMECE,HALKALI MERKEZ MAH.,408,348,347,126,221
KUCUKCEKMECE,HALKALI MERKEZ MAH.,406,347,344,150,194
KUCUKCEKMECE,HALKALI MERKEZ MAH.,406,353,349,128,221
KUCUKCEKMECE,HALKALI MERKEZ MAH.,406,352,348,127,221
KUCUKCEKMECE,HALKALI MERKEZ MAH.,407,373,371,159,212
KUCUKCEKMECE,HALKALI MERKEZ MAH.,407,346,344,127,217
KUCUKCEKMECE,HALKALI MERKEZ MAH.,407,354,349,132,217
KUCUKCEKMECE,HALKALI MERKEZ MAH.,406,345,340,130,210
KUCUKCEKMECE,HALKALI MERKEZ MAH.,406,347,339,142,197
KUCUKCEKMECE,HALKALI MERKEZ MAH.,407,356,350,156,194
KUCUKCEKMECE,HALKALI MERKEZ MAH.,407,355,349,152,197
KUCUKCEKMECE,HALKALI MERKEZ MAH.,407,358,351,159,192
KUCUKCEKMECE,HALKALI MERKEZ MAH.,407,353,349,148,201
KUCUKCEKMECE,HALKALI MERKEZ MAH.,406,364,353,157,196
KUCUKCEKMECE,HALKALI MERKEZ MAH.,407,348,340,150,190
KUCUKCEKMECE,HALKALI MERKEZ MAH.,406,359,351,134,217
KUCUKCEKMECE,HALKALI MERKEZ MAH.,407,366,360,151,209
KUCUKCEKMECE,HALKALI MERKEZ MAH.,405,344,339,134,205
KUCUKCEKMECE,HALKALI MERKEZ MAH.,406,348,344,131,213
KUCUKCEKMECE,HALKALI MERKEZ MAH.,406,351,343,141,202
KUCUKCEKMECE,HALKALI MERKEZ MAH.,405,351,347,154,193
KUCUKCEKMECE,HALKALI MERKEZ MAH.,408,351,348,146,202
KUCUKCEKMECE,HALKALI MERKEZ MAH.,406,357,350,142,208
KUCUKCEKMECE,HALKALI MERKEZ MAH.,407,364,362,136,226
KUCUKCEKMECE,HALKALI MERKEZ MAH.,408,351,340,171,169
KUCUKCEKMECE,HALKALI MERKEZ MAH.,407,346,335,128,207
KUCUKCEKMECE,HALKALI MERKEZ MAH.,408,357,354,137,217
KUCUKCEKMECE,HALKALI MERKEZ MAH.,415,354,346,148,198
KUCUKCEKMECE,HALKALI MERKEZ MAH.,408,361,359,160,199
KUCUKCEKMECE,HALKALI MERKEZ MAH.,408,335,328,144,184
KUCUKCEKMECE,HALKALI MERKEZ MAH.,409,336,335,145,190
KUCUKCEKMECE,HALKALI MERKEZ MAH.,407,346,344,142,202
KUCUKCEKMECE,HALKALI MERKEZ MAH.,407,344,336,118,218
KUCUKCEKMECE,HALKALI MERKEZ MAH.,407,353,343,138,205
KUCUKCEKMECE,HALKALI MERKEZ MAH.,407,347,344,160,184
KUCUKCEKMECE,HALKALI MERKEZ MAH.,408,356,356,190,166
KUCUKCEKMECE,HALKALI MERKEZ MAH.,408,359,357,170,187
KUCUKCEKMECE,HALKALI MERKEZ MAH.,409,371,367,147,220
KUCUKCEKMECE,HALKALI MERKEZ MAH.,407,355,352,147,205
KUCUKCEKMECE,HALKALI MERKEZ MAH.,408,366,356,135,221
KUCUKCEKMECE,HALKALI MERKEZ MAH.,407,370,369,153,216
KUCUKCEKMECE,HALKALI MERKEZ MAH.,406,358,354,151,203
KUCUKCEKMECE,HALKALI MERKEZ MAH.,380,345,340,69,271
KUCUKCEKMECE,HALKALI MERKEZ MAH.,380,357,351,71,280
KUCUKCEKMECE,HALKALI MERKEZ MAH.,380,346,343,63,280
KUCUKCEKMECE,HALKALI MERKEZ MAH.,380,359,359,60,299
KUCUKCEKMECE,HALKALI MERKEZ MAH.,379,363,356,90,266
KUCUKCEKMECE,HALKALI MERKEZ MAH.,380,358,353,64,289
KUCUKCEKMECE,HALKALI MERKEZ MAH.,379,356,354,76,278
KUCUKCEKMECE,HALKALI MERKEZ MAH.,380,369,365,70,295
KUCUKCEKMECE,HALKALI MERKEZ MAH.,380,364,362,64,298
KUCUKCEKMECE,HALKALI MERKEZ MAH.,380,356,351,78,273
KUCUKCEKMECE,HALKALI MERKEZ MAH.,385,344,336,165,171
KUCUKCEKMECE,HALKALI MERKEZ MAH.,387,358,358,122,236
KUCUKCEKMECE,HALKALI MERKEZ MAH.,383,339,332,115,217
KUCUKCEKMECE,HALKALI MERKEZ MAH.,385,352,346,129,217
KUCUKCEKMECE,HALKALI MERKEZ MAH.,384,358,354,116,238
KUCUKCEKMECE,HALKALI MERKEZ MAH.,384,337,332,107,225
KUCUKCEKMECE,HALKALI MERKEZ MAH.,385,349,344,100,244
KUCUKCEKMECE,HALKALI MERKEZ MAH.,385,355,352,106,246
KUCUKCEKMECE,HALKALI MERKEZ MAH.,385,350,348,132,216
KUCUKCEKMECE,HALKALI MERKEZ MAH.,384,341,330,106,224
KUCUKCEKMECE,HALKALI MERKEZ MAH.,385,354,349,111,238
KUCUKCEKMECE,HALKALI MERKEZ MAH.,384,350,350,97,253
KUCUKCEKMECE,HALKALI MERKEZ MAH.,400,328,321,151,170
KUCUKCEKMECE,HALKALI MERKEZ MAH.,400,345,341,188,153
KUCUKCEKMECE,HALKALI MERKEZ MAH.,400,346,341,169,172
KUCUKCEKMECE,HALKALI MERKEZ MAH.,400,357,352,168,184
KUCUKCEKMECE,HALKALI MERKEZ MAH.,401,360,355,167,188
KUCUKCEKMECE,HALKALI MERKEZ MAH.,400,324,319,128,191
KUCUKCEKMECE,HALKALI MERKEZ MAH.,401,350,343,156,187
KUCUKCEKMECE,HALKALI MERKEZ MAH.,400,364,357,179,178
KUCUKCEKMECE,HALKALI MERKEZ MAH.,399,366,365,166,199
KUCUKCEKMECE,HALKALI MERKEZ MAH.,399,358,354,173,181
KUCUKCEKMECE,HALKALI MERKEZ MAH.,399,364,359,184,175
KUCUKCEKMECE,HALKALI MERKEZ MAH.,400,354,352,193,159
KUCUKCEKMECE,HALKALI MERKEZ MAH.,400,345,337,193,144
KUCUKCEKMECE,HALKALI MERKEZ MAH.,401,371,366,197,169
KUCUKCEKMECE,HALKALI MERKEZ MAH.,400,349,345,191,154
KUCUKCEKMECE,HALKALI MERKEZ MAH.,400,364,359,203,156
KUCUKCEKMECE,HALKALI MERKEZ MAH.,400,358,353,179,174
KUCUKCEKMECE,HALKALI MERKEZ MAH.,400,342,341,181,160
KUCUKCEKMECE,HALKALI MERKEZ MAH.,402,351,341,208,133
KUCUKCEKMECE,HALKALI MERKEZ MAH.,399,359,355,196,159
KUCUKCEKMECE,HALKALI MERKEZ MAH.,400,354,345,177,168
KUCUKCEKMECE,HALKALI MERKEZ MAH.,403,356,351,189,162
KUCUKCEKMECE,HALKALI MERKEZ MAH.,406,333,321,124,197
KUCUKCEKMECE,HALKALI MERKEZ MAH.,406,334,324,138,186
KUCUKCEKMECE,HALKALI MERKEZ MAH.,406,340,338,167,171
KUCUKCEKMECE,HALKALI MERKEZ MAH.,407,350,343,159,184
KUCUKCEKMECE,HALKALI MERKEZ MAH.,406,351,346,176,170
KUCUKCEKMECE,HALKALI MERKEZ MAH.,407,354,353,150,203
KUCUKCEKMECE,HALKALI MERKEZ MAH.,406,356,350,160,190
KUCUKCEKMECE,HALKALI MERKEZ MAH.,406,349,347,141,206
KUCUKCEKMECE,HALKALI MERKEZ MAH.,406,338,332,140,192
KUCUKCEKMECE,HALKALI MERKEZ MAH.,406,357,349,141,208
KUCUKCEKMECE,HALKALI MERKEZ MAH.,407,355,350,158,192
KUCUKCEKMECE,HALKALI MERKEZ MAH.,406,356,351,146,205
KUCUKCEKMECE,HALKALI MERKEZ MAH.,407,349,340,152,188
KUCUKCEKMECE,HALKALI MERKEZ MAH.,408,352,348,172,176
KUCUKCEKMECE,HALKALI MERKEZ MAH.,407,356,352,167,185
KUCUKCEKMECE,HALKALI MERKEZ MAH.,407,347,344,145,199
KUCUKCEKMECE,HALKALI MERKEZ MAH.,405,356,354,133,221
KUCUKCEKMECE,HALKALI MERKEZ MAH.,406,352,345,159,186
KUCUKCEKMECE,HALKALI MERKEZ MAH.,406,336,332,134,198
KUCUKCEKMECE,HALKALI MERKEZ MAH.,406,370,365,174,191
KUCUKCEKMECE,HALKALI MERKEZ MAH.,407,354,350,141,209
KUCUKCEKMECE,MEHMET AKIF MAH.,415,339,328,187,141
KUCUKCEKMECE,MEHMET AKIF MAH.,415,364,359,214,145
KUCUKCEKMECE,MEHMET AKIF MAH.,411,365,358,212,146
KUCUKCEKMECE,MEHMET AKIF MAH.,415,372,365,213,152
KUCUKCEKMECE,MEHMET AKIF MAH.,415,362,353,207,146
KUCUKCEKMECE,MEHMET AKIF MAH.,415,375,371,200,171
KUCUKCEKMECE,MEHMET AKIF MAH.,411,351,344,193,151
KUCUKCEKMECE,MEHMET AKIF MAH.,411,369,364,194,170
KUCUKCEKMECE,MEHMET AKIF MAH.,411,362,358,219,139
KUCUKCEKMECE,MEHMET AKIF MAH.,409,357,354,220,134
KUCUKCEKMECE,MEHMET AKIF MAH.,415,334,329,173,156
KUCUKCEKMECE,MEHMET AKIF MAH.,415,370,363,203,160
KUCUKCEKMECE,MEHMET AKIF MAH.,410,370,360,196,164
KUCUKCEKMECE,MEHMET AKIF MAH.,413,364,359,188,171
KUCUKCEKMECE,MEHMET AKIF MAH.,409,363,354,194,160
KUCUKCEKMECE,MEHMET AKIF MAH.,411,363,362,218,144
KUCUKCEKMECE,MEHMET AKIF MAH.,410,365,363,226,137
KUCUKCEKMECE,MEHMET AKIF MAH.,410,358,353,195,158
KUCUKCEKMECE,MEHMET AKIF MAH.,411,368,365,194,171
KUCUKCEKMECE,MEHMET AKIF MAH.,411,370,360,212,148
KUCUKCEKMECE,MEHMET AKIF MAH.,412,374,368,183,185
KUCUKCEKMECE,MEHMET AKIF MAH.,412,371,368,191,177
KUCUKCEKMECE,MEHMET AKIF MAH.,412,354,350,194,156
KUCUKCEKMECE,MEHMET AKIF MAH.,412,354,352,199,153
KUCUKCEKMECE,MEHMET AKIF MAH.,411,370,358,204,154
KUCUKCEKMECE,MEHMET AKIF MAH.,412,376,371,203,168
KUCUKCEKMECE,MEHMET AKIF MAH.,415,340,336,137,199
KUCUKCEKMECE,MEHMET AKIF MAH.,412,347,342,181,161
KUCUKCEKMECE,MEHMET AKIF MAH.,415,369,360,196,164
KUCUKCEKMECE,MEHMET AKIF MAH.,411,370,357,199,158
KUCUKCEKMECE,MEHMET AKIF MAH.,412,378,369,190,179
KUCUKCEKMECE,MEHMET AKIF MAH.,412,373,368,203,165
KUCUKCEKMECE,MEHMET AKIF MAH.,415,370,368,200,168
KUCUKCEKMECE,MEHMET AKIF MAH.,415,361,356,172,184
KUCUKCEKMECE,MEHMET AKIF MAH.,412,366,364,194,170
KUCUKCEKMECE,MEHMET AKIF MAH.,415,371,366,193,173
KUCUKCEKMECE,MEHMET AKIF MAH.,412,359,358,192,166
KUCUKCEKMECE,MEHMET AKIF MAH.,415,378,369,193,176
KUCUKCEKMECE,MEHMET AKIF MAH.,415,374,369,199,170
KUCUKCEKMECE,MEHMET AKIF MAH.,412,365,357,175,182
KUCUKCEKMECE,MEHMET AKIF MAH.,412,351,343,179,164
KUCUKCEKMECE,MEHMET AKIF MAH.,415,366,365,173,192
KUCUKCEKMECE,MEHMET AKIF MAH.,411,370,363,224,139
KUCUKCEKMECE,MEHMET AKIF MAH.,412,370,368,209,159
KUCUKCEKMECE,MEHMET AKIF MAH.,411,380,375,202,173
KUCUKCEKMECE,MEHMET AKIF MAH.,411,357,352,201,151
KUCUKCEKMECE,MEHMET AKIF MAH.,412,351,348,223,125
KUCUKCEKMECE,MEHMET AKIF MAH.,412,367,359,205,154
KUCUKCEKMECE,MEHMET AKIF MAH.,412,356,348,207,141
KUCUKCEKMECE,MEHMET AKIF MAH.,411,381,374,220,154
KUCUKCEKMECE,MEHMET AKIF MAH.,412,382,374,196,178
KUCUKCEKMECE,MEHMET AKIF MAH.,412,370,364,179,185
KUCUKCEKMECE,MEHMET AKIF MAH.,411,369,359,178,181
KUCUKCEKMECE,MEHMET AKIF MAH.,411,382,377,203,174
KUCUKCEKMECE,MEHMET AKIF MAH.,412,363,356,212,144
KUCUKCEKMECE,MEHMET AKIF MAH.,412,375,368,184,184
KUCUKCEKMECE,MEHMET AKIF MAH.,411,368,361,208,153
KUCUKCEKMECE,MEHMET AKIF MAH.,411,364,355,200,155
KUCUKCEKMECE,MEHMET AKIF MAH.,411,357,355,215,140
KUCUKCEKMECE,MEHMET AKIF MAH.,412,366,361,191,170
KUCUKCEKMECE,MEHMET AKIF MAH.,411,369,366,203,163
KUCUKCEKMECE,MEHMET AKIF MAH.,412,373,370,216,154
KUCUKCEKMECE,MEHMET AKIF MAH.,415,366,362,213,149
KUCUKCEKMECE,MEHMET AKIF MAH.,412,357,348,181,167
KUCUKCEKMECE,MEHMET AKIF MAH.,412,368,357,203,154
KUCUKCEKMECE,MEHMET AKIF MAH.,411,353,348,192,156
KUCUKCEKMECE,MEHMET AKIF MAH.,412,369,362,196,166
KUCUKCEKMECE,MEHMET AKIF MAH.,415,355,350,197,153
KUCUKCEKMECE,MEHMET AKIF MAH.,415,388,382,237,145
KUCUKCEKMECE,MEHMET AKIF MAH.,415,370,365,235,130
KUCUKCEKMECE,MEHMET AKIF MAH.,415,386,381,232,149
KUCUKCEKMECE,MEHMET AKIF MAH.,415,373,369,207,162
KUCUKCEKMECE,MEHMET AKIF MAH.,416,380,376,256,120
KUCUKCEKMECE,MEHMET AKIF MAH.,416,376,371,264,107
KUCUKCEKMECE,MEHMET AKIF MAH.,415,369,364,236,128
KUCUKCEKMECE,MEHMET AKIF MAH.,415,366,358,214,144
KUCUKCEKMECE,MEHMET AKIF MAH.,415,364,359,233,126
KUCUKCEKMECE,MEHMET AKIF MAH.,415,361,351,209,142
KUCUKCEKMECE,MEHMET AKIF MAH.,415,372,369,221,148
KUCUKCEKMECE,MEHMET AKIF MAH.,414,384,380,243,137
KUCUKCEKMECE,MEHMET AKIF MAH.,414,391,386,247,139
KUCUKCEKMECE,MEHMET AKIF MAH.,415,374,371,228,143
KUCUKCEKMECE,MEHMET AKIF MAH.,415,365,359,214,145
KUCUKCEKMECE,MEHMET AKIF MAH.,415,387,382,253,129
KUCUKCEKMECE,MEHMET AKIF MAH.,415,370,366,248,118
KUCUKCEKMECE,MEHMET AKIF MAH.,415,368,363,240,123
KUCUKCEKMECE,MEHMET AKIF MAH.,415,377,370,237,133
KUCUKCEKMECE,MEHMET AKIF MAH.,415,385,378,242,136
KUCUKCEKMECE,MEHMET AKIF MAH.,415,364,354,208,146
KUCUKCEKMECE,MEHMET AKIF MAH.,415,376,371,243,128
KUCUKCEKMECE,YARIMBURGAZ MAH.,399,341,332,174,158
KUCUKCEKMECE,YARIMBURGAZ MAH.,399,333,328,187,141
KUCUKCEKMECE,YARIMBURGAZ MAH.,401,346,344,199,145
KUCUKCEKMECE,YARIMBURGAZ MAH.,400,342,339,227,112
KUCUKCEKMECE,YARIMBURGAZ MAH.,399,335,327,198,129
KUCUKCEKMECE,YARIMBURGAZ MAH.,398,359,355,203,152
KUCUKCEKMECE,YARIMBURGAZ MAH.,401,350,345,205,140
KUCUKCEKMECE,YARIMBURGAZ MAH.,398,359,358,209,149
KUCUKCEKMECE,YARIMBURGAZ MAH.,396,343,341,220,121
KUCUKCEKMECE,YARIMBURGAZ MAH.,396,356,351,228,123
KUCUKCEKMECE,YARIMBURGAZ MAH.,398,342,337,215,122
KUCUKCEKMECE,YARIMBURGAZ MAH.,396,346,342,214,128
KUCUKCEKMECE,YARIMBURGAZ MAH.,395,347,340,202,138
KUCUKCEKMECE,YARIMBURGAZ MAH.,396,347,343,211,132
KUCUKCEKMECE,YARIMBURGAZ MAH.,396,355,348,210,138
KUCUKCEKMECE,YARIMBURGAZ MAH.,397,352,345,193,152
KUCUKCEKMECE,YARIMBURGAZ MAH.,398,359,353,235,118
SILE,AGACDERE MAH.,86,86,85,66,19
SILE,AGVA MERKEZ MAH.,387,326,325,144,181
SILE,AGVA MERKEZ MAH.,388,340,335,171,164
SILE,AGVA MERKEZ MAH.,389,342,337,163,174
SILE,AGVA MERKEZ MAH.,388,340,333,153,180
SILE,AHMETLI MAH.,414,383,379,205,174
SILE,AHMETLI MAH.,414,364,356,207,149
SILE,AHMETLI MAH.,415,373,369,194,175
SILE,AKCAKESE MAH.,347,310,305,136,169
SILE,ALACALI MAH.,226,198,197,130,67
SILE,ALACALI MAH.,225,201,197,116,81
SILE,AVCIKORU MAH.,86,85,85,62,23
SILE,BALIBEY MAH.,413,359,355,107,248
SILE,BALIBEY MAH.,413,377,372,129,243
SILE,BALIBEY MAH.,413,361,359,145,214
SILE,BALIBEY MAH.,415,368,366,154,212
SILE,BALIBEY MAH.,411,367,360,112,248
SILE,BICKIDERE MAH.,214,202,195,143,52
SILE,BOZGOCA MAH.,96,90,89,54,35
SILE,BUCAKLI MAH.,282,240,239,177,62
SILE,CATAKLI MAH.,188,171,169,113,56
SILE,CAVUS MAH.,389,325,317,124,193
SILE,CAVUS MAH.,388,342,335,120,215
SILE,CAVUS MAH.,388,346,340,139,201
SILE,CAVUS MAH.,389,344,341,133,208
SILE,CAVUS MAH.,388,341,338,120,218
SILE,CAVUS MAH.,388,345,339,143,196
SILE,CAVUS MAH.,389,347,343,156,187
SILE,CAVUS MAH.,389,330,324,135,189
SILE,CAVUS MAH.,412,336,332,107,225
SILE,CAVUS MAH.,413,372,363,143,220
SILE,CAVUS MAH.,413,353,350,151,199
SILE,CAVUS MAH.,412,350,344,177,167
SILE,CAVUS MAH.,412,374,369,137,232
SILE,CAVUS MAH.,412,361,353,138,215
SILE,CAVUS MAH.,413,352,346,102,244
SILE,CAVUS MAH.,413,365,364,134,230
SILE,CAYIRBASI MAH.,346,320,315,153,162
SILE,CAYIRBASI MAH.,347,301,296,130,166
SILE,CELEBI MAH.,138,134,132,98,34
SILE,CENGILLI MAH.,159,143,140,91,49
SILE,DARLIK MAH.,89,90,90,81,9
SILE,DEGIRMENCAYIRI MAH.,361,338,330,231,99
SILE,DOGANCILI MAH.,297,263,259,166,93
SILE,DOGANCILI MAH.,296,265,261,139,122
SILE,ERENLER MAH.,92,90,90,41,49
SILE,ESENCELI MAH.,60,61,58,46,12
SILE,GEREDELI MAH.,264,217,207,149,58
SILE,GEREDELI MAH.,263,245,241,174,67
SILE,GOCE MAH.,261,217,210,128,82
SILE,GOCE MAH.,261,239,228,150,78
SILE,GOKMASLI MAH.,171,149,146,71,75
SILE,GOKSU MAH.,275,240,235,135,100
SILE,HACI KASIM MAH.,389,319,314,99,215
SILE,HACI KASIM MAH.,390,345,341,117,224
SILE,HACILLI MAH.,199,184,178,127,51
SILE,HASANLI MAH.,191,179,175,126,49
SILE,IMRENDERE MAH.,216,198,197,88,109
SILE,IMRENLI MAH.,228,211,207,114,93
SILE,ISAKOY MAH.,124,113,111,63,48
SILE,KABAKOZ MAH.,240,207,203,131,72
SILE,KABAKOZ MAH.,241,215,212,120,92
SILE,KADIKOY MAH.,148,141,139,105,34
SILE,KALEM MAH.,185,170,166,91,75
SILE,KARABEYLI MAH.,190,171,169,125,44
SILE,KARACAKOY MAH.,234,210,206,86,120
SILE,KARAKIRAZ MAH.,249,232,230,118,112
SILE,KARAMANDERE MAH.,248,228,223,118,105
SILE,KERVANSARAY MAH.,233,219,206,169,37
SILE,KIZILCA MAH.,209,194,193,101,92
SILE,KIZILCA MAH.,208,194,193,113,80
SILE,KORUCU MAH.,178,158,153,95,58
SILE,KOMURLUK MAH.,185,180,167,141,26
SILE,KUMBABA MAH.,271,240,236,90,146
SILE,KUMBABA MAH.,270,239,238,80,158
SILE,KURFALLI MAH.,227,206,203,108,95
SILE,KURNA MAH.,128,114,113,86,27
SILE,MESRUTIYET MAH.,332,304,303,104,199
SILE,ORUCOGLU MAH.,294,282,269,214,55
SILE,OSMANKOY MAH.,209,200,197,147,50
SILE,OVACIK MAH.,110,105,103,59,44
SILE,SAHILKOY MAH.,321,282,280,144,136
SILE,SAHILKOY MAH.,321,286,280,139,141
SILE,SATMAZLI MAH.,284,248,244,129,115
SILE,SOFULAR MAH.,246,221,214,125,89
SILE,SOGULLU MAH.,167,150,150,81,69
SILE,SORTULLU MAH.,86,78,76,53,23
SILE,SUAYIPLI MAH.,218,196,193,94,99
SILE,TEKE MAH.,392,359,345,197,148
SILE,ULUPELIT MAH.,141,132,131,98,33
SILE,UVEZLI MAH.,271,246,229,191,38
SILE,YAKA MAH.,162,153,149,114,35
SILE,YAYLALI MAH.,57,53,53,36,17
SILE,YAZIMANAYIR MAH.,184,174,172,144,28
SILE,YENIKOY MAH.,325,304,298,134,164
SILE,YESILVADI MAH.,123,114,113,48,65
USKUDAR,AHMEDIYE MAH.,393,305,299,106,193
USKUDAR,AHMEDIYE MAH.,391,303,294,90,204
USKUDAR,AHMEDIYE MAH.,391,340,335,101,234
USKUDAR,AHMEDIYE MAH.,392,354,351,126,225
USKUDAR,AHMEDIYE MAH.,391,341,334,96,238
USKUDAR,AHMEDIYE MAH.,391,350,348,84,264
USKUDAR,AHMEDIYE MAH.,391,351,342,100,242
USKUDAR,AHMEDIYE MAH.,392,357,352,141,211
USKUDAR,AHMEDIYE MAH.,392,344,336,108,228
USKUDAR,AHMEDIYE MAH.,391,349,346,109,237
USKUDAR,AHMEDIYE MAH.,391,364,359,93,266
USKUDAR,AHMEDIYE MAH.,391,359,356,109,247
USKUDAR,AHMEDIYE MAH.,391,308,303,127,176
USKUDAR,AHMEDIYE MAH.,390,334,331,152,179
USKUDAR,AHMEDIYE MAH.,391,354,352,136,216
USKUDAR,AHMEDIYE MAH.,391,343,339,133,206
USKUDAR,AHMEDIYE MAH.,392,327,318,147,171
USKUDAR,AHMEDIYE MAH.,391,331,326,126,200
USKUDAR,AHMEDIYE MAH.,390,347,342,146,196
USKUDAR,AHMEDIYE MAH.,391,346,341,126,215
USKUDAR,AZIZ MAHMUT HUDAYI MAH.,359,296,288,81,207
USKUDAR,AZIZ MAHMUT HUDAYI MAH.,358,320,315,104,211
USKUDAR,AZIZ MAHMUT HUDAYI MAH.,359,325,316,105,211
USKUDAR,AZIZ MAHMUT HUDAYI MAH.,359,324,319,127,192
USKUDAR,AZIZ MAHMUT HUDAYI MAH.,360,323,317,109,208
USKUDAR,AZIZ MAHMUT HUDAYI MAH.,403,324,316,102,214
USKUDAR,AZIZ MAHMUT HUDAYI MAH.,402,334,330,111,219
USKUDAR,AZIZ MAHMUT HUDAYI MAH.,402,326,325,124,201
USKUDAR,AZIZ MAHMUT HUDAYI MAH.,402,358,352,146,206
USKUDAR,AZIZ MAHMUT HUDAYI MAH.,402,368,361,120,241
USKUDAR,AZIZ MAHMUT HUDAYI MAH.,403,362,359,141,218
USKUDAR,AZIZ MAHMUT HUDAYI MAH.,402,369,365,135,230
USKUDAR,AZIZ MAHMUT HUDAYI MAH.,404,361,357,126,231
USKUDAR,AZIZ MAHMUT HUDAYI MAH.,403,361,355,139,216
USKUDAR,AZIZ MAHMUT HUDAYI MAH.,401,357,352,123,229
USKUDAR,AZIZ MAHMUT HUDAYI MAH.,402,343,337,134,203
USKUDAR,AZIZ MAHMUT HUDAYI MAH.,403,355,351,122,229
USKUDAR,AZIZ MAHMUT HUDAYI MAH.,403,365,363,133,230
USKUDAR,AZIZ MAHMUT HUDAYI MAH.,403,357,354,120,234
USKUDAR,ICADIYE MAH.,405,304,299,82,217
USKUDAR,ICADIYE MAH.,405,334,330,94,236
USKUDAR,ICADIYE MAH.,405,335,325,80,245
USKUDAR,ICADIYE MAH.,408,373,362,95,267
USKUDAR,ICADIYE MAH.,406,357,352,107,245
USKUDAR,ICADIYE MAH.,404,363,359,124,235
USKUDAR,ICADIYE MAH.,405,372,370,116,254
USKUDAR,ICADIYE MAH.,405,376,374,132,242
USKUDAR,ICADIYE MAH.,405,366,358,113,245
USKUDAR,ICADIYE MAH.,404,408,350,120,230
USKUDAR,ICADIYE MAH.,404,371,365,112,253
USKUDAR,ICADIYE MAH.,405,363,358,101,257
USKUDAR,ICADIYE MAH.,405,362,358,106,252
USKUDAR,ICADIYE MAH.,405,368,362,107,255
USKUDAR,ICADIYE MAH.,405,376,372,125,247
USKUDAR,ICADIYE MAH.,404,361,358,106,252
USKUDAR,ICADIYE MAH.,405,364,361,113,248
USKUDAR,ICADIYE MAH.,405,365,362,107,255
USKUDAR,ICADIYE MAH.,338,292,284,122,162
USKUDAR,ICADIYE MAH.,338,287,281,112,169
USKUDAR,ICADIYE MAH.,338,311,305,107,198
USKUDAR,ICADIYE MAH.,338,310,308,114,194
USKUDAR,ICADIYE MAH.,387,310,308,89,219
USKUDAR,ICADIYE MAH.,387,302,300,86,214
USKUDAR,ICADIYE MAH.,387,335,329,96,233
USKUDAR,ICADIYE MAH.,388,357,355,124,231
USKUDAR,ICADIYE MAH.,391,358,357,148,209
USKUDAR,ICADIYE MAH.,386,355,353,120,233
USKUDAR,ICADIYE MAH.,386,339,335,99,236
USKUDAR,ICADIYE MAH.,387,350,344,131,213
USKUDAR,ICADIYE MAH.,387,351,349,119,230
USKUDAR,ICADIYE MAH.,386,345,340,111,229
USKUDAR,ICADIYE MAH.,386,353,350,110,240
USKUDAR,ICADIYE MAH.,387,350,349,119,230
USKUDAR,ICADIYE MAH.,387,352,347,94,253
USKUDAR,ICADIYE MAH.,387,365,363,132,231
USKUDAR,KUZGUNCUK  MAH.,393,323,319,89,230
USKUDAR,KUZGUNCUK  MAH.,393,336,329,122,207
USKUDAR,KUZGUNCUK  MAH.,392,352,346,118,228
USKUDAR,KUZGUNCUK  MAH.,392,364,359,99,260
USKUDAR,KUZGUNCUK  MAH.,393,364,361,106,255
USKUDAR,KUZGUNCUK  MAH.,392,360,354,78,276
USKUDAR,KUZGUNCUK  MAH.,394,352,347,98,249
USKUDAR,KUZGUNCUK  MAH.,392,342,339,75,264
USKUDAR,KUZGUNCUK  MAH.,393,358,350,109,241
USKUDAR,MIMAR SINAN MAH.,405,315,311,160,151
USKUDAR,MIMAR SINAN MAH.,405,337,332,174,158
USKUDAR,MIMAR SINAN MAH.,404,351,350,216,134
USKUDAR,MIMAR SINAN MAH.,405,361,355,198,157
USKUDAR,MIMAR SINAN MAH.,404,344,343,183,160
USKUDAR,MIMAR SINAN MAH.,406,349,344,181,163
USKUDAR,MIMAR SINAN MAH.,405,356,347,179,168
USKUDAR,MIMAR SINAN MAH.,359,306,298,130,168
USKUDAR,MIMAR SINAN MAH.,359,306,300,122,178
USKUDAR,MIMAR SINAN MAH.,359,317,311,138,173
USKUDAR,MIMAR SINAN MAH.,359,310,304,127,177
USKUDAR,MIMAR SINAN MAH.,359,310,306,140,166
USKUDAR,MIMAR SINAN MAH.,372,304,298,159,139
USKUDAR,MIMAR SINAN MAH.,373,332,320,156,164
USKUDAR,MIMAR SINAN MAH.,372,321,320,145,175
USKUDAR,MIMAR SINAN MAH.,372,320,316,164,152
USKUDAR,MIMAR SINAN MAH.,371,334,329,165,164
USKUDAR,MIMAR SINAN MAH.,370,325,321,164,157
USKUDAR,MIMAR SINAN MAH.,415,338,335,183,152
USKUDAR,MIMAR SINAN MAH.,411,380,376,148,228
USKUDAR,MIMAR SINAN MAH.,415,360,358,140,218
USKUDAR,MIMAR SINAN MAH.,411,356,347,141,206
USKUDAR,MIMAR SINAN MAH.,412,364,363,131,232
USKUDAR,MIMAR SINAN MAH.,413,353,349,162,187
USKUDAR,MIMAR SINAN MAH.,410,363,355,170,185
USKUDAR,MURATREIS MAH.,383,302,295,97,198
USKUDAR,MURATREIS MAH.,383,328,320,112,208
USKUDAR,MURATREIS MAH.,384,343,340,117,223
USKUDAR,MURATREIS MAH.,383,349,341,120,221
USKUDAR,MURATREIS MAH.,384,340,336,126,210
USKUDAR,MURATREIS MAH.,383,351,350,123,227
USKUDAR,MURATREIS MAH.,384,343,339,120,219
USKUDAR,MURATREIS MAH.,383,343,337,98,239
USKUDAR,MURATREIS MAH.,383,364,357,119,238
USKUDAR,MURATREIS MAH.,382,342,339,93,246
USKUDAR,MURATREIS MAH.,384,327,322,98,224
USKUDAR,MURATREIS MAH.,395,312,304,110,194
USKUDAR,MURATREIS MAH.,395,337,335,124,211
USKUDAR,MURATREIS MAH.,395,363,361,151,210
USKUDAR,MURATREIS MAH.,397,352,342,109,233
USKUDAR,MURATREIS MAH.,395,334,332,115,217
USKUDAR,MURATREIS MAH.,394,348,343,134,209
USKUDAR,MURATREIS MAH.,394,356,352,115,237
USKUDAR,MURATREIS MAH.,394,330,329,119,210
USKUDAR,MURATREIS MAH.,394,358,353,139,214
USKUDAR,MURATREIS MAH.,395,365,361,121,240
USKUDAR,MURATREIS MAH.,396,358,349,128,221
USKUDAR,MURATREIS MAH.,383,311,299,148,151
USKUDAR,MURATREIS MAH.,384,337,333,154,179
USKUDAR,MURATREIS MAH.,384,329,327,157,170
USKUDAR,MURATREIS MAH.,385,331,323,142,181
USKUDAR,MURATREIS MAH.,385,335,334,150,184
USKUDAR,MURATREIS MAH.,384,344,335,165,170
USKUDAR,MURATREIS MAH.,384,344,341,152,189
USKUDAR,SALACAK  MAH.,383,326,324,60,264
USKUDAR,SALACAK  MAH.,383,336,329,101,228
USKUDAR,SALACAK  MAH.,383,354,350,88,262
USKUDAR,SALACAK  MAH.,382,351,351,91,260
USKUDAR,SALACAK  MAH.,383,354,349,97,252
USKUDAR,SALACAK  MAH.,382,348,344,112,232
USKUDAR,SALACAK  MAH.,382,324,318,104,214
USKUDAR,SALACAK  MAH.,403,322,318,74,244
USKUDAR,SALACAK  MAH.,402,322,321,85,236
USKUDAR,SALACAK  MAH.,401,340,336,85,251
USKUDAR,SALACAK  MAH.,401,367,359,90,269
USKUDAR,SALACAK  MAH.,401,369,360,105,255
USKUDAR,SALACAK  MAH.,401,360,356,71,285
USKUDAR,SALACAK  MAH.,403,372,369,85,284
USKUDAR,SALACAK  MAH.,402,374,366,93,273
USKUDAR,SALACAK  MAH.,401,369,367,89,278
USKUDAR,SALACAK  MAH.,401,364,361,109,252
USKUDAR,SALACAK  MAH.,401,359,354,61,293
USKUDAR,SALACAK  MAH.,400,370,365,93,272
USKUDAR,SALACAK  MAH.,400,359,358,84,274
USKUDAR,SELAMI ALI MAH.,415,331,325,154,171
USKUDAR,SELAMI ALI MAH.,410,330,324,139,185
USKUDAR,SELAMI ALI MAH.,410,375,372,185,187
USKUDAR,SELAMI ALI MAH.,410,370,365,152,213
USKUDAR,SELAMI ALI MAH.,410,362,357,167,190
USKUDAR,SELAMI ALI MAH.,410,367,361,160,201
USKUDAR,SELAMI ALI MAH.,410,347,345,163,182
USKUDAR,SELAMI ALI MAH.,411,353,343,159,184
USKUDAR,SELAMI ALI MAH.,410,352,349,170,179
USKUDAR,SELAMI ALI MAH.,410,349,346,137,209
USKUDAR,SELAMI ALI MAH.,410,357,354,176,178
USKUDAR,SELAMI ALI MAH.,410,348,341,180,161
USKUDAR,SELAMI ALI MAH.,410,354,351,166,185
USKUDAR,SELAMI ALI MAH.,410,356,354,170,184
USKUDAR,SELAMI ALI MAH.,410,344,341,142,199
USKUDAR,SELAMI ALI MAH.,409,371,366,181,185
USKUDAR,SELAMI ALI MAH.,402,319,310,101,209
USKUDAR,SELAMI ALI MAH.,401,349,341,105,236
USKUDAR,SELAMI ALI MAH.,402,359,357,109,248
USKUDAR,SELAMI ALI MAH.,402,363,359,112,247
USKUDAR,SELAMI ALI MAH.,402,359,354,118,236
USKUDAR,SELAMI ALI MAH.,402,368,362,128,234
USKUDAR,SELAMI ALI MAH.,401,366,363,125,238
USKUDAR,SELAMI ALI MAH.,401,356,350,116,234
USKUDAR,SELAMI ALI MAH.,401,359,354,134,220
USKUDAR,SELAMI ALI MAH.,402,374,370,143,227
USKUDAR,SELIMIYE MAH.,401,335,331,80,251
USKUDAR,SELIMIYE MAH.,403,338,329,82,247
USKUDAR,SELIMIYE MAH.,403,347,340,87,253
USKUDAR,SELIMIYE MAH.,403,366,364,58,306
USKUDAR,SELIMIYE MAH.,403,366,363,60,303
USKUDAR,SELIMIYE MAH.,403,364,359,68,291
USKUDAR,SELIMIYE MAH.,402,365,363,76,287
USKUDAR,SELIMIYE MAH.,402,373,367,82,285
USKUDAR,SELIMIYE MAH.,402,364,356,91,265
USKUDAR,SELIMIYE MAH.,402,372,365,103,262
USKUDAR,SELIMIYE MAH.,402,365,365,86,279
USKUDAR,SELIMIYE MAH.,402,372,367,70,297
USKUDAR,SELIMIYE MAH.,403,380,377,83,294
USKUDAR,SELIMIYE MAH.,402,363,359,90,269
USKUDAR,SELIMIYE MAH.,408,362,356,61,295
USKUDAR,SULTANTEPE MAH.,393,328,324,116,208
USKUDAR,SULTANTEPE MAH.,393,307,301,129,172
USKUDAR,SULTANTEPE MAH.,391,347,344,138,206
USKUDAR,SULTANTEPE MAH.,390,362,359,149,210
USKUDAR,SULTANTEPE MAH.,391,354,348,141,207
USKUDAR,SULTANTEPE MAH.,390,353,348,138,210
USKUDAR,SULTANTEPE MAH.,391,362,360,154,206
USKUDAR,SULTANTEPE MAH.,391,358,353,142,211
USKUDAR,SULTANTEPE MAH.,390,353,351,146,205
USKUDAR,SULTANTEPE MAH.,391,347,343,147,196
USKUDAR,SULTANTEPE MAH.,391,367,361,162,199
USKUDAR,SULTANTEPE MAH.,390,365,361,159,202
USKUDAR,SULTANTEPE MAH.,390,354,349,137,212
USKUDAR,SULTANTEPE MAH.,379,303,298,135,163
USKUDAR,SULTANTEPE MAH.,379,326,322,122,200
USKUDAR,SULTANTEPE MAH.,378,339,331,166,165
USKUDAR,SULTANTEPE MAH.,378,346,340,145,195
USKUDAR,SULTANTEPE MAH.,380,348,346,146,200
USKUDAR,SULTANTEPE MAH.,378,344,341,123,218
USKUDAR,SULTANTEPE MAH.,377,335,321,135,186
USKUDAR,SULTANTEPE MAH.,380,353,348,129,219
USKUDAR,SULTANTEPE MAH.,377,342,336,144,192
USKUDAR,SULTANTEPE MAH.,378,339,337,168,169
USKUDAR,SULTANTEPE MAH.,377,339,333,153,180
USKUDAR,VALIDE-I ATIK MAH.,407,333,327,153,174
USKUDAR,VALIDE-I ATIK MAH.,407,321,312,131,181
USKUDAR,VALIDE-I ATIK MAH.,407,333,323,134,189
USKUDAR,VALIDE-I ATIK MAH.,407,335,328,150,178
USKUDAR,VALIDE-I ATIK MAH.,406,353,343,128,215
USKUDAR,VALIDE-I ATIK MAH.,407,361,358,143,215
USKUDAR,VALIDE-I ATIK MAH.,407,368,363,121,242
USKUDAR,VALIDE-I ATIK MAH.,407,362,358,143,215
USKUDAR,VALIDE-I ATIK MAH.,410,366,361,138,223
USKUDAR,VALIDE-I ATIK MAH.,406,355,350,138,212
USKUDAR,VALIDE-I ATIK MAH.,407,369,365,162,203
USKUDAR,VALIDE-I ATIK MAH.,407,354,349,135,214
USKUDAR,VALIDE-I ATIK MAH.,407,361,359,124,235
USKUDAR,VALIDE-I ATIK MAH.,409,367,363,140,223
USKUDAR,VALIDE-I ATIK MAH.,406,364,363,124,239
USKUDAR,VALIDE-I ATIK MAH.,406,369,366,110,256
USKUDAR,VALIDE-I ATIK MAH.,409,353,349,133,216
USKUDAR,VALIDE-I ATIK MAH.,407,359,357,154,203
USKUDAR,VALIDE-I ATIK MAH.,406,360,350,155,195
USKUDAR,VALIDE-I ATIK MAH.,407,373,367,156,211
USKUDAR,VALIDE-I ATIK MAH.,406,365,358,133,225
USKUDAR,VALIDE-I ATIK MAH.,406,350,339,133,206
USKUDAR,VALIDE-I ATIK MAH.,407,370,361,158,203
USKUDAR,VALIDE-I ATIK MAH.,399,318,314,133,181
USKUDAR,VALIDE-I ATIK MAH.,396,349,336,143,193
USKUDAR,VALIDE-I ATIK MAH.,397,353,345,144,201
USKUDAR,VALIDE-I ATIK MAH.,398,353,347,120,227
USKUDAR,VALIDE-I ATIK MAH.,396,361,357,135,222
USKUDAR,VALIDE-I ATIK MAH.,398,349,340,134,206
USKUDAR,VALIDE-I ATIK MAH.,396,355,351,143,208
USKUDAR,VALIDE-I ATIK MAH.,396,349,345,121,224
USKUDAR,VALIDE-I ATIK MAH.,384,324,317,179,138
USKUDAR,VALIDE-I ATIK MAH.,383,309,305,128,177
USKUDAR,VALIDE-I ATIK MAH.,383,354,350,165,185
USKUDAR,VALIDE-I ATIK MAH.,388,333,325,153,172
USKUDAR,VALIDE-I ATIK MAH.,385,346,341,161,180
USKUDAR,VALIDE-I ATIK MAH.,383,335,329,136,193
USKUDAR,VALIDE-I ATIK MAH.,386,348,342,166,176
USKUDAR,VALIDE-I ATIK MAH.,383,340,339,158,181
USKUDAR,VALIDE-I ATIK MAH.,384,321,315,166,149
USKUDAR,VALIDE-I ATIK MAH.,384,338,332,155,177
USKUDAR,VALIDE-I ATIK MAH.,384,347,342,144,198
USKUDAR,VALIDE-I ATIK MAH.,383,332,326,154,172
USKUDAR,VALIDE-I ATIK MAH.,384,338,333,165,168
USKUDAR,ZEYNEP KAMIL MAH.,389,312,306,148,158
USKUDAR,ZEYNEP KAMIL MAH.,388,345,337,127,210
USKUDAR,ZEYNEP KAMIL MAH.,388,343,339,146,193
USKUDAR,ZEYNEP KAMIL MAH.,389,329,325,108,217
USKUDAR,ZEYNEP KAMIL MAH.,390,348,345,121,224
USKUDAR,ZEYNEP KAMIL MAH.,389,342,342,162,180
USKUDAR,ZEYNEP KAMIL MAH.,389,347,343,129,214
USKUDAR,ZEYNEP KAMIL MAH.,389,329,323,128,195
USKUDAR,ZEYNEP KAMIL MAH.,388,338,337,123,214
USKUDAR,ZEYNEP KAMIL MAH.,409,330,315,128,187
USKUDAR,ZEYNEP KAMIL MAH.,415,320,314,119,195
USKUDAR,ZEYNEP KAMIL MAH.,410,361,352,140,212
USKUDAR,ZEYNEP KAMIL MAH.,410,359,356,149,207
USKUDAR,ZEYNEP KAMIL MAH.,409,360,357,133,224
USKUDAR,ZEYNEP KAMIL MAH.,409,374,371,157,214
USKUDAR,ZEYNEP KAMIL MAH.,410,370,369,135,234
USKUDAR,ZEYNEP KAMIL MAH.,408,358,349,108,241
USKUDAR,ZEYNEP KAMIL MAH.,410,373,368,169,199
USKUDAR,ZEYNEP KAMIL MAH.,410,382,380,140,240
USKUDAR,ZEYNEP KAMIL MAH.,410,382,379,155,224
USKUDAR,ZEYNEP KAMIL MAH.,409,367,363,143,220
USKUDAR,ZEYNEP KAMIL MAH.,407,362,357,146,211
USKUDAR,ZEYNEP KAMIL MAH.,410,365,356,143,213
USKUDAR,ZEYNEP KAMIL MAH.,410,369,365,149,216
USKUDAR,ZEYNEP KAMIL MAH.,410,371,366,125,241
USKUDAR,ZEYNEP KAMIL MAH.,407,362,354,168,186
USKUDAR,ALTUNIZADE MAH.,396,339,333,94,239
USKUDAR,ALTUNIZADE MAH.,397,339,337,122,215
USKUDAR,ALTUNIZADE MAH.,396,367,361,132,229
USKUDAR,ALTUNIZADE MAH.,396,362,357,145,212
USKUDAR,ALTUNIZADE MAH.,397,365,360,145,215
USKUDAR,ALTUNIZADE MAH.,397,356,351,143,208
USKUDAR,ALTUNIZADE MAH.,396,362,356,142,214
USKUDAR,ALTUNIZADE MAH.,397,368,364,151,213
USKUDAR,ALTUNIZADE MAH.,397,364,360,161,199
USKUDAR,ALTUNIZADE MAH.,398,370,361,133,228
USKUDAR,ALTUNIZADE MAH.,395,366,362,131,231
USKUDAR,ALTUNIZADE MAH.,396,362,354,128,226
USKUDAR,ALTUNIZADE MAH.,397,357,355,113,242
USKUDAR,ALTUNIZADE MAH.,412,362,357,54,303
USKUDAR,ALTUNIZADE MAH.,415,373,370,72,298
USKUDAR,ALTUNIZADE MAH.,415,393,389,62,327
USKUDAR,ALTUNIZADE MAH.,415,375,370,90,280
USKUDAR,ALTUNIZADE MAH.,415,397,394,92,302
USKUDAR,ALTUNIZADE MAH.,415,388,387,83,304
USKUDAR,ALTUNIZADE MAH.,415,391,386,65,321
USKUDAR,ALTUNIZADE MAH.,415,392,390,74,316
USKUDAR,ALTUNIZADE MAH.,415,390,383,63,320
USKUDAR,ALTUNIZADE MAH.,415,382,375,73,302
USKUDAR,ALTUNIZADE MAH.,415,399,391,78,313
USKUDAR,ALTUNIZADE MAH.,415,390,383,73,310
USKUDAR,ALTUNIZADE MAH.,415,384,381,66,315
USKUDAR,BAHCELIEVLER MAH.,411,344,340,205,135
USKUDAR,BAHCELIEVLER MAH.,411,366,358,221,137
USKUDAR,BAHCELIEVLER MAH.,415,394,392,228,164
USKUDAR,BAHCELIEVLER MAH.,412,358,354,214,140
USKUDAR,BAHCELIEVLER MAH.,412,387,382,231,151
USKUDAR,BAHCELIEVLER MAH.,411,367,364,216,148
USKUDAR,BAHCELIEVLER MAH.,411,363,359,212,147
USKUDAR,BAHCELIEVLER MAH.,411,353,348,225,123
USKUDAR,BAHCELIEVLER MAH.,415,366,362,222,140
USKUDAR,BAHCELIEVLER MAH.,349,297,294,189,105
USKUDAR,BAHCELIEVLER MAH.,352,327,318,195,123
USKUDAR,BAHCELIEVLER MAH.,348,310,307,181,126
USKUDAR,BAHCELIEVLER MAH.,349,302,298,180,118
USKUDAR,BAHCELIEVLER MAH.,348,305,304,192,112
USKUDAR,BAHCELIEVLER MAH.,350,316,306,215,91
USKUDAR,BAHCELIEVLER MAH.,375,335,329,109,220
USKUDAR,BAHCELIEVLER MAH.,375,341,337,69,268
USKUDAR,BAHCELIEVLER MAH.,374,335,329,70,259
USKUDAR,BAHCELIEVLER MAH.,374,345,343,97,246
USKUDAR,BAHCELIEVLER MAH.,374,364,355,104,251
USKUDAR,BAHCELIEVLER MAH.,374,339,337,86,251
USKUDAR,BAHCELIEVLER MAH.,375,360,352,60,292
USKUDAR,BAHCELIEVLER MAH.,373,347,344,98,246
USKUDAR,BAHCELIEVLER MAH.,374,347,345,113,232
USKUDAR,BAHCELIEVLER MAH.,383,345,339,178,161
USKUDAR,BAHCELIEVLER MAH.,382,342,337,181,156
USKUDAR,BAHCELIEVLER MAH.,382,346,340,192,148
USKUDAR,BAHCELIEVLER MAH.,383,343,339,178,161
USKUDAR,BAHCELIEVLER MAH.,383,346,340,200,140
USKUDAR,BAHCELIEVLER MAH.,382,352,345,190,155
USKUDAR,BAHCELIEVLER MAH.,398,333,326,63,263
USKUDAR,BAHCELIEVLER MAH.,398,370,369,79,290
USKUDAR,BAHCELIEVLER MAH.,398,364,364,120,244
USKUDAR,BAHCELIEVLER MAH.,399,374,371,71,300
USKUDAR,BAHCELIEVLER MAH.,399,378,374,80,294
USKUDAR,BAHCELIEVLER MAH.,398,380,377,67,310
USKUDAR,BAHCELIEVLER MAH.,398,372,365,92,273
USKUDAR,BAHCELIEVLER MAH.,398,376,370,91,279
USKUDAR,BAHCELIEVLER MAH.,398,367,363,99,264
USKUDAR,BAHCELIEVLER MAH.,397,369,365,100,265
USKUDAR,BAHCELIEVLER MAH.,398,372,367,82,285
USKUDAR,BARBAROS  MAH.,385,327,323,100,223
USKUDAR,BARBAROS  MAH.,385,346,343,99,244
USKUDAR,BARBAROS  MAH.,386,354,346,112,234
USKUDAR,BARBAROS  MAH.,385,345,339,107,232
USKUDAR,BARBAROS  MAH.,385,362,361,100,261
USKUDAR,BARBAROS  MAH.,386,361,354,90,264
USKUDAR,BARBAROS  MAH.,385,352,349,91,258
USKUDAR,BARBAROS  MAH.,384,354,352,97,255
USKUDAR,BARBAROS  MAH.,408,349,342,55,287
USKUDAR,BARBAROS  MAH.,406,354,352,52,300
USKUDAR,BARBAROS  MAH.,407,385,377,82,295
USKUDAR,BARBAROS  MAH.,406,374,374,66,308
USKUDAR,BARBAROS  MAH.,406,376,370,102,268
USKUDAR,BARBAROS  MAH.,409,378,369,77,292
USKUDAR,BARBAROS  MAH.,407,375,369,97,272
USKUDAR,BARBAROS  MAH.,406,382,379,99,280
USKUDAR,BARBAROS  MAH.,406,379,376,88,288
USKUDAR,BARBAROS  MAH.,407,382,378,69,309
USKUDAR,BARBAROS  MAH.,405,379,377,91,286
USKUDAR,BARBAROS  MAH.,405,371,369,99,270
USKUDAR,BARBAROS  MAH.,406,384,375,65,310
USKUDAR,BARBAROS  MAH.,405,375,371,95,276
USKUDAR,BARBAROS  MAH.,406,374,371,73,298
USKUDAR,BARBAROS  MAH.,405,368,364,76,288
USKUDAR,BARBAROS  MAH.,416,358,349,91,258
USKUDAR,BARBAROS  MAH.,415,371,367,88,279
USKUDAR,BARBAROS  MAH.,416,386,383,81,302
USKUDAR,BARBAROS  MAH.,415,391,387,84,303
USKUDAR,BARBAROS  MAH.,414,391,388,102,286
USKUDAR,BARBAROS  MAH.,415,388,384,118,266
USKUDAR,BARBAROS  MAH.,415,389,386,109,277
USKUDAR,BARBAROS  MAH.,419,401,396,84,312
USKUDAR,BARBAROS  MAH.,415,375,371,74,297
USKUDAR,BARBAROS  MAH.,415,376,373,60,313
USKUDAR,BARBAROS  MAH.,415,383,382,89,293
USKUDAR,BARBAROS  MAH.,413,376,372,71,301
USKUDAR,BEYLERBEYI MAH.,388,317,314,105,209
USKUDAR,BEYLERBEYI MAH.,386,334,330,115,215
USKUDAR,BEYLERBEYI MAH.,385,350,345,126,219
USKUDAR,BEYLERBEYI MAH.,386,347,341,122,219
USKUDAR,BEYLERBEYI MAH.,385,339,336,107,229
USKUDAR,BEYLERBEYI MAH.,387,359,352,116,236
USKUDAR,BEYLERBEYI MAH.,364,296,290,134,156
USKUDAR,BEYLERBEYI MAH.,365,324,320,172,148
USKUDAR,BEYLERBEYI MAH.,365,331,327,154,173
USKUDAR,BEYLERBEYI MAH.,364,338,335,194,141
USKUDAR,BEYLERBEYI MAH.,364,310,308,144,164
USKUDAR,BEYLERBEYI MAH.,364,334,327,157,170
USKUDAR,BURHANIYE MAH.,416,334,330,176,154
USKUDAR,BURHANIYE MAH.,416,373,367,186,181
USKUDAR,BURHANIYE MAH.,416,371,364,186,178
USKUDAR,BURHANIYE MAH.,416,362,360,191,169
USKUDAR,BURHANIYE MAH.,416,371,367,205,162
USKUDAR,BURHANIYE MAH.,418,374,370,205,165
USKUDAR,BURHANIYE MAH.,416,374,369,219,150
USKUDAR,BURHANIYE MAH.,415,367,365,208,157
USKUDAR,BURHANIYE MAH.,415,361,357,206,151
USKUDAR,BURHANIYE MAH.,395,342,336,178,158
USKUDAR,BURHANIYE MAH.,394,328,327,189,138
USKUDAR,BURHANIYE MAH.,393,345,339,173,166
USKUDAR,BURHANIYE MAH.,393,357,357,210,147
USKUDAR,BURHANIYE MAH.,394,359,354,198,156
USKUDAR,BURHANIYE MAH.,394,345,337,184,153
USKUDAR,BURHANIYE MAH.,396,329,323,196,127
USKUDAR,BURHANIYE MAH.,396,331,329,202,127
USKUDAR,BURHANIYE MAH.,396,359,355,215,140
USKUDAR,BURHANIYE MAH.,398,353,345,203,142
USKUDAR,BURHANIYE MAH.,396,358,355,210,145
USKUDAR,BURHANIYE MAH.,396,359,352,200,152
USKUDAR,BURHANIYE MAH.,398,355,349,184,165
USKUDAR,BURHANIYE MAH.,397,364,360,221,139
USKUDAR,BURHANIYE MAH.,396,369,365,213,152
USKUDAR,BURHANIYE MAH.,397,351,350,203,147
USKUDAR,BURHANIYE MAH.,395,356,347,189,158
USKUDAR,BURHANIYE MAH.,395,361,357,221,136
USKUDAR,BURHANIYE MAH.,396,363,360,180,180
USKUDAR,BURHANIYE MAH.,396,347,347,183,164
USKUDAR,BURHANIYE MAH.,395,354,350,204,146
USKUDAR,BURHANIYE MAH.,396,345,341,193,148
USKUDAR,CENGELKOY MAH.,400,331,329,170,159
USKUDAR,CENGELKOY MAH.,399,332,327,160,167
USKUDAR,CENGELKOY MAH.,399,357,354,190,164
USKUDAR,CENGELKOY MAH.,399,372,371,211,160
USKUDAR,CENGELKOY MAH.,401,364,359,219,140
USKUDAR,CENGELKOY MAH.,398,358,350,165,185
USKUDAR,CENGELKOY MAH.,399,370,366,163,203
USKUDAR,CENGELKOY MAH.,399,361,359,201,158
USKUDAR,CENGELKOY MAH.,399,356,347,178,169
USKUDAR,CENGELKOY MAH.,400,364,354,162,192
USKUDAR,CENGELKOY MAH.,399,349,345,180,165
USKUDAR,CENGELKOY MAH.,398,355,351,161,190
USKUDAR,CENGELKOY MAH.,398,363,362,176,186
USKUDAR,CENGELKOY MAH.,398,358,356,182,174
USKUDAR,CENGELKOY MAH.,399,357,354,207,147
USKUDAR,CENGELKOY MAH.,398,361,355,196,159
USKUDAR,CENGELKOY MAH.,402,325,321,181,140
USKUDAR,CENGELKOY MAH.,401,335,331,202,129
USKUDAR,CENGELKOY MAH.,401,372,369,246,123
USKUDAR,CENGELKOY MAH.,401,370,365,210,155
USKUDAR,CENGELKOY MAH.,401,365,363,232,131
USKUDAR,CENGELKOY MAH.,401,374,368,244,124
USKUDAR,CENGELKOY MAH.,399,360,355,226,129
USKUDAR,CENGELKOY MAH.,401,370,367,247,120
USKUDAR,CENGELKOY MAH.,401,372,371,236,135
USKUDAR,CENGELKOY MAH.,403,370,364,244,120
USKUDAR,CENGELKOY MAH.,400,360,356,232,124
USKUDAR,GUZELTEPE  MAH.,411,366,360,194,166
USKUDAR,GUZELTEPE  MAH.,412,362,355,217,138
USKUDAR,GUZELTEPE  MAH.,409,369,365,219,146
USKUDAR,GUZELTEPE  MAH.,410,368,360,202,158
USKUDAR,GUZELTEPE  MAH.,411,369,365,235,130
USKUDAR,GUZELTEPE  MAH.,410,372,368,227,141
USKUDAR,GUZELTEPE  MAH.,411,363,356,192,164
USKUDAR,GUZELTEPE  MAH.,409,367,365,208,157
USKUDAR,GUZELTEPE  MAH.,410,383,381,236,145
USKUDAR,GUZELTEPE  MAH.,410,363,357,206,151
USKUDAR,GUZELTEPE  MAH.,410,383,378,196,182
USKUDAR,GUZELTEPE  MAH.,387,331,323,212,111
USKUDAR,GUZELTEPE  MAH.,385,320,312,199,113
USKUDAR,GUZELTEPE  MAH.,387,349,341,211,130
USKUDAR,GUZELTEPE  MAH.,385,351,348,230,118
USKUDAR,GUZELTEPE  MAH.,387,346,343,224,119
USKUDAR,GUZELTEPE  MAH.,386,358,356,249,107
USKUDAR,GUZELTEPE  MAH.,387,356,355,211,144
USKUDAR,GUZELTEPE  MAH.,387,348,343,215,128
USKUDAR,GUZELTEPE  MAH.,386,347,345,216,129
USKUDAR,GUZELTEPE  MAH.,387,357,353,238,115
USKUDAR,GUZELTEPE  MAH.,387,361,357,229,128
USKUDAR,GUZELTEPE  MAH.,386,335,329,212,117
USKUDAR,GUZELTEPE  MAH.,387,353,350,242,108
USKUDAR,GUZELTEPE  MAH.,387,340,338,227,111
USKUDAR,KANDILLI MAH.,395,326,309,67,242
USKUDAR,KANDILLI MAH.,396,344,340,92,248
USKUDAR,KANDILLI MAH.,396,362,358,73,285
USKUDAR,KIRAZLITEPE MAH.,402,347,333,221,112
USKUDAR,KIRAZLITEPE MAH.,402,364,360,248,112
USKUDAR,KIRAZLITEPE MAH.,403,367,363,264,99
USKUDAR,KIRAZLITEPE MAH.,402,363,354,243,111
USKUDAR,KIRAZLITEPE MAH.,403,364,353,230,123
USKUDAR,KIRAZLITEPE MAH.,403,361,356,241,115
USKUDAR,KIRAZLITEPE MAH.,402,360,357,245,112
USKUDAR,KIRAZLITEPE MAH.,403,346,340,241,99
USKUDAR,KIRAZLITEPE MAH.,405,363,357,238,119
USKUDAR,KIRAZLITEPE MAH.,403,361,357,257,100
USKUDAR,KIRAZLITEPE MAH.,403,367,365,228,137
USKUDAR,KIRAZLITEPE MAH.,403,369,358,261,97
USKUDAR,KIRAZLITEPE MAH.,403,364,360,272,88
USKUDAR,KIRAZLITEPE MAH.,402,361,358,231,127
USKUDAR,KIRAZLITEPE MAH.,400,341,329,231,98
USKUDAR,KIRAZLITEPE MAH.,402,359,352,248,104
USKUDAR,KIRAZLITEPE MAH.,401,361,357,248,109
USKUDAR,KIRAZLITEPE MAH.,400,363,355,258,97
USKUDAR,KIRAZLITEPE MAH.,400,353,348,257,91
USKUDAR,KIRAZLITEPE MAH.,400,360,356,259,97
USKUDAR,KIRAZLITEPE MAH.,403,362,359,244,115
USKUDAR,KIRAZLITEPE MAH.,400,356,354,231,123
USKUDAR,KIRAZLITEPE MAH.,399,364,362,253,109
USKUDAR,KIRAZLITEPE MAH.,399,366,356,250,106
USKUDAR,KULELI MAH.,396,315,314,146,168
USKUDAR,KULELI MAH.,396,350,342,182,160
USKUDAR,KULELI MAH.,397,342,340,182,158
USKUDAR,KULELI MAH.,395,351,348,190,158
USKUDAR,KUCUKSU  MAH.,408,338,333,141,192
USKUDAR,KUCUKSU  MAH.,406,325,322,125,197
USKUDAR,KUCUKSU  MAH.,406,334,331,129,202
USKUDAR,KUCUKSU  MAH.,407,384,382,139,243
USKUDAR,KUCUKSU  MAH.,407,367,366,170,196
USKUDAR,KUCUKSU  MAH.,407,367,365,169,196
USKUDAR,KUCUKSU  MAH.,408,373,368,143,225
USKUDAR,KUCUKSU  MAH.,409,390,390,161,229
USKUDAR,KUCUKSU  MAH.,408,373,364,168,196
USKUDAR,KUCUKSU  MAH.,406,376,373,139,234
USKUDAR,KUCUKSU  MAH.,415,378,374,159,215
USKUDAR,KUCUKSU  MAH.,407,359,355,131,224
USKUDAR,KUCUKSU  MAH.,407,372,366,133,233
USKUDAR,KUCUKSU  MAH.,407,371,364,161,203
USKUDAR,KUCUKSU  MAH.,407,367,359,145,214
USKUDAR,KUCUKSU  MAH.,407,363,359,156,203
USKUDAR,KUCUKSU  MAH.,407,376,367,148,219
USKUDAR,KUCUKSU  MAH.,408,360,351,141,210
USKUDAR,KUCUKSU  MAH.,407,374,368,147,221
USKUDAR,KUCUKSU  MAH.,408,378,373,169,204
USKUDAR,KUCUKSU  MAH.,408,367,360,154,206
USKUDAR,KUCUKSU  MAH.,407,371,367,158,209
USKUDAR,KUCUKSU  MAH.,407,372,370,168,202
USKUDAR,KUCUKSU  MAH.,407,371,366,153,213
USKUDAR,KUCUKSU  MAH.,408,364,360,182,178
USKUDAR,KUCUKSU  MAH.,408,375,371,159,212
USKUDAR,KUCUKSU  MAH.,407,369,363,147,216
USKUDAR,KUCUKSU  MAH.,407,371,366,147,219
USKUDAR,KUCUKSU  MAH.,409,377,376,164,212
USKUDAR,KUCUKSU  MAH.,383,324,319,155,164
USKUDAR,KUCUKSU  MAH.,383,343,340,167,173
USKUDAR,KUCUKSU  MAH.,381,334,330,174,156
USKUDAR,KUCUKSU  MAH.,382,338,331,149,182
USKUDAR,KUCUKSU  MAH.,382,340,336,175,161
USKUDAR,KUCUKSU  MAH.,381,332,327,166,161
USKUDAR,KUCUKSU  MAH.,382,346,340,161,179
USKUDAR,KUPLUCE  MAH.,415,346,339,210,129
USKUDAR,KUPLUCE  MAH.,415,366,361,230,131
USKUDAR,KUPLUCE  MAH.,415,373,370,228,142
USKUDAR,KUPLUCE  MAH.,415,383,380,257,123
USKUDAR,KUPLUCE  MAH.,415,368,366,218,148
USKUDAR,KUPLUCE  MAH.,414,361,355,240,115
USKUDAR,KUPLUCE  MAH.,415,369,362,235,127
USKUDAR,KUPLUCE  MAH.,415,369,364,248,116
USKUDAR,KUPLUCE  MAH.,415,366,363,236,127
USKUDAR,KUPLUCE  MAH.,415,370,369,257,112
USKUDAR,KUPLUCE  MAH.,412,370,366,244,122
USKUDAR,KUPLUCE  MAH.,403,345,332,208,124
USKUDAR,KUPLUCE  MAH.,404,365,359,243,116
USKUDAR,KUPLUCE  MAH.,403,367,363,264,99
USKUDAR,KUPLUCE  MAH.,403,377,373,236,137
USKUDAR,KUPLUCE  MAH.,403,371,361,227,134
USKUDAR,KUPLUCE  MAH.,403,379,375,248,127
USKUDAR,KUPLUCE  MAH.,403,360,352,221,131
USKUDAR,KUPLUCE  MAH.,406,354,348,228,120
USKUDAR,KUPLUCE  MAH.,403,362,358,252,106
USKUDAR,KUPLUCE  MAH.,404,374,368,271,97
USKUDAR,KUPLUCE  MAH.,403,365,359,234,125
USKUDAR,KUPLUCE  MAH.,404,375,363,243,120
USKUDAR,KUPLUCE  MAH.,403,364,357,240,117
USKUDAR,KUPLUCE  MAH.,412,334,323,220,103
USKUDAR,KUPLUCE  MAH.,412,363,360,235,125
USKUDAR,KUPLUCE  MAH.,413,354,345,212,133
USKUDAR,KUPLUCE  MAH.,413,364,356,246,110
USKUDAR,KUPLUCE  MAH.,415,368,360,230,130
USKUDAR,KUPLUCE  MAH.,413,364,355,253,102
USKUDAR,KUPLUCE  MAH.,412,372,368,240,128
USKUDAR,KUPLUCE  MAH.,413,362,360,250,110
USKUDAR,MEHMET AKIF ERSOY MAH.,415,352,344,169,175
USKUDAR,MEHMET AKIF ERSOY MAH.,408,351,340,187,153
USKUDAR,MEHMET AKIF ERSOY MAH.,409,359,352,212,140
USKUDAR,MEHMET AKIF ERSOY MAH.,408,374,369,184,185
USKUDAR,MEHMET AKIF ERSOY MAH.,409,372,366,217,149
USKUDAR,MEHMET AKIF ERSOY MAH.,409,381,370,232,138
USKUDAR,MEHMET AKIF ERSOY MAH.,408,372,365,214,151
USKUDAR,MEHMET AKIF ERSOY MAH.,409,371,362,240,122
USKUDAR,MEHMET AKIF ERSOY MAH.,408,370,361,211,150
USKUDAR,MEHMET AKIF ERSOY MAH.,407,378,374,214,160
USKUDAR,MEHMET AKIF ERSOY MAH.,408,355,353,220,133
USKUDAR,MEHMET AKIF ERSOY MAH.,408,377,376,261,115
USKUDAR,MEHMET AKIF ERSOY MAH.,410,375,367,212,155
USKUDAR,MEHMET AKIF ERSOY MAH.,408,376,371,241,130
USKUDAR,MEHMET AKIF ERSOY MAH.,409,387,377,228,149
USKUDAR,MEHMET AKIF ERSOY MAH.,409,372,367,245,122
USKUDAR,MEHMET AKIF ERSOY MAH.,409,381,377,222,155
USKUDAR,MEHMET AKIF ERSOY MAH.,408,366,359,190,169
USKUDAR,MEHMET AKIF ERSOY MAH.,408,355,352,222,130
USKUDAR,MEHMET AKIF ERSOY MAH.,408,386,377,235,142
USKUDAR,MEHMET AKIF ERSOY MAH.,409,378,377,222,155
USKUDAR,MEHMET AKIF ERSOY MAH.,409,379,375,238,137
USKUDAR,MEHMET AKIF ERSOY MAH.,408,361,353,197,156
USKUDAR,MEHMET AKIF ERSOY MAH.,407,374,372,221,151
USKUDAR,MEHMET AKIF ERSOY MAH.,407,369,362,221,141
USKUDAR,MEHMET AKIF ERSOY MAH.,415,359,351,231,120
USKUDAR,MEHMET AKIF ERSOY MAH.,415,371,368,266,102
USKUDAR,MEHMET AKIF ERSOY MAH.,411,385,381,278,103
USKUDAR,MEHMET AKIF ERSOY MAH.,411,376,372,270,102
USKUDAR,MEHMET AKIF ERSOY MAH.,410,368,360,258,102
USKUDAR,MEHMET AKIF ERSOY MAH.,415,375,365,248,117
USKUDAR,MEHMET AKIF ERSOY MAH.,410,370,362,257,105
USKUDAR,MEHMET AKIF ERSOY MAH.,410,370,367,250,117
USKUDAR,MEHMET AKIF ERSOY MAH.,410,368,362,266,96
USKUDAR,MEHMET AKIF ERSOY MAH.,415,374,368,250,118
USKUDAR,MEHMET AKIF ERSOY MAH.,411,376,370,282,88
USKUDAR,MEHMET AKIF ERSOY MAH.,412,380,375,266,109
USKUDAR,MEHMET AKIF ERSOY MAH.,411,362,356,284,72
USKUDAR,YAVUZTURK  MAH.,414,344,334,225,109
USKUDAR,YAVUZTURK  MAH.,415,359,346,246,100
USKUDAR,YAVUZTURK  MAH.,414,382,371,242,129
USKUDAR,YAVUZTURK  MAH.,415,374,369,253,116
USKUDAR,YAVUZTURK  MAH.,414,364,347,211,136
USKUDAR,YAVUZTURK  MAH.,414,369,367,226,141
USKUDAR,YAVUZTURK  MAH.,415,379,371,244,127
USKUDAR,YAVUZTURK  MAH.,415,368,365,233,132
USKUDAR,YAVUZTURK  MAH.,414,361,355,229,126
USKUDAR,YAVUZTURK  MAH.,414,375,367,240,127
USKUDAR,YAVUZTURK  MAH.,412,366,353,237,116
USKUDAR,YAVUZTURK  MAH.,415,369,360,231,129
USKUDAR,YAVUZTURK  MAH.,415,370,352,262,90
USKUDAR,YAVUZTURK  MAH.,415,372,363,236,127
USKUDAR,YAVUZTURK  MAH.,411,375,368,245,123
USKUDAR,YAVUZTURK  MAH.,413,374,368,248,120
USKUDAR,YAVUZTURK  MAH.,413,380,378,214,164
USKUDAR,YAVUZTURK  MAH.,405,359,349,176,173
USKUDAR,YAVUZTURK  MAH.,406,343,331,192,139
USKUDAR,YAVUZTURK  MAH.,402,343,331,175,156
USKUDAR,YAVUZTURK  MAH.,404,373,361,205,156
USKUDAR,YAVUZTURK  MAH.,404,371,362,185,177
USKUDAR,YAVUZTURK  MAH.,402,372,357,184,173
USKUDAR,YAVUZTURK  MAH.,403,369,361,197,164
USKUDAR,YAVUZTURK  MAH.,404,363,359,187,172
USKUDAR,YAVUZTURK  MAH.,403,356,346,197,149
USKUDAR,YAVUZTURK  MAH.,402,358,352,195,157
USKUDAR,YAVUZTURK  MAH.,401,354,349,196,153
USKUDAR,YAVUZTURK  MAH.,403,364,359,196,163
USKUDAR,YAVUZTURK  MAH.,401,358,357,202,155
USKUDAR,YAVUZTURK  MAH.,401,354,348,197,151
USKUDAR,YAVUZTURK  MAH.,401,371,367,194,173
USKUDAR,YAVUZTURK  MAH.,403,370,367,196,171
USKUDAR,YAVUZTURK  MAH.,402,364,353,179,174
USKUDAR,YAVUZTURK  MAH.,402,348,341,192,149
USKUDAR,YAVUZTURK  MAH.,401,359,350,195,155
USKUDAR,YAVUZTURK  MAH.,402,369,363,211,152
USKUDAR,YAVUZTURK  MAH.,401,367,363,200,163
USKUDAR,YAVUZTURK  MAH.,402,355,352,198,154
USKUDAR,YAVUZTURK  MAH.,401,351,344,186,158
USKUDAR,YAVUZTURK  MAH.,402,362,360,202,158
USKUDAR,YAVUZTURK  MAH.,401,348,340,202,138
USKUDAR,YAVUZTURK  MAH.,402,358,355,177,178
USKUDAR,YAVUZTURK  MAH.,401,349,342,188,154
USKUDAR,YAVUZTURK  MAH.,396,326,319,198,121
USKUDAR,YAVUZTURK  MAH.,396,342,332,198,134
USKUDAR,YAVUZTURK  MAH.,395,360,357,216,141
USKUDAR,YAVUZTURK  MAH.,396,357,356,214,142
USKUDAR,YAVUZTURK  MAH.,396,367,360,208,152
USKUDAR,YAVUZTURK  MAH.,395,342,334,224,110
USKUDAR,YAVUZTURK  MAH.,396,364,359,233,126
USKUDAR,YAVUZTURK  MAH.,395,363,359,232,127
USKUDAR,YAVUZTURK  MAH.,397,349,343,212,131
USKUDAR,YAVUZTURK  MAH.,396,347,337,214,123
USKUDAR,YAVUZTURK  MAH.,396,356,347,199,148
USKUDAR,YAVUZTURK  MAH.,395,346,341,208,133
USKUDAR,YAVUZTURK  MAH.,396,357,349,206,143
USKUDAR,YAVUZTURK  MAH.,396,359,353,215,138
USKUDAR,YAVUZTURK  MAH.,396,354,349,221,128
USKUDAR,YAVUZTURK  MAH.,396,341,332,206,126
USKUDAR,YAVUZTURK  MAH.,396,355,349,233,116
USKUDAR,YAVUZTURK  MAH.,396,348,345,218,127
USKUDAR,ACIBADEM MAH.,411,353,347,81,266
USKUDAR,ACIBADEM MAH.,411,343,340,87,253
USKUDAR,ACIBADEM MAH.,410,390,387,87,300
USKUDAR,ACIBADEM MAH.,411,383,380,92,288
USKUDAR,ACIBADEM MAH.,410,380,376,73,303
USKUDAR,ACIBADEM MAH.,411,384,379,86,293
USKUDAR,ACIBADEM MAH.,410,371,369,64,305
USKUDAR,ACIBADEM MAH.,411,378,377,81,296
USKUDAR,ACIBADEM MAH.,410,377,372,74,298
USKUDAR,ACIBADEM MAH.,411,381,373,77,296
USKUDAR,ACIBADEM MAH.,410,372,369,60,309
USKUDAR,ACIBADEM MAH.,410,378,374,74,300
USKUDAR,ACIBADEM MAH.,410,392,385,78,307
USKUDAR,ACIBADEM MAH.,411,388,381,60,321
USKUDAR,ACIBADEM MAH.,411,386,383,60,323
USKUDAR,ACIBADEM MAH.,411,383,383,79,304
USKUDAR,ACIBADEM MAH.,411,375,372,76,296
USKUDAR,ACIBADEM MAH.,410,382,377,66,311
USKUDAR,ACIBADEM MAH.,375,316,311,80,231
USKUDAR,ACIBADEM MAH.,374,331,325,91,234
USKUDAR,ACIBADEM MAH.,374,349,347,97,250
USKUDAR,ACIBADEM MAH.,375,354,346,94,252
USKUDAR,ACIBADEM MAH.,374,346,342,93,249
USKUDAR,ACIBADEM MAH.,375,345,342,110,232
USKUDAR,ACIBADEM MAH.,375,357,356,109,247
USKUDAR,ACIBADEM MAH.,375,346,338,104,234
USKUDAR,ACIBADEM MAH.,374,350,348,94,254
USKUDAR,ACIBADEM MAH.,416,364,358,100,258
USKUDAR,ACIBADEM MAH.,415,393,385,110,275
USKUDAR,ACIBADEM MAH.,416,384,376,97,279
USKUDAR,ACIBADEM MAH.,421,392,388,105,283
USKUDAR,ACIBADEM MAH.,415,391,387,113,274
USKUDAR,ACIBADEM MAH.,415,395,388,106,282
USKUDAR,ACIBADEM MAH.,415,383,375,103,272
USKUDAR,ACIBADEM MAH.,416,392,389,97,292
USKUDAR,ACIBADEM MAH.,408,351,343,77,266
USKUDAR,ACIBADEM MAH.,406,352,349,75,274
USKUDAR,ACIBADEM MAH.,406,372,367,85,282
USKUDAR,ACIBADEM MAH.,406,377,373,80,293
USKUDAR,ACIBADEM MAH.,406,378,375,75,300
USKUDAR,ACIBADEM MAH.,406,376,374,93,281
USKUDAR,ACIBADEM MAH.,407,365,363,65,298
USKUDAR,ACIBADEM MAH.,405,388,385,86,299
USKUDAR,ACIBADEM MAH.,406,381,374,75,299
USKUDAR,ACIBADEM MAH.,406,366,361,92,269
USKUDAR,ACIBADEM MAH.,405,377,368,76,292
USKUDAR,ACIBADEM MAH.,405,373,366,89,277
USKUDAR,ACIBADEM MAH.,406,367,364,85,279
USKUDAR,BULGURLU  MAH.,399,326,322,169,153
USKUDAR,BULGURLU  MAH.,399,346,340,170,170
USKUDAR,BULGURLU  MAH.,401,366,361,178,183
USKUDAR,BULGURLU  MAH.,398,344,340,189,151
USKUDAR,BULGURLU  MAH.,398,343,339,166,173
USKUDAR,BULGURLU  MAH.,399,357,349,150,199
USKUDAR,BULGURLU  MAH.,400,368,365,169,196
USKUDAR,BULGURLU  MAH.,398,371,369,185,184
USKUDAR,BULGURLU  MAH.,399,356,348,165,183
USKUDAR,BULGURLU  MAH.,399,371,368,199,169
USKUDAR,BULGURLU  MAH.,398,377,376,200,176
USKUDAR,BULGURLU  MAH.,399,364,362,186,176
USKUDAR,BULGURLU  MAH.,398,363,359,206,153
USKUDAR,BULGURLU  MAH.,399,358,355,193,162
USKUDAR,BULGURLU  MAH.,399,360,354,180,174
USKUDAR,BULGURLU  MAH.,398,365,361,186,175
USKUDAR,BULGURLU  MAH.,392,339,333,152,181
USKUDAR,BULGURLU  MAH.,392,341,330,159,171
USKUDAR,BULGURLU  MAH.,391,372,366,176,190
USKUDAR,BULGURLU  MAH.,393,371,371,178,193
USKUDAR,BULGURLU  MAH.,391,358,352,149,203
USKUDAR,BULGURLU  MAH.,391,360,357,150,207
USKUDAR,BULGURLU  MAH.,391,358,354,160,194
USKUDAR,BULGURLU  MAH.,391,365,359,168,191
USKUDAR,BULGURLU  MAH.,391,359,351,167,184
USKUDAR,BULGURLU  MAH.,390,350,344,156,188
USKUDAR,BULGURLU  MAH.,390,365,364,176,188
USKUDAR,BULGURLU  MAH.,391,361,357,147,210
USKUDAR,BULGURLU  MAH.,391,349,340,150,190
USKUDAR,BULGURLU  MAH.,390,355,349,163,186
USKUDAR,BULGURLU  MAH.,393,341,338,165,173
USKUDAR,BULGURLU  MAH.,415,371,370,153,217
USKUDAR,BULGURLU  MAH.,415,385,380,172,208
USKUDAR,BULGURLU  MAH.,415,382,379,192,187
USKUDAR,BULGURLU  MAH.,415,383,374,208,166
USKUDAR,BULGURLU  MAH.,415,380,380,190,190
USKUDAR,BULGURLU  MAH.,415,380,373,197,176
USKUDAR,BULGURLU  MAH.,411,377,368,189,179
USKUDAR,BULGURLU  MAH.,415,383,379,198,181
USKUDAR,BULGURLU  MAH.,411,389,384,181,203
USKUDAR,BULGURLU  MAH.,410,370,368,206,162
USKUDAR,BULGURLU  MAH.,413,377,370,179,191
USKUDAR,BULGURLU  MAH.,413,372,364,164,200
USKUDAR,BULGURLU  MAH.,412,373,366,175,191
USKUDAR,BULGURLU  MAH.,411,367,359,147,212
USKUDAR,BULGURLU  MAH.,413,383,378,186,192
USKUDAR,BULGURLU  MAH.,412,388,385,214,171
USKUDAR,BULGURLU  MAH.,379,338,334,201,133
USKUDAR,BULGURLU  MAH.,380,357,349,193,156
USKUDAR,BULGURLU  MAH.,381,331,322,190,132
USKUDAR,BULGURLU  MAH.,378,357,350,179,171
USKUDAR,BULGURLU  MAH.,379,354,348,223,125
USKUDAR,BULGURLU  MAH.,379,342,337,186,151
USKUDAR,BULGURLU  MAH.,378,349,344,215,129
USKUDAR,BULGURLU  MAH.,378,350,348,183,165
USKUDAR,BULGURLU  MAH.,378,350,339,201,138
USKUDAR,BULGURLU  MAH.,378,350,340,210,130
USKUDAR,BULGURLU  MAH.,378,359,350,202,148
USKUDAR,CUMHURIYET MAH.,406,339,326,194,132
USKUDAR,CUMHURIYET MAH.,406,349,342,184,158
USKUDAR,CUMHURIYET MAH.,405,356,350,184,166
USKUDAR,CUMHURIYET MAH.,405,371,368,202,166
USKUDAR,CUMHURIYET MAH.,405,368,361,187,174
USKUDAR,CUMHURIYET MAH.,406,372,371,209,162
USKUDAR,CUMHURIYET MAH.,405,361,360,185,175
USKUDAR,CUMHURIYET MAH.,405,367,361,204,157
USKUDAR,CUMHURIYET MAH.,406,371,364,182,182
USKUDAR,CUMHURIYET MAH.,405,379,374,186,188
USKUDAR,CUMHURIYET MAH.,405,372,364,195,169
USKUDAR,CUMHURIYET MAH.,407,365,356,181,175
USKUDAR,CUMHURIYET MAH.,405,367,364,212,152
USKUDAR,CUMHURIYET MAH.,405,352,347,180,167
USKUDAR,CUMHURIYET MAH.,407,379,376,172,204
USKUDAR,CUMHURIYET MAH.,406,369,359,221,138
USKUDAR,CUMHURIYET MAH.,406,377,373,201,172
USKUDAR,CUMHURIYET MAH.,407,362,362,210,152
USKUDAR,CUMHURIYET MAH.,405,367,364,209,155
USKUDAR,CUMHURIYET MAH.,407,371,369,220,149
USKUDAR,CUMHURIYET MAH.,404,357,349,164,185
USKUDAR,CUMHURIYET MAH.,405,374,370,194,176
USKUDAR,CUMHURIYET MAH.,405,357,353,199,154
USKUDAR,CUMHURIYET MAH.,404,374,372,203,169
USKUDAR,CUMHURIYET MAH.,405,370,361,186,175
USKUDAR,CUMHURIYET MAH.,404,360,352,206,146
USKUDAR,CUMHURIYET MAH.,405,363,360,202,158
USKUDAR,CUMHURIYET MAH.,405,382,378,213,165
USKUDAR,CUMHURIYET MAH.,408,374,371,216,155
USKUDAR,CUMHURIYET MAH.,404,349,341,149,192
USKUDAR,CUMHURIYET MAH.,405,344,336,160,176
USKUDAR,CUMHURIYET MAH.,404,368,367,169,198
USKUDAR,CUMHURIYET MAH.,404,367,362,175,187
USKUDAR,CUMHURIYET MAH.,404,376,371,180,191
USKUDAR,CUMHURIYET MAH.,403,372,368,169,199
USKUDAR,CUMHURIYET MAH.,402,359,356,180,176
USKUDAR,CUMHURIYET MAH.,404,363,359,163,196
USKUDAR,CUMHURIYET MAH.,404,367,362,147,215
USKUDAR,CUMHURIYET MAH.,404,374,366,179,187
USKUDAR,CUMHURIYET MAH.,404,383,378,151,227
USKUDAR,CUMHURIYET MAH.,404,372,367,173,194
USKUDAR,CUMHURIYET MAH.,403,378,374,178,196
USKUDAR,CUMHURIYET MAH.,403,380,380,167,213
USKUDAR,CUMHURIYET MAH.,403,374,368,136,232
USKUDAR,CUMHURIYET MAH.,402,361,358,155,203
USKUDAR,CUMHURIYET MAH.,403,366,357,147,210
USKUDAR,CUMHURIYET MAH.,404,362,352,166,186
USKUDAR,CUMHURIYET MAH.,404,369,358,174,184
USKUDAR,CUMHURIYET MAH.,404,373,370,181,189
USKUDAR,CUMHURIYET MAH.,404,365,363,165,198
USKUDAR,CUMHURIYET MAH.,403,379,377,171,206
USKUDAR,CUMHURIYET MAH.,403,376,373,172,201
USKUDAR,CUMHURIYET MAH.,393,335,327,152,175
USKUDAR,CUMHURIYET MAH.,393,359,357,191,166
USKUDAR,CUMHURIYET MAH.,393,364,355,206,149
USKUDAR,CUMHURIYET MAH.,393,364,362,202,160
USKUDAR,CUMHURIYET MAH.,391,362,356,181,175
USKUDAR,CUMHURIYET MAH.,395,377,370,194,176
USKUDAR,CUMHURIYET MAH.,393,369,367,196,171
USKUDAR,CUMHURIYET MAH.,391,364,360,182,178
USKUDAR,CUMHURIYET MAH.,392,351,347,174,173
USKUDAR,CUMHURIYET MAH.,393,362,357,168,189
USKUDAR,CUMHURIYET MAH.,393,356,354,194,160
USKUDAR,CUMHURIYET MAH.,395,360,359,201,158
USKUDAR,CUMHURIYET MAH.,393,364,363,194,169
USKUDAR,CUMHURIYET MAH.,393,354,350,190,160
USKUDAR,CUMHURIYET MAH.,393,357,352,192,160
USKUDAR,FERAH  MAH.,402,341,334,209,125
USKUDAR,FERAH  MAH.,401,350,340,221,119
USKUDAR,FERAH  MAH.,400,370,366,242,124
USKUDAR,FERAH  MAH.,400,363,350,200,150
USKUDAR,FERAH  MAH.,400,372,368,228,140
USKUDAR,FERAH  MAH.,399,380,373,244,129
USKUDAR,FERAH  MAH.,400,368,367,234,133
USKUDAR,FERAH  MAH.,399,370,365,242,123
USKUDAR,FERAH  MAH.,400,369,363,241,122
USKUDAR,FERAH  MAH.,399,359,347,233,114
USKUDAR,FERAH  MAH.,399,356,346,219,127
USKUDAR,FERAH  MAH.,400,366,358,223,135
USKUDAR,FERAH  MAH.,399,368,357,234,123
USKUDAR,FERAH  MAH.,399,353,344,220,124
USKUDAR,FERAH  MAH.,399,365,362,238,124
USKUDAR,FERAH  MAH.,400,359,353,217,136
USKUDAR,FERAH  MAH.,400,362,353,230,123
USKUDAR,FERAH  MAH.,399,350,344,222,122
USKUDAR,FERAH  MAH.,399,362,354,227,127
USKUDAR,FERAH  MAH.,399,344,340,221,119
USKUDAR,FERAH  MAH.,400,366,354,220,134
USKUDAR,FERAH  MAH.,400,354,348,205,143
USKUDAR,FERAH  MAH.,400,374,365,220,145
USKUDAR,FERAH  MAH.,400,362,359,249,110
USKUDAR,FERAH  MAH.,402,327,315,194,121
USKUDAR,FERAH  MAH.,402,377,374,206,168
USKUDAR,FERAH  MAH.,405,372,367,232,135
USKUDAR,FERAH  MAH.,402,363,356,233,123
USKUDAR,FERAH  MAH.,402,368,367,214,153
USKUDAR,FERAH  MAH.,405,381,377,220,157
USKUDAR,FERAH  MAH.,402,372,368,204,164
USKUDAR,FERAH  MAH.,401,369,360,207,153
USKUDAR,FERAH  MAH.,402,368,363,210,153
USKUDAR,FERAH  MAH.,402,372,364,223,141
USKUDAR,FERAH  MAH.,402,374,370,218,152
USKUDAR,FERAH  MAH.,401,357,355,238,117
USKUDAR,FERAH  MAH.,402,362,358,205,153
USKUDAR,KISIKLI  MAH.,404,342,335,217,118
USKUDAR,KISIKLI  MAH.,404,342,329,209,120
USKUDAR,KISIKLI  MAH.,403,378,370,250,120
USKUDAR,KISIKLI  MAH.,405,378,364,228,136
USKUDAR,KISIKLI  MAH.,403,355,350,202,148
USKUDAR,KISIKLI  MAH.,403,367,357,204,153
USKUDAR,KISIKLI  MAH.,403,366,362,244,118
USKUDAR,KISIKLI  MAH.,403,365,356,203,153
USKUDAR,KISIKLI  MAH.,402,366,362,195,167
USKUDAR,KISIKLI  MAH.,407,383,372,205,167
USKUDAR,KISIKLI  MAH.,403,364,357,214,143
USKUDAR,KISIKLI  MAH.,403,375,365,236,129
USKUDAR,KISIKLI  MAH.,403,345,340,204,136
USKUDAR,KISIKLI  MAH.,403,345,340,212,128
USKUDAR,KISIKLI  MAH.,403,363,357,200,157
USKUDAR,KISIKLI  MAH.,403,367,362,221,141
USKUDAR,KISIKLI  MAH.,402,357,347,206,141
USKUDAR,KISIKLI  MAH.,404,365,364,246,118
USKUDAR,KISIKLI  MAH.,402,369,362,225,137
USKUDAR,KISIKLI  MAH.,402,352,346,221,125
USKUDAR,KISIKLI  MAH.,403,359,353,204,149
USKUDAR,KISIKLI  MAH.,402,351,344,234,110
USKUDAR,KISIKLI  MAH.,401,317,309,189,120
USKUDAR,KISIKLI  MAH.,401,353,347,204,143
USKUDAR,KISIKLI  MAH.,402,348,341,208,133
USKUDAR,KISIKLI  MAH.,401,355,347,213,134
USKUDAR,KISIKLI  MAH.,401,365,357,229,128
USKUDAR,KISIKLI  MAH.,401,352,352,214,138
USKUDAR,KISIKLI  MAH.,400,361,356,220,136
USKUDAR,KISIKLI  MAH.,401,369,361,232,129
USKUDAR,KISIKLI  MAH.,404,348,345,211,134
USKUDAR,KISIKLI  MAH.,401,355,347,200,147
USKUDAR,KISIKLI  MAH.,402,353,343,201,142
USKUDAR,KISIKLI  MAH.,401,361,353,181,172
USKUDAR,KISIKLI  MAH.,401,361,356,200,156
USKUDAR,KUCUK CAMLICA MAH.,401,305,294,128,166
USKUDAR,KUCUK CAMLICA MAH.,401,333,322,166,156
USKUDAR,KUCUK CAMLICA MAH.,400,354,351,205,146
USKUDAR,KUCUK CAMLICA MAH.,400,382,376,209,167
USKUDAR,KUCUK CAMLICA MAH.,400,381,379,228,151
USKUDAR,KUCUK CAMLICA MAH.,405,380,378,232,146
USKUDAR,KUCUK CAMLICA MAH.,403,367,367,217,150
USKUDAR,KUCUK CAMLICA MAH.,399,369,364,201,163
USKUDAR,KUCUK CAMLICA MAH.,400,364,357,192,165
USKUDAR,KUCUK CAMLICA MAH.,406,372,372,200,172
USKUDAR,KUCUK CAMLICA MAH.,400,362,353,185,168
USKUDAR,KUCUK CAMLICA MAH.,402,372,367,200,167
USKUDAR,KUCUK CAMLICA MAH.,401,354,349,186,163
USKUDAR,KUCUK CAMLICA MAH.,401,365,363,191,172
USKUDAR,KUCUK CAMLICA MAH.,399,360,358,183,175
USKUDAR,KUCUK CAMLICA MAH.,401,356,352,174,178
USKUDAR,KUCUK CAMLICA MAH.,400,366,363,188,175
USKUDAR,KUCUK CAMLICA MAH.,400,362,360,185,175
USKUDAR,KUCUK CAMLICA MAH.,400,363,362,183,179
USKUDAR,UNALAN  MAH.,394,333,327,201,126
USKUDAR,UNALAN  MAH.,397,339,330,170,160
USKUDAR,UNALAN  MAH.,396,354,350,203,147
USKUDAR,UNALAN  MAH.,395,357,352,191,161
USKUDAR,UNALAN  MAH.,398,349,344,178,166
USKUDAR,UNALAN  MAH.,395,363,356,194,162
USKUDAR,UNALAN  MAH.,395,358,354,209,145
USKUDAR,UNALAN  MAH.,394,358,351,185,166
USKUDAR,UNALAN  MAH.,397,356,353,208,145
USKUDAR,UNALAN  MAH.,395,336,334,166,168
USKUDAR,UNALAN  MAH.,394,355,349,169,180
USKUDAR,UNALAN  MAH.,395,362,362,214,148
USKUDAR,UNALAN  MAH.,394,353,344,174,170
USKUDAR,UNALAN  MAH.,394,361,356,197,159
USKUDAR,UNALAN  MAH.,394,349,347,165,182
USKUDAR,UNALAN  MAH.,415,366,356,168,188
USKUDAR,UNALAN  MAH.,417,382,380,175,205
USKUDAR,UNALAN  MAH.,417,401,396,203,193
USKUDAR,UNALAN  MAH.,415,377,372,225,147
USKUDAR,UNALAN  MAH.,415,372,368,205,163
USKUDAR,UNALAN  MAH.,415,388,384,215,169
USKUDAR,UNALAN  MAH.,413,372,363,201,162
USKUDAR,UNALAN  MAH.,417,378,375,198,177
USKUDAR,UNALAN  MAH.,415,371,363,187,176
USKUDAR,UNALAN  MAH.,415,377,373,188,185
USKUDAR,UNALAN  MAH.,413,366,361,180,181
USKUDAR,UNALAN  MAH.,415,366,359,168,191
USKUDAR,UNALAN  MAH.,413,397,396,207,189
USKUDAR,UNALAN  MAH.,413,349,335,85,250
USKUDAR,UNALAN  MAH.,414,381,374,94,280
USKUDAR,UNALAN  MAH.,414,401,396,95,301
USKUDAR,UNALAN  MAH.,413,382,378,130,248
USKUDAR,UNALAN  MAH.,414,383,377,131,246
USKUDAR,UNALAN  MAH.,414,386,381,106,275
USKUDAR,UNALAN  MAH.,413,398,395,114,281
USKUDAR,UNALAN  MAH.,413,376,372,73,299
USKUDAR,UNALAN  MAH.,414,383,377,90,287
USKUDAR,UNALAN  MAH.,414,387,382,91,291
USKUDAR,UNALAN  MAH.,413,384,381,103,278
USKUDAR,UNALAN  MAH.,399,330,324,218,106
USKUDAR,UNALAN  MAH.,399,338,328,216,112
USKUDAR,UNALAN  MAH.,402,348,344,242,102
USKUDAR,UNALAN  MAH.,399,368,366,230,136
USKUDAR,UNALAN  MAH.,399,352,344,203,141
USKUDAR,UNALAN  MAH.,399,360,357,218,139
USKUDAR,UNALAN  MAH.,400,354,349,216,133
USKUDAR,UNALAN  MAH.,400,352,348,212,136
USKUDAR,UNALAN  MAH.,401,373,371,201,170
USKUDAR,UNALAN  MAH.,402,357,348,224,124
USKUDAR,UNALAN  MAH.,399,368,360,227,133
USKUDAR,UNALAN  MAH.,398,355,345,219,126
USKUDAR,UNALAN  MAH.,399,350,347,199,148
USKUDAR,UNALAN  MAH.,400,365,365,231,134
USKUDAR,UNALAN  MAH.,399,353,350,221,129
USKUDAR,UNALAN  MAH.,399,351,350,222,128
USKUDAR,UNALAN  MAH.,399,363,355,236,119
USKUDAR,UNALAN  MAH.,400,355,351,201,150
USKUDAR,UNALAN  MAH.,400,354,348,229,119
USKUDAR,UNALAN  MAH.,399,365,356,207,149
USKUDAR,UNALAN  MAH.,399,357,350,211,139
USKUDAR,UNALAN  MAH.,399,360,352,191,161
USKUDAR,UNALAN  MAH.,398,369,365,220,145
USKUDAR,UNALAN  MAH.,398,345,339,189,150
USKUDAR,UNALAN  MAH.,398,360,353,209,144
USKUDAR,PASAKAPISI KAPALI CEZA INFAZ KURUMU,82,87,87,30,57
SARIYER,BAHCEKOY MERKEZ MAH.,415,350,344,145,199
SARIYER,BAHCEKOY MERKEZ MAH.,411,386,381,156,225
SARIYER,BAHCEKOY MERKEZ MAH.,410,355,353,182,171
SARIYER,BAHCEKOY MERKEZ MAH.,410,376,364,169,195
SARIYER,BAHCEKOY MERKEZ MAH.,408,371,364,159,205
SARIYER,BAHCEKOY MERKEZ MAH.,411,376,372,179,193
SARIYER,BAHCEKOY MERKEZ MAH.,409,365,360,156,204
SARIYER,BAHCEKOY YENI MAH.,378,328,323,162,161
SARIYER,BAHCEKOY YENI MAH.,379,342,341,152,189
SARIYER,BAHCEKOY YENI MAH.,378,335,325,156,169
SARIYER,BAHCEKOY YENI MAH.,378,340,336,171,165
SARIYER,BAHCEKOY YENI MAH.,377,339,336,168,168
SARIYER,BAHCEKOY YENI MAH.,377,342,341,185,156
SARIYER,BAHCEKOY YENI MAH.,377,330,326,156,170
SARIYER,BAHCEKOY YENI MAH.,378,343,341,141,200
SARIYER,BAHCEKOY YENI MAH.,378,346,341,144,197
SARIYER,BAHCEKOY YENI MAH.,377,336,328,163,165
SARIYER,BUYUKDERE MAH.,418,360,345,85,260
SARIYER,BUYUKDERE MAH.,416,367,361,112,249
SARIYER,BUYUKDERE MAH.,415,362,350,107,243
SARIYER,BUYUKDERE MAH.,415,380,372,118,254
SARIYER,BUYUKDERE MAH.,417,382,375,154,221
SARIYER,BUYUKDERE MAH.,416,386,382,162,220
SARIYER,BUYUKDERE MAH.,416,374,368,137,231
SARIYER,BUYUKDERE MAH.,416,372,368,135,233
SARIYER,BUYUKDERE MAH.,415,366,361,132,229
SARIYER,BUYUKDERE MAH.,367,312,310,93,217
SARIYER,BUYUKDERE MAH.,367,321,318,125,193
SARIYER,BUYUKDERE MAH.,370,330,327,104,223
SARIYER,BUYUKDERE MAH.,368,315,311,86,225
SARIYER,BUYUKDERE MAH.,355,287,282,62,220
SARIYER,BUYUKDERE MAH.,356,321,313,103,210
SARIYER,BUYUKDERE MAH.,355,313,309,89,220
SARIYER,BUYUKDERE MAH.,356,311,308,99,209
SARIYER,BUYUKDERE MAH.,356,320,319,97,222
SARIYER,BUYUKDERE MAH.,356,322,319,122,197
SARIYER,CUMHURIYET MAH.,359,325,318,137,181
SARIYER,CUMHURIYET MAH.,359,334,333,137,196
SARIYER,CUMHURIYET MAH.,359,331,330,134,196
SARIYER,CUMHURIYET MAH.,360,328,323,148,175
SARIYER,CUMHURIYET MAH.,358,323,317,117,200
SARIYER,CUMHURIYET MAH.,359,323,320,124,196
SARIYER,CUMHURIYET MAH.,377,339,335,140,195
SARIYER,CUMHURIYET MAH.,375,349,344,196,148
SARIYER,CUMHURIYET MAH.,376,336,331,190,141
SARIYER,CUMHURIYET MAH.,375,348,343,183,160
SARIYER,CUMHURIYET MAH.,375,341,336,192,144
SARIYER,CUMHURIYET MAH.,375,345,344,182,162
SARIYER,CUMHURIYET MAH.,376,327,319,159,160
SARIYER,CUMHURIYET MAH.,376,337,336,199,137
SARIYER,CUMHURIYET MAH.,376,339,333,154,179
SARIYER,CUMHURIYET MAH.,376,353,351,167,184
SARIYER,CUMHURIYET MAH.,376,346,345,172,173
SARIYER,CUMHURIYET MAH.,378,334,329,172,157
SARIYER,CUMHURIYET MAH.,376,327,325,155,170
SARIYER,CUMHURIYET MAH.,377,335,328,177,151
SARIYER,CUMHURIYET MAH.,379,347,345,175,170
SARIYER,CUMHURIYET MAH.,379,330,325,191,134
SARIYER,CUMHURIYET MAH.,378,342,339,195,144
SARIYER,CAYIRBASI MAH.,404,349,335,127,208
SARIYER,CAYIRBASI MAH.,403,350,349,143,206
SARIYER,CAYIRBASI MAH.,401,353,348,146,202
SARIYER,CAYIRBASI MAH.,401,346,339,147,192
SARIYER,CAYIRBASI MAH.,401,359,354,141,213
SARIYER,CAYIRBASI MAH.,401,336,332,135,197
SARIYER,CAYIRBASI MAH.,402,335,332,139,193
SARIYER,CAYIRBASI MAH.,404,346,340,146,194
SARIYER,CAYIRBASI MAH.,401,333,327,121,206
SARIYER,CAYIRBASI MAH.,402,356,341,117,224
SARIYER,DEMIRCIKOY MAH.,312,273,269,88,181
SARIYER,DEMIRCIKOY MAH.,311,288,286,87,199
SARIYER,DEMIRCIKOY MAH.,312,283,282,75,207
SARIYER,FERAHEVLER MAH.,395,352,341,180,161
SARIYER,FERAHEVLER MAH.,393,342,336,142,194
SARIYER,FERAHEVLER MAH.,394,347,343,187,156
SARIYER,FERAHEVLER MAH.,394,347,341,193,148
SARIYER,FERAHEVLER MAH.,395,353,346,199,147
SARIYER,FERAHEVLER MAH.,394,361,346,180,166
SARIYER,FERAHEVLER MAH.,395,345,338,158,180
SARIYER,FERAHEVLER MAH.,395,358,352,181,171
SARIYER,FERAHEVLER MAH.,396,359,351,175,176
SARIYER,FERAHEVLER MAH.,394,364,362,184,178
SARIYER,FERAHEVLER MAH.,394,369,365,196,169
SARIYER,FERAHEVLER MAH.,394,356,348,205,143
SARIYER,FERAHEVLER MAH.,399,352,349,171,178
SARIYER,FERAHEVLER MAH.,393,368,363,190,173
SARIYER,FERAHEVLER MAH.,393,357,344,176,168
SARIYER,FERAHEVLER MAH.,394,356,350,198,152
SARIYER,FERAHEVLER MAH.,394,346,342,168,174
SARIYER,FERAHEVLER MAH.,393,348,344,204,140
SARIYER,FERAHEVLER MAH.,394,353,348,224,124
SARIYER,FERAHEVLER MAH.,378,327,322,152,170
SARIYER,FERAHEVLER MAH.,378,341,340,167,173
SARIYER,FERAHEVLER MAH.,379,353,348,156,192
SARIYER,FERAHEVLER MAH.,378,344,341,178,163
SARIYER,FERAHEVLER MAH.,379,342,338,172,166
SARIYER,FERAHEVLER MAH.,380,346,343,176,167
SARIYER,FERAHEVLER MAH.,379,356,353,189,164
SARIYER,FERAHEVLER MAH.,377,345,341,159,182
SARIYER,FERAHEVLER MAH.,379,337,336,185,151
SARIYER,FERAHEVLER MAH.,379,344,342,191,151
SARIYER,GARIPCE MAH.,307,291,289,236,53
SARIYER,GUMUSDERE MAH.,397,345,342,145,197
SARIYER,GUMUSDERE MAH.,396,352,345,162,183
SARIYER,GUMUSDERE MAH.,395,359,347,161,186
SARIYER,GUMUSDERE MAH.,397,359,350,143,207
SARIYER,KAZIM KARABEKIR PASA MAH.,360,308,302,127,175
SARIYER,KAZIM KARABEKIR PASA MAH.,359,314,311,126,185
SARIYER,KAZIM KARABEKIR PASA MAH.,361,310,307,127,180
SARIYER,KAZIM KARABEKIR PASA MAH.,392,364,358,63,295
SARIYER,KAZIM KARABEKIR PASA MAH.,391,360,350,73,277
SARIYER,KAZIM KARABEKIR PASA MAH.,390,360,355,87,268
SARIYER,KAZIM KARABEKIR PASA MAH.,392,346,341,77,264
SARIYER,KAZIM KARABEKIR PASA MAH.,391,356,353,81,272
SARIYER,KAZIM KARABEKIR PASA MAH.,394,354,350,87,263
SARIYER,KAZIM KARABEKIR PASA MAH.,390,354,349,67,282
SARIYER,KAZIM KARABEKIR PASA MAH.,374,322,317,157,160
SARIYER,KAZIM KARABEKIR PASA MAH.,373,331,327,164,163
SARIYER,KAZIM KARABEKIR PASA MAH.,371,329,325,160,165
SARIYER,KAZIM KARABEKIR PASA MAH.,372,322,320,141,179
SARIYER,KAZIM KARABEKIR PASA MAH.,372,321,312,164,148
SARIYER,KAZIM KARABEKIR PASA MAH.,372,339,338,161,177
SARIYER,KAZIM KARABEKIR PASA MAH.,371,337,331,197,134
SARIYER,BAHCEKOY KEMER MAH.,357,317,312,160,152
SARIYER,BAHCEKOY KEMER MAH.,353,316,310,170,140
SARIYER,BAHCEKOY KEMER MAH.,353,317,315,168,147
SARIYER,BAHCEKOY KEMER MAH.,354,322,315,145,170
SARIYER,BAHCEKOY KEMER MAH.,353,327,323,176,147
SARIYER,KISIRKAYA MAH.,293,257,252,105,147
SARIYER,KIRECBURNU MAH.,384,338,336,86,250
SARIYER,KIRECBURNU MAH.,384,346,343,81,262
SARIYER,KIRECBURNU MAH.,384,358,354,89,265
SARIYER,KIRECBURNU MAH.,383,344,341,89,252
SARIYER,KIRECBURNU MAH.,383,350,345,104,241
SARIYER,KIRECBURNU MAH.,376,330,327,68,259
SARIYER,KIRECBURNU MAH.,376,338,333,50,283
SARIYER,KIRECBURNU MAH.,374,325,323,126,197
SARIYER,KIRECBURNU MAH.,376,351,345,120,225
SARIYER,KIRECBURNU MAH.,415,362,358,109,249
SARIYER,KIRECBURNU MAH.,415,369,364,128,236
SARIYER,KIRECBURNU MAH.,414,371,369,136,233
SARIYER,KIRECBURNU MAH.,415,366,362,156,206
SARIYER,KIRECBURNU MAH.,415,380,373,145,228
SARIYER,KOCATAS MAH.,387,330,323,135,188
SARIYER,KOCATAS MAH.,389,340,336,159,177
SARIYER,KOCATAS MAH.,388,340,332,165,167
SARIYER,KOCATAS MAH.,388,336,328,168,160
SARIYER,KOCATAS MAH.,387,346,343,170,173
SARIYER,KOCATAS MAH.,388,348,344,179,165
SARIYER,KOCATAS MAH.,388,334,329,196,133
SARIYER,KOCATAS MAH.,387,331,323,178,145
SARIYER,KOCATAS MAH.,387,351,346,163,183
SARIYER,KUMKOY (KILYOS) MAH.,405,354,350,94,256
SARIYER,KUMKOY (KILYOS) MAH.,406,376,370,130,240
SARIYER,KUMKOY (KILYOS) MAH.,405,365,362,122,240
SARIYER,KUMKOY (KILYOS) MAH.,407,367,363,111,252
SARIYER,KUMKOY (KILYOS) MAH.,406,353,351,124,227
SARIYER,KUMKOY (KILYOS) MAH.,408,374,371,104,267
SARIYER,MADEN MAH.,395,317,309,132,177
SARIYER,MADEN MAH.,397,351,341,142,199
SARIYER,MADEN MAH.,395,354,350,159,191
SARIYER,MADEN MAH.,394,354,350,147,203
SARIYER,MADEN MAH.,395,351,347,150,197
SARIYER,MADEN MAH.,393,345,345,158,187
SARIYER,MADEN MAH.,395,338,331,170,161
SARIYER,MADEN MAH.,397,343,335,151,184
SARIYER,MADEN MAH.,371,330,328,112,216
SARIYER,MADEN MAH.,371,333,324,103,221
SARIYER,MADEN MAH.,370,333,331,91,240
SARIYER,MADEN MAH.,371,323,323,68,255
SARIYER,MADEN MAH.,370,331,325,108,217
SARIYER,MADEN MAH.,350,302,300,128,172
SARIYER,MADEN MAH.,350,309,306,140,166
SARIYER,MADEN MAH.,350,316,313,145,168
SARIYER,MADEN MAH.,351,308,306,176,130
SARIYER,MADEN MAH.,350,316,309,161,148
SARIYER,MADEN MAH.,349,306,299,157,142
SARIYER,MADEN MAH.,377,328,319,162,157
SARIYER,MADEN MAH.,376,337,329,141,188
SARIYER,MADEN MAH.,377,342,331,145,186
SARIYER,MADEN MAH.,376,342,337,151,186
SARIYER,MADEN MAH.,376,340,331,123,208
SARIYER,MADEN MAH.,376,330,314,116,198
SARIYER,MADEN MAH.,377,348,336,151,185
SARIYER,MADEN MAH.,381,338,332,152,180
SARIYER,SARIYER MERKEZ MAH.,383,327,324,133,191
SARIYER,SARIYER MERKEZ MAH.,384,317,312,126,186
SARIYER,SARIYER MERKEZ MAH.,384,342,339,137,202
SARIYER,SARIYER MERKEZ MAH.,384,363,363,167,196
SARIYER,SARIYER MERKEZ MAH.,382,333,328,135,193
SARIYER,SARIYER MERKEZ MAH.,383,331,329,169,160
SARIYER,SARIYER MERKEZ MAH.,383,330,326,146,180
SARIYER,SARIYER MERKEZ MAH.,384,335,333,144,189
SARIYER,SARIYER MERKEZ MAH.,396,329,323,117,206
SARIYER,SARIYER MERKEZ MAH.,396,346,343,163,180
SARIYER,SARIYER MERKEZ MAH.,398,350,342,134,208
SARIYER,SARIYER MERKEZ MAH.,395,356,351,113,238
SARIYER,SARIYER MERKEZ MAH.,395,342,338,128,210
SARIYER,SARIYER MERKEZ MAH.,394,349,344,139,205
SARIYER,SARIYER MERKEZ MAH.,368,291,286,144,142
SARIYER,SARIYER MERKEZ MAH.,370,340,335,152,183
SARIYER,SARIYER MERKEZ MAH.,369,323,321,146,175
SARIYER,SARIYER MERKEZ MAH.,367,332,328,164,164
SARIYER,SARIYER MERKEZ MAH.,369,320,316,138,178
SARIYER,SARIYER MERKEZ MAH.,369,321,319,152,167
SARIYER,SARIYER MERKEZ MAH.,369,319,313,123,190
SARIYER,SARIYER MERKEZ MAH.,366,289,285,91,194
SARIYER,SARIYER MERKEZ MAH.,366,307,302,92,210
SARIYER,SARIYER MERKEZ MAH.,365,330,323,108,215
SARIYER,SARIYER MERKEZ MAH.,366,324,322,119,203
SARIYER,SARIYER MERKEZ MAH.,368,319,317,126,191
SARIYER,SARIYER MERKEZ MAH.,366,324,322,104,218
SARIYER,PTT EVLERI MAH.,366,321,315,202,113
SARIYER,PTT EVLERI MAH.,363,329,328,187,141
SARIYER,PTT EVLERI MAH.,363,335,330,179,151
SARIYER,PTT EVLERI MAH.,362,334,325,170,155
SARIYER,PTT EVLERI MAH.,363,329,328,153,175
SARIYER,PTT EVLERI MAH.,363,312,308,166,142
SARIYER,PTT EVLERI MAH.,363,324,320,165,155
SARIYER,PTT EVLERI MAH.,364,325,320,164,156
SARIYER,PTT EVLERI MAH.,365,325,320,173,147
SARIYER,PTT EVLERI MAH.,362,335,333,192,141
SARIYER,RUMELIKAVAGI MAH.,411,307,300,121,179
SARIYER,RUMELIKAVAGI MAH.,410,349,343,165,178
SARIYER,RUMELIKAVAGI MAH.,410,362,358,174,184
SARIYER,RUMELIKAVAGI MAH.,410,353,348,167,181
SARIYER,RUMELIKAVAGI MAH.,409,356,352,165,187
SARIYER,RUMELIKAVAGI MAH.,410,360,354,175,179
SARIYER,RUMELIKAVAGI MAH.,409,359,354,189,165
SARIYER,RUMELIFENERI MAH.,394,311,304,216,88
SARIYER,RUMELIFENERI MAH.,394,333,332,180,152
SARIYER,RUMELIFENERI MAH.,395,361,360,191,169
SARIYER,RUMELIFENERI MAH.,395,355,349,226,123
SARIYER,TARABYA MAH.,364,316,312,117,195
SARIYER,TARABYA MAH.,363,313,311,123,188
SARIYER,TARABYA MAH.,363,328,325,141,184
SARIYER,TARABYA MAH.,362,324,321,125,196
SARIYER,TARABYA MAH.,362,327,320,125,195
SARIYER,TARABYA MAH.,362,321,319,123,196
SARIYER,TARABYA MAH.,362,328,326,116,210
SARIYER,TARABYA MAH.,374,336,335,135,200
SARIYER,TARABYA MAH.,373,348,345,95,250
SARIYER,TARABYA MAH.,243,227,221,74,147
SARIYER,TARABYA MAH.,245,228,224,94,130
SARIYER,TARABYA MAH.,226,215,206,86,120
SARIYER,TARABYA MAH.,225,198,197,50,147
SARIYER,TARABYA MAH.,419,375,374,83,291
SARIYER,TARABYA MAH.,339,299,297,65,232
SARIYER,TARABYA MAH.,262,244,241,41,200
SARIYER,TARABYA MAH.,262,234,234,29,205
SARIYER,TARABYA MAH.,364,326,316,147,169
SARIYER,TARABYA MAH.,364,321,319,118,201
SARIYER,TARABYA MAH.,364,323,317,123,194
SARIYER,TARABYA MAH.,364,317,314,111,203
SARIYER,TARABYA MAH.,364,322,320,134,186
SARIYER,TARABYA MAH.,364,315,313,124,189
SARIYER,TARABYA MAH.,364,315,315,108,207
SARIYER,TARABYA MAH.,388,337,332,81,251
SARIYER,TARABYA MAH.,389,332,329,105,224
SARIYER,TARABYA MAH.,388,352,345,88,257
SARIYER,TARABYA MAH.,388,355,351,83,268
SARIYER,TARABYA MAH.,389,358,353,66,287
SARIYER,TARABYA MAH.,387,350,345,97,248
SARIYER,TARABYA MAH.,388,364,361,115,246
SARIYER,TARABYA MAH.,390,355,353,104,249
SARIYER,TARABYA MAH.,387,350,346,87,259
SARIYER,TARABYA MAH.,388,342,340,91,249
SARIYER,TARABYA MAH.,388,363,359,84,275
SARIYER,TARABYA MAH.,388,355,354,78,276
SARIYER,TARABYA MAH.,388,356,353,110,243
SARIYER,TARABYA MAH.,388,362,354,98,256
SARIYER,TARABYA MAH.,301,275,270,99,171
SARIYER,USKUMRUKOY MAH.,406,348,340,62,278
SARIYER,USKUMRUKOY MAH.,406,367,364,71,293
SARIYER,USKUMRUKOY MAH.,406,369,364,53,311
SARIYER,USKUMRUKOY MAH.,407,379,376,51,325
SARIYER,USKUMRUKOY MAH.,407,373,370,71,299
SARIYER,USKUMRUKOY MAH.,406,368,365,61,304
SARIYER,USKUMRUKOY MAH.,406,375,369,73,296
SARIYER,USKUMRUKOY MAH.,406,357,355,56,299
SARIYER,USKUMRUKOY MAH.,406,370,366,63,303
SARIYER,USKUMRUKOY MAH.,407,378,378,37,341
SARIYER,USKUMRUKOY MAH.,405,388,384,25,359
SARIYER,USKUMRUKOY MAH.,406,388,382,47,335
SARIYER,USKUMRUKOY MAH.,405,380,376,40,336
SARIYER,YENI MAH.,365,312,309,155,154
SARIYER,YENI MAH.,366,329,326,167,159
SARIYER,YENI MAH.,365,313,311,169,142
SARIYER,YENI MAH.,365,335,330,181,149
SARIYER,YENI MAH.,335,290,284,133,151
SARIYER,YENI MAH.,332,302,301,126,175
SARIYER,YENI MAH.,325,274,271,143,128
SARIYER,YENI MAH.,325,274,270,137,133
SARIYER,ZEKERIYAKOY MAH.,404,365,360,54,306
SARIYER,ZEKERIYAKOY MAH.,403,349,344,45,299
SARIYER,ZEKERIYAKOY MAH.,405,361,360,66,294
SARIYER,ZEKERIYAKOY MAH.,404,367,366,60,306
SARIYER,ZEKERIYAKOY MAH.,403,359,358,47,311
SARIYER,ZEKERIYAKOY MAH.,404,350,346,50,296
SARIYER,ZEKERIYAKOY MAH.,404,352,348,52,296
SARIYER,ZEKERIYAKOY MAH.,404,372,367,60,307
SARIYER,ZEKERIYAKOY MAH.,360,343,340,39,301
SARIYER,ZEKERIYAKOY MAH.,357,337,334,41,293
SARIYER,ZEKERIYAKOY MAH.,357,339,337,30,307
SARIYER,ZEKERIYAKOY MAH.,358,328,322,42,280
SARIYER,ZEKERIYAKOY MAH.,358,333,328,31,297
SARIYER,ZEKERIYAKOY MAH.,415,363,355,53,302
SARIYER,ZEKERIYAKOY MAH.,415,359,357,50,307
SARIYER,ZEKERIYAKOY MAH.,412,370,367,78,289
SARIYER,ZEKERIYAKOY MAH.,415,378,374,60,314
SARIYER,ZEKERIYAKOY MAH.,415,370,368,50,318
SARIYER,ZEKERIYAKOY MAH.,415,381,376,41,335
SARIYER,ZEKERIYAKOY MAH.,413,381,380,53,327
SARIYER,ZEKERIYAKOY MAH.,415,376,371,57,314
SARIYER,ZEKERIYAKOY MAH.,413,380,371,50,321
SARIYER,ZEKERIYAKOY MAH.,415,379,376,54,322
SARIYER,ZEKERIYAKOY MAH.,413,380,377,71,306
SARIYER,ZEKERIYAKOY MAH.,413,381,378,63,315
SARIYER,ZEKERIYAKOY MAH.,413,380,375,61,314
SARIYER,ZEKERIYAKOY MAH.,412,369,362,70,292
SARIYER,ZEKERIYAKOY MAH.,414,377,375,47,328
SARIYER,ZEKERIYAKOY MAH.,413,380,374,53,321
SARIYER,ZEKERIYAKOY MAH.,414,378,378,67,311
SARIYER,ZEKERIYAKOY MAH.,414,368,359,39,320
SARIYER,ZEKERIYAKOY MAH.,412,382,377,67,310
SARIYER,ZEKERIYAKOY MAH.,413,382,379,44,335
SARIYER,AYAZAGA MAH.,415,342,335,207,128
SARIYER,AYAZAGA MAH.,411,344,338,222,116
SARIYER,AYAZAGA MAH.,411,358,357,183,174
SARIYER,AYAZAGA MAH.,412,354,347,205,142
SARIYER,AYAZAGA MAH.,411,360,355,230,125
SARIYER,AYAZAGA MAH.,410,366,363,218,145
SARIYER,AYAZAGA MAH.,410,362,359,213,146
SARIYER,AYAZAGA MAH.,410,358,355,219,136
SARIYER,AYAZAGA MAH.,411,377,372,211,161
SARIYER,AYAZAGA MAH.,410,357,351,184,167
SARIYER,AYAZAGA MAH.,411,363,360,204,156
SARIYER,AYAZAGA MAH.,410,368,363,191,172
SARIYER,AYAZAGA MAH.,410,356,352,225,127
SARIYER,AYAZAGA MAH.,411,375,367,228,139
SARIYER,AYAZAGA MAH.,411,358,353,199,154
SARIYER,AYAZAGA MAH.,411,357,351,213,138
SARIYER,AYAZAGA MAH.,410,354,347,210,137
SARIYER,AYAZAGA MAH.,410,363,361,246,115
SARIYER,AYAZAGA MAH.,411,350,345,218,127
SARIYER,AYAZAGA MAH.,411,363,357,208,149
SARIYER,AYAZAGA MAH.,410,366,356,210,146
SARIYER,AYAZAGA MAH.,411,347,344,203,141
SARIYER,AYAZAGA MAH.,410,357,354,208,146
SARIYER,AYAZAGA MAH.,411,355,353,181,172
SARIYER,AYAZAGA MAH.,415,330,318,220,98
SARIYER,AYAZAGA MAH.,409,332,321,214,107
SARIYER,AYAZAGA MAH.,410,351,345,221,124
SARIYER,AYAZAGA MAH.,409,349,344,218,126
SARIYER,AYAZAGA MAH.,409,364,350,247,103
SARIYER,AYAZAGA MAH.,409,352,347,204,143
SARIYER,AYAZAGA MAH.,409,357,345,236,109
SARIYER,AYAZAGA MAH.,410,363,352,231,121
SARIYER,AYAZAGA MAH.,410,368,364,220,144
SARIYER,AYAZAGA MAH.,411,361,359,235,124
SARIYER,AYAZAGA MAH.,410,353,346,225,121
SARIYER,AYAZAGA MAH.,410,358,353,230,123
SARIYER,AYAZAGA MAH.,410,358,354,221,133
SARIYER,AYAZAGA MAH.,410,370,368,232,136
SARIYER,AYAZAGA MAH.,408,344,337,197,140
SARIYER,AYAZAGA MAH.,410,343,340,199,141
SARIYER,AYAZAGA MAH.,409,353,348,206,142
SARIYER,AYAZAGA MAH.,410,371,369,214,155
SARIYER,AYAZAGA MAH.,409,362,357,229,128
SARIYER,AYAZAGA MAH.,409,353,351,234,117
SARIYER,AYAZAGA MAH.,409,345,336,203,133
SARIYER,AYAZAGA MAH.,410,353,346,216,130
SARIYER,AYAZAGA MAH.,410,359,355,237,118
SARIYER,AYAZAGA MAH.,409,365,362,232,130
SARIYER,AYAZAGA MAH.,410,355,352,216,136
SARIYER,AYAZAGA MAH.,410,354,349,229,120
SARIYER,AYAZAGA MAH.,409,357,354,235,119
SARIYER,AYAZAGA MAH.,409,350,345,217,128
SARIYER,AYAZAGA MAH.,403,336,333,238,95
SARIYER,AYAZAGA MAH.,404,357,351,212,139
SARIYER,AYAZAGA MAH.,403,343,340,177,163
SARIYER,AYAZAGA MAH.,403,357,355,225,130
SARIYER,AYAZAGA MAH.,405,351,349,214,135
SARIYER,AYAZAGA MAH.,403,356,352,210,142
SARIYER,AYAZAGA MAH.,403,367,362,199,163
SARIYER,AYAZAGA MAH.,404,358,350,199,151
SARIYER,AYAZAGA MAH.,403,355,348,202,146
SARIYER,AYAZAGA MAH.,403,340,337,225,112
SARIYER,BALTALIMANI MAH.,379,345,343,152,191
SARIYER,BALTALIMANI MAH.,379,348,341,179,162
SARIYER,BALTALIMANI MAH.,379,333,328,150,178
SARIYER,BALTALIMANI MAH.,379,336,333,163,170
SARIYER,BALTALIMANI MAH.,379,337,335,77,258
SARIYER,BALTALIMANI MAH.,379,357,348,107,241
SARIYER,BALTALIMANI MAH.,380,338,335,97,238
SARIYER,BALTALIMANI MAH.,380,349,344,105,239
SARIYER,BALTALIMANI MAH.,382,344,338,91,247
SARIYER,BALTALIMANI MAH.,380,349,347,80,267
SARIYER,BALTALIMANI MAH.,380,349,346,84,262
SARIYER,CAMLITEPE MAH.,381,327,316,169,147
SARIYER,CAMLITEPE MAH.,382,346,341,148,193
SARIYER,CAMLITEPE MAH.,382,350,346,140,206
SARIYER,CAMLITEPE MAH.,381,334,330,183,147
SARIYER,CAMLITEPE MAH.,382,342,339,156,183
SARIYER,CAMLITEPE MAH.,382,339,333,140,193
SARIYER,CAMLITEPE MAH.,381,324,317,123,194
SARIYER,CAMLITEPE MAH.,382,331,322,137,185
SARIYER,CAMLITEPE MAH.,381,347,343,119,224
SARIYER,CAMLITEPE MAH.,384,348,344,138,206
SARIYER,CAMLITEPE MAH.,382,344,338,145,193
SARIYER,CAMLITEPE MAH.,382,331,327,180,147
SARIYER,DARUSSAFAKA MAH.,409,343,340,52,288
SARIYER,DARUSSAFAKA MAH.,409,353,349,34,315
SARIYER,DARUSSAFAKA MAH.,408,374,371,39,332
SARIYER,DARUSSAFAKA MAH.,408,367,366,52,314
SARIYER,DARUSSAFAKA MAH.,415,376,375,46,329
SARIYER,DARUSSAFAKA MAH.,409,385,380,60,320
SARIYER,DARUSSAFAKA MAH.,408,375,372,41,331
SARIYER,DARUSSAFAKA MAH.,408,372,368,51,317
SARIYER,DARUSSAFAKA MAH.,408,381,380,40,340
SARIYER,DARUSSAFAKA MAH.,414,379,372,30,342
SARIYER,DARUSSAFAKA MAH.,409,381,378,41,337
SARIYER,DARUSSAFAKA MAH.,407,365,360,40,320
SARIYER,DARUSSAFAKA MAH.,408,388,381,48,333
SARIYER,DARUSSAFAKA MAH.,409,385,381,53,328
SARIYER,DARUSSAFAKA MAH.,409,363,358,49,309
SARIYER,DARUSSAFAKA MAH.,408,364,361,28,333
SARIYER,DARUSSAFAKA MAH.,409,374,367,50,317
SARIYER,EMIRGAN MAH.,355,282,278,58,220
SARIYER,EMIRGAN MAH.,358,303,301,87,214
SARIYER,EMIRGAN MAH.,355,322,320,83,237
SARIYER,EMIRGAN MAH.,355,330,329,88,241
SARIYER,EMIRGAN MAH.,354,324,322,74,248
SARIYER,EMIRGAN MAH.,355,302,299,73,226
SARIYER,EMIRGAN MAH.,388,320,318,117,201
SARIYER,EMIRGAN MAH.,386,332,327,124,203
SARIYER,EMIRGAN MAH.,387,340,336,140,196
SARIYER,EMIRGAN MAH.,388,327,322,117,205
SARIYER,EMIRGAN MAH.,388,330,328,145,183
SARIYER,EMIRGAN MAH.,371,291,288,108,180
SARIYER,EMIRGAN MAH.,371,339,335,146,189
SARIYER,EMIRGAN MAH.,370,329,325,143,182
SARIYER,EMIRGAN MAH.,369,315,314,145,169
SARIYER,EMIRGAN MAH.,371,314,312,137,175
SARIYER,EMIRGAN MAH.,370,314,313,134,179
SARIYER,EMIRGAN MAH.,371,320,314,158,156
SARIYER,EMIRGAN MAH.,371,323,318,150,168
SARIYER,FATIH SULTAN MEHMET MAH.,408,347,341,171,170
SARIYER,FATIH SULTAN MEHMET MAH.,408,330,323,169,154
SARIYER,FATIH SULTAN MEHMET MAH.,408,355,349,162,187
SARIYER,FATIH SULTAN MEHMET MAH.,408,368,365,196,169
SARIYER,FATIH SULTAN MEHMET MAH.,409,382,377,215,162
SARIYER,FATIH SULTAN MEHMET MAH.,409,370,369,238,131
SARIYER,FATIH SULTAN MEHMET MAH.,410,354,348,183,165
SARIYER,FATIH SULTAN MEHMET MAH.,408,357,349,172,177
SARIYER,FATIH SULTAN MEHMET MAH.,408,363,354,171,183
SARIYER,FATIH SULTAN MEHMET MAH.,409,369,366,198,168
SARIYER,FATIH SULTAN MEHMET MAH.,415,360,357,189,168
SARIYER,FATIH SULTAN MEHMET MAH.,409,356,355,196,159
SARIYER,FATIH SULTAN MEHMET MAH.,409,358,354,187,167
SARIYER,FATIH SULTAN MEHMET MAH.,408,356,353,174,179
SARIYER,FATIH SULTAN MEHMET MAH.,407,359,357,192,165
SARIYER,FATIH SULTAN MEHMET MAH.,409,361,354,186,168
SARIYER,FATIH SULTAN MEHMET MAH.,409,365,365,208,157
SARIYER,FATIH SULTAN MEHMET MAH.,411,350,346,198,148
SARIYER,FATIH SULTAN MEHMET MAH.,408,357,351,173,178
SARIYER,FATIH SULTAN MEHMET MAH.,409,351,348,188,160
SARIYER,FATIH SULTAN MEHMET MAH.,408,355,352,204,148
SARIYER,FATIH SULTAN MEHMET MAH.,409,367,363,197,166
SARIYER,FATIH SULTAN MEHMET MAH.,408,363,360,200,160
SARIYER,FATIH SULTAN MEHMET MAH.,409,364,358,199,159
SARIYER,FATIH SULTAN MEHMET MAH.,408,362,356,219,137
SARIYER,FATIH SULTAN MEHMET MAH.,409,361,357,184,173
SARIYER,FATIH SULTAN MEHMET MAH.,409,356,346,190,156
SARIYER,FATIH SULTAN MEHMET MAH.,408,359,353,187,166
SARIYER,FATIH SULTAN MEHMET MAH.,408,338,334,194,140
SARIYER,HUZUR MAH.,372,351,350,44,306
SARIYER,HUZUR MAH.,370,356,356,30,326
SARIYER,HUZUR MAH.,369,345,343,27,316
SARIYER,HUZUR MAH.,370,355,353,27,326
SARIYER,HUZUR MAH.,370,361,359,29,330
SARIYER,HUZUR MAH.,370,355,350,20,330
SARIYER,HUZUR MAH.,371,358,351,33,318
SARIYER,HUZUR MAH.,370,352,349,18,331
SARIYER,HUZUR MAH.,369,360,356,22,334
SARIYER,HUZUR MAH.,416,374,368,259,109
SARIYER,HUZUR MAH.,415,356,352,219,133
SARIYER,HUZUR MAH.,415,359,350,214,136
SARIYER,HUZUR MAH.,414,364,360,216,144
SARIYER,HUZUR MAH.,415,346,344,201,143
SARIYER,HUZUR MAH.,416,331,324,206,118
SARIYER,ISTINYE MAH.,410,368,368,78,290
SARIYER,ISTINYE MAH.,412,375,370,91,279
SARIYER,ISTINYE MAH.,413,378,373,85,288
SARIYER,ISTINYE MAH.,409,375,372,116,256
SARIYER,ISTINYE MAH.,378,331,318,145,173
SARIYER,ISTINYE MAH.,379,326,323,167,156
SARIYER,ISTINYE MAH.,378,346,339,169,170
SARIYER,ISTINYE MAH.,378,332,328,163,165
SARIYER,ISTINYE MAH.,376,334,329,161,168
SARIYER,ISTINYE MAH.,378,338,333,181,152
SARIYER,ISTINYE MAH.,385,321,315,182,133
SARIYER,ISTINYE MAH.,388,347,345,204,141
SARIYER,ISTINYE MAH.,386,340,335,202,133
SARIYER,ISTINYE MAH.,387,352,345,184,161
SARIYER,ISTINYE MAH.,387,341,340,205,135
SARIYER,ISTINYE MAH.,384,346,345,212,133
SARIYER,ISTINYE MAH.,384,344,341,206,135
SARIYER,ISTINYE MAH.,384,357,352,201,151
SARIYER,ISTINYE MAH.,385,352,350,209,141
SARIYER,ISTINYE MAH.,386,342,340,195,145
SARIYER,ISTINYE MAH.,384,348,346,207,139
SARIYER,ISTINYE MAH.,384,336,335,183,152
SARIYER,ISTINYE MAH.,413,358,354,90,264
SARIYER,ISTINYE MAH.,415,367,365,91,274
SARIYER,ISTINYE MAH.,387,318,313,198,115
SARIYER,ISTINYE MAH.,387,346,339,173,166
SARIYER,ISTINYE MAH.,387,339,333,182,151
SARIYER,ISTINYE MAH.,387,341,337,195,142
SARIYER,ISTINYE MAH.,387,345,341,202,139
SARIYER,ISTINYE MAH.,386,351,346,209,137
SARIYER,ISTINYE MAH.,386,341,336,177,159
SARIYER,ISTINYE MAH.,386,340,338,187,151
SARIYER,MASLAK MAH.,363,329,326,52,274
SARIYER,MASLAK MAH.,362,340,339,36,303
SARIYER,MASLAK MAH.,362,329,328,39,289
SARIYER,MASLAK MAH.,363,315,311,52,259
SARIYER,MASLAK MAH.,363,331,330,34,296
SARIYER,MASLAK MAH.,362,324,322,46,276
SARIYER,MASLAK MAH.,366,328,328,40,288
SARIYER,MASLAK MAH.,330,300,292,70,222
SARIYER,MASLAK MAH.,331,287,284,75,209
SARIYER,MASLAK MAH.,329,298,293,77,216
SARIYER,MASLAK MAH.,330,302,300,75,225
SARIYER,PINAR MAH.,404,349,339,209,130
SARIYER,PINAR MAH.,403,352,352,203,149
SARIYER,PINAR MAH.,403,361,351,220,131
SARIYER,PINAR MAH.,401,371,367,217,150
SARIYER,PINAR MAH.,403,361,359,228,131
SARIYER,PINAR MAH.,402,371,365,200,165
SARIYER,PINAR MAH.,403,370,368,220,148
SARIYER,PINAR MAH.,401,356,353,213,140
SARIYER,PINAR MAH.,403,366,365,221,144
SARIYER,PINAR MAH.,404,368,362,211,151
SARIYER,PINAR MAH.,404,340,331,153,178
SARIYER,PINAR MAH.,398,339,332,172,160
SARIYER,PINAR MAH.,397,353,347,160,187
SARIYER,PINAR MAH.,398,348,345,162,183
SARIYER,PINAR MAH.,398,347,340,149,191
SARIYER,PINAR MAH.,397,360,355,175,180
SARIYER,PINAR MAH.,398,359,353,175,178
SARIYER,PINAR MAH.,398,359,356,173,183
SARIYER,PINAR MAH.,397,342,337,151,186
SARIYER,PINAR MAH.,397,339,331,134,197
SARIYER,PINAR MAH.,398,360,354,160,194
SARIYER,POLIGON MAH.,411,360,353,160,193
SARIYER,POLIGON MAH.,413,372,366,144,222
SARIYER,POLIGON MAH.,410,371,369,156,213
SARIYER,POLIGON MAH.,411,387,384,150,234
SARIYER,POLIGON MAH.,411,373,367,141,226
SARIYER,POLIGON MAH.,411,370,367,127,240
SARIYER,POLIGON MAH.,410,374,369,128,241
SARIYER,POLIGON MAH.,410,393,391,145,246
SARIYER,POLIGON MAH.,411,377,371,132,239
SARIYER,POLIGON MAH.,410,382,376,145,231
SARIYER,POLIGON MAH.,411,367,361,147,214
SARIYER,POLIGON MAH.,410,378,376,157,219
SARIYER,RESITPASA MAH.,366,301,299,103,196
SARIYER,RESITPASA MAH.,365,335,331,90,241
SARIYER,RESITPASA MAH.,367,328,325,115,210
SARIYER,RESITPASA MAH.,367,325,322,102,220
SARIYER,RESITPASA MAH.,365,321,318,122,196
SARIYER,RESITPASA MAH.,366,319,309,111,198
SARIYER,RESITPASA MAH.,365,319,315,112,203
SARIYER,RESITPASA MAH.,364,330,325,114,211
SARIYER,RESITPASA MAH.,364,316,315,109,206
SARIYER,RESITPASA MAH.,366,328,327,123,204
SARIYER,RESITPASA MAH.,406,336,329,132,197
SARIYER,RESITPASA MAH.,407,354,350,151,199
SARIYER,RESITPASA MAH.,407,352,348,181,167
SARIYER,RESITPASA MAH.,406,357,353,172,181
SARIYER,RESITPASA MAH.,406,353,349,165,184
SARIYER,RESITPASA MAH.,406,349,343,157,186
SARIYER,RESITPASA MAH.,406,357,349,160,189
SARIYER,RESITPASA MAH.,405,365,362,180,182
SARIYER,RESITPASA MAH.,405,349,342,169,173
SARIYER,RESITPASA MAH.,406,355,350,186,164
SARIYER,RESITPASA MAH.,406,371,368,181,187
SARIYER,RESITPASA MAH.,405,346,343,178,165
SARIYER,RESITPASA MAH.,405,354,351,161,190
SARIYER,RESITPASA MAH.,407,356,352,162,190
SARIYER,RESITPASA MAH.,351,328,326,83,243
SARIYER,RESITPASA MAH.,351,344,344,29,315
SARIYER,RESITPASA MAH.,351,328,325,83,242
SARIYER,RESITPASA MAH.,351,313,309,98,211
SARIYER,RESITPASA MAH.,351,297,296,74,222
SARIYER,RUMELIHISARI MAH.,367,330,324,72,252
SARIYER,RUMELIHISARI MAH.,366,344,335,90,245
SARIYER,RUMELIHISARI MAH.,366,338,334,74,260
SARIYER,RUMELIHISARI MAH.,367,340,335,73,262
SARIYER,RUMELIHISARI MAH.,389,342,340,47,293
SARIYER,RUMELIHISARI MAH.,389,357,353,70,283
SARIYER,RUMELIHISARI MAH.,389,353,348,65,283
SARIYER,RUMELIHISARI MAH.,390,345,345,93,252
SARIYER,RUMELIHISARI MAH.,407,367,363,106,257
SARIYER,RUMELIHISARI MAH.,406,371,365,87,278
SARIYER,RUMELIHISARI MAH.,407,360,356,77,279
SARIYER,RUMELIHISARI MAH.,409,370,366,100,266
SARIYER,RUMELIHISARI MAH.,406,349,348,89,259
SARIYER,RUMELIHISARI MAH.,407,368,366,78,288
SARIYER,RUMELIHISARI MAH.,405,350,343,86,257
SARIYER,RUMELIHISARI MAH.,406,370,368,89,279
SARIYER,RUMELIHISARI MAH.,392,336,331,33,298
SARIYER,RUMELIHISARI MAH.,392,348,342,29,313
SARIYER,RUMELIHISARI MAH.,392,347,344,49,295
SARIYER,YENIKOY MAH.,348,310,305,185,120
SARIYER,YENIKOY MAH.,345,321,318,193,125
SARIYER,YENIKOY MAH.,346,314,310,177,133
SARIYER,YENIKOY MAH.,345,316,313,210,103
SARIYER,YENIKOY MAH.,347,308,305,194,111
SARIYER,YENIKOY MAH.,377,304,300,73,227
SARIYER,YENIKOY MAH.,377,321,318,64,254
SARIYER,YENIKOY MAH.,377,343,341,78,263
SARIYER,YENIKOY MAH.,377,328,323,62,261
SARIYER,YENIKOY MAH.,377,331,329,80,249
SARIYER,YENIKOY MAH.,304,271,264,71,193
SARIYER,YENIKOY MAH.,304,284,281,74,207
SARIYER,YENIKOY MAH.,304,269,267,67,200
SARIYER,YENIKOY MAH.,404,337,334,120,214
SARIYER,YENIKOY MAH.,403,368,364,132,232
SARIYER,YENIKOY MAH.,404,359,350,138,212
SARIYER,YENIKOY MAH.,404,363,357,150,207
SARIYER,YENIKOY MAH.,405,367,362,140,222
SARIYER,YENIKOY MAH.,404,365,360,121,239
SARIYER,YENIKOY MAH.,384,330,321,158,163
SARIYER,YENIKOY MAH.,384,335,329,179,150
SARIYER,YENIKOY MAH.,383,360,358,205,153
SARIYER,YENIKOY MAH.,383,339,339,213,126
SARIYER,YENIKOY MAH.,383,354,349,194,155
SARIYER,YENIKOY MAH.,385,349,344,174,170
SARIYER,YENIKOY MAH.,383,352,349,207,142
SARIYER,YENIKOY MAH.,384,343,336,198,138
SARIYER,YENIKOY MAH.,384,347,343,190,153
SARIYER,YENIKOY MAH.,383,337,333,173,160
SARIYER,YENIKOY MAH.,384,350,347,193,154
SARIYER,YENIKOY MAH.,383,345,342,177,165
SARIYER,YENIKOY MAH.,384,351,343,177,166
GUNGOREN,ABDURRAHMAN NAFIZ GURMAN MAH.,392,321,316,95,221
GUNGOREN,ABDURRAHMAN NAFIZ GURMAN MAH.,392,319,314,93,221
GUNGOREN,ABDURRAHMAN NAFIZ GURMAN MAH.,392,332,326,102,224
GUNGOREN,ABDURRAHMAN NAFIZ GURMAN MAH.,392,353,353,117,236
GUNGOREN,ABDURRAHMAN NAFIZ GURMAN MAH.,393,348,343,100,243
GUNGOREN,ABDURRAHMAN NAFIZ GURMAN MAH.,392,360,357,122,235
GUNGOREN,ABDURRAHMAN NAFIZ GURMAN MAH.,392,345,340,98,242
GUNGOREN,ABDURRAHMAN NAFIZ GURMAN MAH.,392,359,352,95,257
GUNGOREN,ABDURRAHMAN NAFIZ GURMAN MAH.,392,366,365,117,248
GUNGOREN,ABDURRAHMAN NAFIZ GURMAN MAH.,395,358,352,113,239
GUNGOREN,ABDURRAHMAN NAFIZ GURMAN MAH.,393,364,360,101,259
GUNGOREN,ABDURRAHMAN NAFIZ GURMAN MAH.,394,355,351,120,231
GUNGOREN,ABDURRAHMAN NAFIZ GURMAN MAH.,392,353,349,129,220
GUNGOREN,ABDURRAHMAN NAFIZ GURMAN MAH.,393,353,350,114,236
GUNGOREN,ABDURRAHMAN NAFIZ GURMAN MAH.,392,349,344,112,232
GUNGOREN,ABDURRAHMAN NAFIZ GURMAN MAH.,392,355,352,109,243
GUNGOREN,ABDURRAHMAN NAFIZ GURMAN MAH.,392,365,362,114,248
GUNGOREN,ABDURRAHMAN NAFIZ GURMAN MAH.,404,325,321,82,239
GUNGOREN,ABDURRAHMAN NAFIZ GURMAN MAH.,404,336,325,86,239
GUNGOREN,ABDURRAHMAN NAFIZ GURMAN MAH.,404,338,330,114,216
GUNGOREN,ABDURRAHMAN NAFIZ GURMAN MAH.,407,328,327,103,224
GUNGOREN,ABDURRAHMAN NAFIZ GURMAN MAH.,406,339,335,95,240
GUNGOREN,ABDURRAHMAN NAFIZ GURMAN MAH.,405,358,355,132,223
GUNGOREN,ABDURRAHMAN NAFIZ GURMAN MAH.,404,369,365,118,247
GUNGOREN,ABDURRAHMAN NAFIZ GURMAN MAH.,406,353,351,121,230
GUNGOREN,ABDURRAHMAN NAFIZ GURMAN MAH.,404,361,359,116,243
GUNGOREN,ABDURRAHMAN NAFIZ GURMAN MAH.,404,381,379,134,245
GUNGOREN,ABDURRAHMAN NAFIZ GURMAN MAH.,403,378,371,101,270
GUNGOREN,ABDURRAHMAN NAFIZ GURMAN MAH.,403,362,359,117,242
GUNGOREN,ABDURRAHMAN NAFIZ GURMAN MAH.,403,359,357,111,246
GUNGOREN,ABDURRAHMAN NAFIZ GURMAN MAH.,404,370,368,130,238
GUNGOREN,ABDURRAHMAN NAFIZ GURMAN MAH.,403,370,362,117,245
GUNGOREN,ABDURRAHMAN NAFIZ GURMAN MAH.,404,361,360,117,243
GUNGOREN,ABDURRAHMAN NAFIZ GURMAN MAH.,404,371,364,116,248
GUNGOREN,ABDURRAHMAN NAFIZ GURMAN MAH.,404,371,370,150,220
GUNGOREN,ABDURRAHMAN NAFIZ GURMAN MAH.,403,363,358,134,224
GUNGOREN,ABDURRAHMAN NAFIZ GURMAN MAH.,404,371,368,109,259
GUNGOREN,ABDURRAHMAN NAFIZ GURMAN MAH.,403,372,368,121,247
GUNGOREN,ABDURRAHMAN NAFIZ GURMAN MAH.,403,354,350,119,231
GUNGOREN,ABDURRAHMAN NAFIZ GURMAN MAH.,404,359,348,84,264
GUNGOREN,ABDURRAHMAN NAFIZ GURMAN MAH.,405,379,376,117,259
GUNGOREN,ABDURRAHMAN NAFIZ GURMAN MAH.,403,348,340,103,237
GUNGOREN,ABDURRAHMAN NAFIZ GURMAN MAH.,405,374,364,123,241
GUNGOREN,GENCOSMAN MAH.,407,348,345,215,130
GUNGOREN,GENCOSMAN MAH.,406,358,350,226,124
GUNGOREN,GENCOSMAN MAH.,406,356,354,201,153
GUNGOREN,GENCOSMAN MAH.,408,374,369,208,161
GUNGOREN,GENCOSMAN MAH.,406,361,359,244,115
GUNGOREN,GENCOSMAN MAH.,415,391,387,221,166
GUNGOREN,GENCOSMAN MAH.,407,372,366,224,142
GUNGOREN,GENCOSMAN MAH.,408,378,374,189,185
GUNGOREN,GENCOSMAN MAH.,407,364,362,243,119
GUNGOREN,GENCOSMAN MAH.,407,372,369,216,153
GUNGOREN,GENCOSMAN MAH.,406,362,360,225,135
GUNGOREN,GENCOSMAN MAH.,407,358,355,216,139
GUNGOREN,GENCOSMAN MAH.,406,362,359,204,155
GUNGOREN,GENCOSMAN MAH.,407,387,384,180,204
GUNGOREN,GENCOSMAN MAH.,406,363,358,223,135
GUNGOREN,GENCOSMAN MAH.,406,352,347,177,170
GUNGOREN,GENCOSMAN MAH.,407,359,357,209,148
GUNGOREN,GENCOSMAN MAH.,406,378,375,231,144
GUNGOREN,GENCOSMAN MAH.,406,361,359,213,146
GUNGOREN,GENCOSMAN MAH.,407,373,367,205,162
GUNGOREN,GENCOSMAN MAH.,415,335,328,181,147
GUNGOREN,GENCOSMAN MAH.,415,375,371,217,154
GUNGOREN,GENCOSMAN MAH.,415,373,372,205,167
GUNGOREN,GENCOSMAN MAH.,415,356,349,197,152
GUNGOREN,GENCOSMAN MAH.,415,360,357,221,136
GUNGOREN,GENCOSMAN MAH.,415,383,376,208,168
GUNGOREN,GENCOSMAN MAH.,415,362,362,186,176
GUNGOREN,GENCOSMAN MAH.,415,369,362,226,136
GUNGOREN,GENCOSMAN MAH.,415,388,381,223,158
GUNGOREN,GENCOSMAN MAH.,414,383,380,225,155
GUNGOREN,GENCOSMAN MAH.,415,371,364,206,158
GUNGOREN,GENCOSMAN MAH.,414,364,362,215,147
GUNGOREN,GENCOSMAN MAH.,414,373,370,206,164
GUNGOREN,GENCOSMAN MAH.,415,381,374,208,166
GUNGOREN,GENCOSMAN MAH.,406,313,306,194,112
GUNGOREN,GENCOSMAN MAH.,405,341,336,186,150
GUNGOREN,GENCOSMAN MAH.,406,376,369,223,146
GUNGOREN,GENCOSMAN MAH.,407,349,343,184,159
GUNGOREN,GENCOSMAN MAH.,406,353,347,203,144
GUNGOREN,GENCOSMAN MAH.,407,356,349,216,133
GUNGOREN,GENCOSMAN MAH.,406,365,358,211,147
GUNGOREN,GENCOSMAN MAH.,407,363,358,206,152
GUNGOREN,GENCOSMAN MAH.,406,340,340,222,118
GUNGOREN,GENCOSMAN MAH.,406,359,351,237,114
GUNGOREN,GENCOSMAN MAH.,406,361,352,199,153
GUNGOREN,GENCOSMAN MAH.,407,336,334,181,153
GUNGOREN,GENCOSMAN MAH.,410,351,342,206,136
GUNGOREN,GENCOSMAN MAH.,406,369,364,227,137
GUNGOREN,GENCOSMAN MAH.,406,350,345,202,143
GUNGOREN,GENCOSMAN MAH.,407,355,352,213,139
GUNGOREN,GENCOSMAN MAH.,408,365,359,209,150
GUNGOREN,GENCOSMAN MAH.,399,312,305,156,149
GUNGOREN,GENCOSMAN MAH.,400,359,356,217,139
GUNGOREN,GENCOSMAN MAH.,399,339,338,178,160
GUNGOREN,GENCOSMAN MAH.,399,359,356,201,155
GUNGOREN,GENCOSMAN MAH.,397,350,343,192,151
GUNGOREN,GENCOSMAN MAH.,399,342,336,213,123
GUNGOREN,GENCOSMAN MAH.,399,348,345,191,154
GUNGOREN,GENCOSMAN MAH.,399,350,340,185,155
GUNGOREN,GENCOSMAN MAH.,398,340,333,210,123
GUNGOREN,GENCOSMAN MAH.,397,360,359,219,140
GUNGOREN,GENCOSMAN MAH.,399,355,348,218,130
GUNGOREN,GENCOSMAN MAH.,398,330,322,186,136
GUNGOREN,GENCOSMAN MAH.,398,370,365,230,135
GUNGOREN,GENCOSMAN MAH.,398,364,359,212,147
GUNGOREN,MEHMET NESIH OZMEN MAH.,415,354,347,130,217
GUNGOREN,MEHMET NESIH OZMEN MAH.,412,352,348,125,223
GUNGOREN,MEHMET NESIH OZMEN MAH.,412,380,372,161,211
GUNGOREN,MEHMET NESIH OZMEN MAH.,415,365,362,123,239
GUNGOREN,MEHMET NESIH OZMEN MAH.,412,381,379,177,202
GUNGOREN,MEHMET NESIH OZMEN MAH.,412,381,374,136,238
GUNGOREN,MEHMET NESIH OZMEN MAH.,410,381,373,140,233
GUNGOREN,MEHMET NESIH OZMEN MAH.,415,390,385,152,233
GUNGOREN,MEHMET NESIH OZMEN MAH.,415,379,373,165,208
GUNGOREN,MEHMET NESIH OZMEN MAH.,412,380,378,133,245
GUNGOREN,MEHMET NESIH OZMEN MAH.,411,374,370,137,233
GUNGOREN,MEHMET NESIH OZMEN MAH.,412,374,368,135,233
GUNGOREN,MEHMET NESIH OZMEN MAH.,415,391,386,151,235
GUNGOREN,MEHMET NESIH OZMEN MAH.,409,372,368,151,217
GUNGOREN,MEHMET NESIH OZMEN MAH.,415,365,363,128,235
GUNGOREN,MEHMET NESIH OZMEN MAH.,411,382,376,147,229
GUNGOREN,MEHMET NESIH OZMEN MAH.,412,373,369,164,205
GUNGOREN,MEHMET NESIH OZMEN MAH.,412,370,363,155,208
GUNGOREN,MERKEZ MAH.,404,319,311,174,137
GUNGOREN,MERKEZ MAH.,405,353,349,179,170
GUNGOREN,MERKEZ MAH.,404,360,358,192,166
GUNGOREN,MERKEZ MAH.,404,363,355,215,140
GUNGOREN,MERKEZ MAH.,404,363,354,193,161
GUNGOREN,MERKEZ MAH.,405,356,350,216,134
GUNGOREN,MERKEZ MAH.,403,359,354,169,185
GUNGOREN,MERKEZ MAH.,404,358,352,228,124
GUNGOREN,MERKEZ MAH.,403,355,353,197,156
GUNGOREN,MERKEZ MAH.,404,368,367,211,156
GUNGOREN,MERKEZ MAH.,404,355,350,181,169
GUNGOREN,MERKEZ MAH.,404,339,336,193,143
GUNGOREN,MERKEZ MAH.,404,360,357,210,147
GUNGOREN,MERKEZ MAH.,405,343,341,196,145
GUNGOREN,MERKEZ MAH.,404,357,352,205,147
GUNGOREN,MERKEZ MAH.,406,367,364,215,149
GUNGOREN,MERKEZ MAH.,404,362,359,197,162
GUNGOREN,MERKEZ MAH.,404,358,354,214,140
GUNGOREN,MERKEZ MAH.,404,355,352,209,143
GUNGOREN,MERKEZ MAH.,404,373,365,223,142
GUNGOREN,MERKEZ MAH.,403,367,358,205,153
GUNGOREN,MERKEZ MAH.,405,327,321,194,127
GUNGOREN,MERKEZ MAH.,404,328,327,212,115
GUNGOREN,MERKEZ MAH.,408,371,367,229,138
GUNGOREN,MERKEZ MAH.,404,341,336,205,131
GUNGOREN,MERKEZ MAH.,406,352,347,224,123
GUNGOREN,MERKEZ MAH.,404,347,343,213,130
GUNGOREN,MERKEZ MAH.,404,373,370,237,133
GUNGOREN,MERKEZ MAH.,404,359,357,228,129
GUNGOREN,MERKEZ MAH.,403,356,355,204,151
GUNGOREN,MERKEZ MAH.,403,356,352,220,132
GUNGOREN,MERKEZ MAH.,404,357,352,241,111
GUNGOREN,MERKEZ MAH.,404,367,360,232,128
GUNGOREN,MERKEZ MAH.,403,359,357,224,133
GUNGOREN,MERKEZ MAH.,406,371,370,248,122
GUNGOREN,MERKEZ MAH.,404,360,357,227,130
GUNGOREN,MERKEZ MAH.,403,362,354,218,136
GUNGOREN,MERKEZ MAH.,403,364,358,235,123
GUNGOREN,MERKEZ MAH.,404,359,349,214,135
GUNGOREN,MERKEZ MAH.,404,362,356,226,130
GUNGOREN,MERKEZ MAH.,404,359,356,214,142
GUNGOREN,MERKEZ MAH.,403,364,357,250,107
GUNGOREN,MERKEZ MAH.,403,372,368,222,146
GUNGOREN,MERKEZ MAH.,403,370,368,248,120
GUNGOREN,MERKEZ MAH.,399,323,321,205,116
GUNGOREN,MERKEZ MAH.,400,328,323,177,146
GUNGOREN,MERKEZ MAH.,402,341,335,204,131
GUNGOREN,MERKEZ MAH.,399,365,358,210,148
GUNGOREN,MERKEZ MAH.,401,348,342,219,123
GUNGOREN,MERKEZ MAH.,399,346,340,204,136
GUNGOREN,MERKEZ MAH.,398,357,351,196,155
GUNGOREN,MERKEZ MAH.,399,349,345,196,149
GUNGOREN,MERKEZ MAH.,399,350,344,191,153
GUNGOREN,MERKEZ MAH.,398,355,350,203,147
GUNGOREN,MERKEZ MAH.,399,336,329,181,148
GUNGOREN,MERKEZ MAH.,399,353,347,202,145
GUNGOREN,MERKEZ MAH.,398,360,359,209,150
GUNGOREN,MERKEZ MAH.,400,357,354,204,150
GUNGOREN,MERKEZ MAH.,399,324,318,172,146
GUNGOREN,MERKEZ MAH.,398,357,352,226,126
GUNGOREN,MERKEZ MAH.,399,348,339,203,136
GUNGOREN,MERKEZ MAH.,398,349,344,220,124
GUNGOREN,MERKEZ MAH.,399,335,327,208,119
GUNGOREN,MERKEZ MAH.,398,336,332,215,117
GUNGOREN,MERKEZ MAH.,399,341,331,192,139
GUNGOREN,MERKEZ MAH.,398,348,343,207,136
GUNGOREN,MERKEZ MAH.,399,352,347,208,139
GUNGOREN,MERKEZ MAH.,403,300,292,167,125
GUNGOREN,MERKEZ MAH.,403,329,322,174,148
GUNGOREN,MERKEZ MAH.,402,353,351,202,149
GUNGOREN,MERKEZ MAH.,403,352,346,222,124
GUNGOREN,MERKEZ MAH.,402,357,354,201,153
GUNGOREN,MERKEZ MAH.,402,357,355,228,127
GUNGOREN,MERKEZ MAH.,409,347,345,198,147
GUNGOREN,MERKEZ MAH.,402,357,354,203,151
GUNGOREN,MERKEZ MAH.,403,355,347,190,157
GUNGOREN,MERKEZ MAH.,402,347,340,190,150
GUNGOREN,MERKEZ MAH.,402,362,357,213,144
GUNGOREN,MERKEZ MAH.,402,340,337,205,132
GUNGOREN,MERKEZ MAH.,402,349,344,200,144
GUNGOREN,MERKEZ MAH.,404,358,352,187,165
GUNGOREN,MERKEZ MAH.,403,344,337,175,162
GUNGOREN,MERKEZ MAH.,403,360,357,234,123
GUNGOREN,MERKEZ MAH.,402,356,355,204,151
GUNGOREN,MERKEZ MAH.,402,370,358,192,166
GUNGOREN,SANAYI MAH.,403,331,322,175,147
GUNGOREN,SANAYI MAH.,402,332,326,170,156
GUNGOREN,SANAYI MAH.,402,361,352,215,137
GUNGOREN,SANAYI MAH.,403,370,365,208,157
GUNGOREN,SANAYI MAH.,402,351,348,197,151
GUNGOREN,SANAYI MAH.,403,355,350,196,154
GUNGOREN,SANAYI MAH.,402,359,356,198,158
GUNGOREN,SANAYI MAH.,404,357,355,195,160
GUNGOREN,SANAYI MAH.,402,358,346,204,142
GUNGOREN,SANAYI MAH.,402,353,347,183,164
GUNGOREN,SANAYI MAH.,403,350,348,194,154
GUNGOREN,SANAYI MAH.,403,361,360,221,139
GUNGOREN,SANAYI MAH.,406,363,361,195,166
GUNGOREN,SANAYI MAH.,402,353,348,211,137
GUNGOREN,SANAYI MAH.,405,368,365,214,151
GUNGOREN,SANAYI MAH.,402,357,355,201,154
GUNGOREN,SANAYI MAH.,403,359,353,192,161
GUNGOREN,SANAYI MAH.,403,359,354,202,152
GUNGOREN,SANAYI MAH.,402,341,340,183,157
GUNGOREN,SANAYI MAH.,402,334,326,210,116
GUNGOREN,SANAYI MAH.,403,345,341,203,138
GUNGOREN,SANAYI MAH.,402,344,343,205,138
GUNGOREN,SANAYI MAH.,403,350,347,191,156
GUNGOREN,SANAYI MAH.,403,369,364,184,180
GUNGOREN,TOZKOPARAN MAH.,393,301,295,113,182
GUNGOREN,TOZKOPARAN MAH.,392,319,317,111,206
GUNGOREN,TOZKOPARAN MAH.,393,353,346,139,207
GUNGOREN,TOZKOPARAN MAH.,393,343,339,128,211
GUNGOREN,TOZKOPARAN MAH.,391,344,341,127,214
GUNGOREN,TOZKOPARAN MAH.,392,340,335,136,199
GUNGOREN,TOZKOPARAN MAH.,391,349,346,137,209
GUNGOREN,TOZKOPARAN MAH.,393,357,353,150,203
GUNGOREN,TOZKOPARAN MAH.,393,348,339,124,215
GUNGOREN,TOZKOPARAN MAH.,392,330,328,110,218
GUNGOREN,TOZKOPARAN MAH.,392,347,341,111,230
GUNGOREN,TOZKOPARAN MAH.,395,350,349,133,216
GUNGOREN,TOZKOPARAN MAH.,392,338,334,119,215
GUNGOREN,TOZKOPARAN MAH.,393,324,316,137,179
GUNGOREN,TOZKOPARAN MAH.,392,342,340,140,200
GUNGOREN,TOZKOPARAN MAH.,393,352,348,171,177
GUNGOREN,TOZKOPARAN MAH.,392,348,343,158,185
GUNGOREN,TOZKOPARAN MAH.,391,352,344,145,199
GUNGOREN,TOZKOPARAN MAH.,393,365,361,170,191
GUNGOREN,TOZKOPARAN MAH.,391,338,335,176,159
GUNGOREN,TOZKOPARAN MAH.,392,348,341,168,173
GUNGOREN,TOZKOPARAN MAH.,393,346,339,173,166
GUNGOREN,TOZKOPARAN MAH.,406,297,291,113,178
GUNGOREN,TOZKOPARAN MAH.,406,317,312,143,169
GUNGOREN,TOZKOPARAN MAH.,406,344,340,148,192
GUNGOREN,TOZKOPARAN MAH.,407,361,350,145,205
GUNGOREN,TOZKOPARAN MAH.,408,362,355,153,202
GUNGOREN,TOZKOPARAN MAH.,406,371,369,171,198
GUNGOREN,TOZKOPARAN MAH.,406,352,347,177,170
GUNGOREN,TOZKOPARAN MAH.,406,359,356,159,197
GUNGOREN,TOZKOPARAN MAH.,405,349,344,161,183
GUNGOREN,TOZKOPARAN MAH.,405,328,326,146,180
GUNGOREN,TOZKOPARAN MAH.,407,361,358,159,199
GUNGOREN,TOZKOPARAN MAH.,405,364,360,150,210
GUNGOREN,TOZKOPARAN MAH.,406,374,369,163,206
GUNGOREN,TOZKOPARAN MAH.,406,357,355,160,195
GUNGOREN,TOZKOPARAN MAH.,406,364,361,142,219
GUNGOREN,AKINCILAR MAH.,398,323,312,183,129
GUNGOREN,AKINCILAR MAH.,396,324,320,187,133
GUNGOREN,AKINCILAR MAH.,397,350,345,184,161
GUNGOREN,AKINCILAR MAH.,396,338,336,208,128
GUNGOREN,AKINCILAR MAH.,396,344,342,209,133
GUNGOREN,AKINCILAR MAH.,396,335,327,217,110
GUNGOREN,AKINCILAR MAH.,396,353,347,201,146
GUNGOREN,AKINCILAR MAH.,395,351,345,223,122
GUNGOREN,AKINCILAR MAH.,394,343,335,208,127
GUNGOREN,AKINCILAR MAH.,396,348,342,198,144
GUNGOREN,AKINCILAR MAH.,395,362,354,194,160
GUNGOREN,AKINCILAR MAH.,395,350,349,201,148
GUNGOREN,AKINCILAR MAH.,395,348,345,217,128
GUNGOREN,AKINCILAR MAH.,394,359,355,180,175
GUNGOREN,AKINCILAR MAH.,395,352,349,189,160
GUNGOREN,AKINCILAR MAH.,396,360,354,229,125
GUNGOREN,AKINCILAR MAH.,395,350,343,212,131
GUNGOREN,AKINCILAR MAH.,395,350,345,190,155
GUNGOREN,AKINCILAR MAH.,395,358,354,204,150
GUNGOREN,AKINCILAR MAH.,400,319,310,201,109
GUNGOREN,AKINCILAR MAH.,398,317,310,163,147
GUNGOREN,AKINCILAR MAH.,398,342,338,202,136
GUNGOREN,AKINCILAR MAH.,397,352,349,235,114
GUNGOREN,AKINCILAR MAH.,397,349,338,187,151
GUNGOREN,AKINCILAR MAH.,397,357,351,197,154
GUNGOREN,AKINCILAR MAH.,401,355,354,217,137
GUNGOREN,AKINCILAR MAH.,398,333,327,190,137
GUNGOREN,AKINCILAR MAH.,397,367,365,194,171
GUNGOREN,AKINCILAR MAH.,397,352,352,231,121
GUNGOREN,AKINCILAR MAH.,398,357,352,217,135
GUNGOREN,AKINCILAR MAH.,398,350,348,212,136
GUNGOREN,AKINCILAR MAH.,398,373,370,203,167
GUNGOREN,AKINCILAR MAH.,402,357,354,214,140
GUNGOREN,AKINCILAR MAH.,397,353,346,231,115
GUNGOREN,AKINCILAR MAH.,397,366,364,215,149
GUNGOREN,AKINCILAR MAH.,396,345,344,217,127
GUNGOREN,AKINCILAR MAH.,398,361,352,219,133
GUNGOREN,AKINCILAR MAH.,397,356,354,214,140
GUNGOREN,AKINCILAR MAH.,396,359,355,212,143
GUNGOREN,AKINCILAR MAH.,398,353,350,215,135
GUNGOREN,GUNESTEPE MAH.,402,327,318,196,122
GUNGOREN,GUNESTEPE MAH.,401,341,333,209,124
GUNGOREN,GUNESTEPE MAH.,403,360,354,240,114
GUNGOREN,GUNESTEPE MAH.,401,358,352,207,145
GUNGOREN,GUNESTEPE MAH.,401,364,358,240,118
GUNGOREN,GUNESTEPE MAH.,402,361,356,228,128
GUNGOREN,GUNESTEPE MAH.,402,347,340,229,111
GUNGOREN,GUNESTEPE MAH.,401,365,360,242,118
GUNGOREN,GUNESTEPE MAH.,401,364,364,230,134
GUNGOREN,GUNESTEPE MAH.,402,357,349,220,129
GUNGOREN,GUNESTEPE MAH.,401,365,361,225,136
GUNGOREN,GUNESTEPE MAH.,403,366,360,234,126
GUNGOREN,GUNESTEPE MAH.,401,355,349,233,116
GUNGOREN,GUNESTEPE MAH.,402,359,356,227,129
GUNGOREN,GUNESTEPE MAH.,403,359,356,221,135
GUNGOREN,GUNESTEPE MAH.,402,361,358,231,127
GUNGOREN,GUNESTEPE MAH.,402,345,338,204,134
GUNGOREN,GUNESTEPE MAH.,402,362,359,240,119
GUNGOREN,GUNESTEPE MAH.,401,356,352,230,122
GUNGOREN,GUNESTEPE MAH.,401,352,348,231,117
GUNGOREN,GUNESTEPE MAH.,402,361,352,220,132
GUNGOREN,GUNESTEPE MAH.,409,322,311,189,122
GUNGOREN,GUNESTEPE MAH.,410,343,338,204,134
GUNGOREN,GUNESTEPE MAH.,409,369,359,236,123
GUNGOREN,GUNESTEPE MAH.,409,371,366,248,118
GUNGOREN,GUNESTEPE MAH.,410,367,361,222,139
GUNGOREN,GUNESTEPE MAH.,410,363,354,222,132
GUNGOREN,GUNESTEPE MAH.,410,354,349,210,139
GUNGOREN,GUNESTEPE MAH.,415,369,357,212,145
GUNGOREN,GUNESTEPE MAH.,409,359,356,226,130
GUNGOREN,GUNESTEPE MAH.,410,373,369,235,134
GUNGOREN,GUNESTEPE MAH.,415,383,370,237,133
GUNGOREN,GUNESTEPE MAH.,410,347,343,200,143
GUNGOREN,GUNESTEPE MAH.,415,367,357,213,144
GUNGOREN,GUNESTEPE MAH.,410,371,364,206,158
GUNGOREN,GUNESTEPE MAH.,409,355,348,220,128
GUNGOREN,GUNESTEPE MAH.,411,372,364,219,145
GUNGOREN,GUNESTEPE MAH.,409,356,355,200,155
GUNGOREN,GUNESTEPE MAH.,411,357,349,222,127
GUNGOREN,GUNESTEPE MAH.,410,357,347,215,132
GUNGOREN,GUNESTEPE MAH.,410,369,359,217,142
GUNGOREN,GUNESTEPE MAH.,411,373,368,205,163
GUNGOREN,GUNESTEPE MAH.,410,365,358,223,135
GUNGOREN,GUNESTEPE MAH.,410,377,374,232,142
GUNGOREN,GUNESTEPE MAH.,400,317,314,197,117
GUNGOREN,GUNESTEPE MAH.,399,344,339,234,105
GUNGOREN,GUNESTEPE MAH.,406,363,353,220,133
GUNGOREN,GUNESTEPE MAH.,399,345,337,212,125
GUNGOREN,GUNESTEPE MAH.,400,363,359,232,127
GUNGOREN,GUNESTEPE MAH.,400,354,341,213,128
GUNGOREN,GUNESTEPE MAH.,399,357,355,212,143
GUNGOREN,GUNESTEPE MAH.,400,366,363,249,114
GUNGOREN,GUNESTEPE MAH.,399,349,345,214,131
GUNGOREN,GUNESTEPE MAH.,399,354,349,225,124
GUNGOREN,GUNESTEPE MAH.,399,356,352,197,155
GUNGOREN,GUNESTEPE MAH.,399,342,337,220,117
GUNGOREN,GUNESTEPE MAH.,400,356,352,187,165
GUNGOREN,GUNESTEPE MAH.,399,349,347,190,157
GUNGOREN,GUNESTEPE MAH.,399,359,357,223,134
GUNGOREN,GUNESTEPE MAH.,399,354,348,207,141
GUNGOREN,GUNESTEPE MAH.,398,348,346,206,140
GUNGOREN,GUNESTEPE MAH.,399,353,343,213,130
GUNGOREN,GUNESTEPE MAH.,398,350,348,216,132
GUNGOREN,GUNESTEPE MAH.,400,336,330,173,157
GUNGOREN,GUNESTEPE MAH.,399,335,330,225,105
GUNGOREN,GUNESTEPE MAH.,399,355,348,211,137
GUNGOREN,GUNESTEPE MAH.,398,355,353,204,149
GUNGOREN,GUNESTEPE MAH.,399,362,355,218,137
GUNGOREN,GUNESTEPE MAH.,399,363,355,213,142
GUNGOREN,GUNESTEPE MAH.,407,344,337,215,122
GUNGOREN,GUNESTEPE MAH.,408,341,335,241,94
GUNGOREN,GUNESTEPE MAH.,408,338,329,199,130
GUNGOREN,GUNESTEPE MAH.,409,371,362,242,120
GUNGOREN,GUNESTEPE MAH.,409,361,354,212,142
GUNGOREN,GUNESTEPE MAH.,406,351,346,232,114
GUNGOREN,GUNESTEPE MAH.,407,356,354,218,136
GUNGOREN,GUNESTEPE MAH.,408,362,354,223,131
GUNGOREN,GUNESTEPE MAH.,407,359,353,225,128
GUNGOREN,GUNESTEPE MAH.,407,360,357,209,148
GUNGOREN,GUNESTEPE MAH.,407,364,359,208,151
GUNGOREN,GUNESTEPE MAH.,406,353,349,227,122
GUNGOREN,GUNESTEPE MAH.,408,363,361,239,122
GUNGOREN,GUNESTEPE MAH.,407,340,329,222,107
GUNGOREN,GUNESTEPE MAH.,407,349,343,238,105
GUNGOREN,GUNESTEPE MAH.,407,352,348,200,148
GUNGOREN,GUNESTEPE MAH.,407,362,359,237,122
GUNGOREN,GUNESTEPE MAH.,406,345,341,226,115
GUNGOREN,GUNESTEPE MAH.,407,373,365,229,136
GUNGOREN,GUNESTEPE MAH.,409,373,361,264,97
GUNGOREN,GUNESTEPE MAH.,407,353,353,235,118
GUNGOREN,GUNESTEPE MAH.,407,358,352,206,146
GUNGOREN,GUVEN MAH.,395,317,309,159,150
GUNGOREN,GUVEN MAH.,392,305,302,161,141
GUNGOREN,GUVEN MAH.,392,355,350,172,178
GUNGOREN,GUVEN MAH.,392,346,344,168,176
GUNGOREN,GUVEN MAH.,392,350,345,155,190
GUNGOREN,GUVEN MAH.,393,359,356,174,182
GUNGOREN,GUVEN MAH.,392,352,347,190,157
GUNGOREN,GUVEN MAH.,393,343,341,170,171
GUNGOREN,GUVEN MAH.,391,356,351,181,170
GUNGOREN,GUVEN MAH.,392,346,344,185,159
GUNGOREN,GUVEN MAH.,392,351,340,159,181
GUNGOREN,GUVEN MAH.,392,352,347,167,180
GUNGOREN,GUVEN MAH.,392,354,354,185,169
GUNGOREN,GUVEN MAH.,393,371,366,182,184
GUNGOREN,GUVEN MAH.,402,310,307,129,178
GUNGOREN,GUVEN MAH.,401,317,311,133,178
GUNGOREN,GUVEN MAH.,401,348,342,154,188
GUNGOREN,GUVEN MAH.,402,354,345,142,203
GUNGOREN,GUVEN MAH.,402,366,361,165,196
GUNGOREN,GUVEN MAH.,402,341,339,166,173
GUNGOREN,GUVEN MAH.,402,356,354,162,192
GUNGOREN,GUVEN MAH.,402,358,352,193,159
GUNGOREN,GUVEN MAH.,401,343,332,169,163
GUNGOREN,GUVEN MAH.,404,360,357,157,200
GUNGOREN,GUVEN MAH.,402,347,341,158,183
GUNGOREN,GUVEN MAH.,402,348,343,167,176
GUNGOREN,GUVEN MAH.,402,341,337,162,175
GUNGOREN,GUVEN MAH.,402,352,350,150,200
GUNGOREN,GUVEN MAH.,402,350,347,147,200
GUNGOREN,GUVEN MAH.,402,363,359,171,188
GUNGOREN,GUVEN MAH.,402,346,342,181,161
GUNGOREN,GUVEN MAH.,404,361,356,157,199
GUNGOREN,GUVEN MAH.,401,359,356,173,183
GUNGOREN,GUVEN MAH.,402,362,360,158,202
GUNGOREN,GUVEN MAH.,401,367,363,161,202
GUNGOREN,HAZNEDAR MAH.,400,333,326,136,190
GUNGOREN,HAZNEDAR MAH.,397,335,330,144,186
GUNGOREN,HAZNEDAR MAH.,399,344,340,169,171
GUNGOREN,HAZNEDAR MAH.,397,365,363,169,194
GUNGOREN,HAZNEDAR MAH.,396,354,351,164,187
GUNGOREN,HAZNEDAR MAH.,398,356,352,183,169
GUNGOREN,HAZNEDAR MAH.,396,348,344,162,182
GUNGOREN,HAZNEDAR MAH.,396,368,365,182,183
GUNGOREN,HAZNEDAR MAH.,398,364,360,146,214
GUNGOREN,HAZNEDAR MAH.,397,329,324,151,173
GUNGOREN,HAZNEDAR MAH.,397,346,343,179,164
GUNGOREN,HAZNEDAR MAH.,396,367,364,190,174
GUNGOREN,HAZNEDAR MAH.,397,367,359,175,184
GUNGOREN,HAZNEDAR MAH.,396,362,354,155,199
GUNGOREN,HAZNEDAR MAH.,397,357,354,173,181
GUNGOREN,HAZNEDAR MAH.,409,318,310,129,181
GUNGOREN,HAZNEDAR MAH.,409,331,324,109,215
GUNGOREN,HAZNEDAR MAH.,409,312,309,136,173
GUNGOREN,HAZNEDAR MAH.,415,352,346,147,199
GUNGOREN,HAZNEDAR MAH.,410,382,377,182,195
GUNGOREN,HAZNEDAR MAH.,409,359,359,173,186
GUNGOREN,HAZNEDAR MAH.,410,371,366,153,213
GUNGOREN,HAZNEDAR MAH.,409,367,357,158,199
GUNGOREN,HAZNEDAR MAH.,410,371,362,187,175
GUNGOREN,HAZNEDAR MAH.,409,376,369,180,189
GUNGOREN,HAZNEDAR MAH.,408,369,366,159,207
GUNGOREN,HAZNEDAR MAH.,410,355,352,180,172
GUNGOREN,HAZNEDAR MAH.,409,369,366,147,219
GUNGOREN,HAZNEDAR MAH.,408,364,361,175,186
GUNGOREN,HAZNEDAR MAH.,409,366,365,154,211
GUNGOREN,HAZNEDAR MAH.,408,354,348,155,193
GUNGOREN,HAZNEDAR MAH.,410,378,376,161,215
GUNGOREN,HAZNEDAR MAH.,410,358,352,162,190
GUNGOREN,HAZNEDAR MAH.,409,368,364,158,206
GUNGOREN,HAZNEDAR MAH.,412,352,347,186,161
GUNGOREN,HAZNEDAR MAH.,410,383,378,157,221
GUNGOREN,HAZNEDAR MAH.,409,372,370,180,190
GUNGOREN,HAZNEDAR MAH.,409,367,362,166,196
GUNGOREN,HAZNEDAR MAH.,409,367,364,171,193
GUNGOREN,HAZNEDAR MAH.,409,360,356,141,215
GUNGOREN,HAZNEDAR MAH.,409,362,359,152,207
GUNGOREN,HAZNEDAR MAH.,408,361,355,149,206
GUNGOREN,MARESAL CAKMAK MAH.,408,321,314,188,126
GUNGOREN,MARESAL CAKMAK MAH.,401,331,324,208,116
GUNGOREN,MARESAL CAKMAK MAH.,402,324,310,166,144
GUNGOREN,MARESAL CAKMAK MAH.,402,356,345,218,127
GUNGOREN,MARESAL CAKMAK MAH.,401,361,360,219,141
GUNGOREN,MARESAL CAKMAK MAH.,402,349,347,236,111
GUNGOREN,MARESAL CAKMAK MAH.,402,363,359,243,116
GUNGOREN,MARESAL CAKMAK MAH.,402,356,353,192,161
GUNGOREN,MARESAL CAKMAK MAH.,402,363,359,204,155
GUNGOREN,MARESAL CAKMAK MAH.,401,350,344,203,141
GUNGOREN,MARESAL CAKMAK MAH.,401,361,357,224,133
GUNGOREN,MARESAL CAKMAK MAH.,406,361,358,218,140
GUNGOREN,MARESAL CAKMAK MAH.,402,362,358,240,118
GUNGOREN,MARESAL CAKMAK MAH.,402,358,351,226,125
GUNGOREN,MARESAL CAKMAK MAH.,403,340,337,206,131
GUNGOREN,MARESAL CAKMAK MAH.,402,348,345,209,136
GUNGOREN,MARESAL CAKMAK MAH.,401,334,322,218,104
GUNGOREN,MARESAL CAKMAK MAH.,401,351,348,213,135
GUNGOREN,MARESAL CAKMAK MAH.,401,363,349,209,140
GUNGOREN,MARESAL CAKMAK MAH.,402,371,363,221,142
GUNGOREN,MARESAL CAKMAK MAH.,402,341,335,201,134
GUNGOREN,MARESAL CAKMAK MAH.,404,346,336,206,130
GUNGOREN,MARESAL CAKMAK MAH.,402,357,348,241,107
GUNGOREN,MARESAL CAKMAK MAH.,401,351,345,215,130
GUNGOREN,MARESAL CAKMAK MAH.,401,364,359,213,146
GUNGOREN,MARESAL CAKMAK MAH.,402,357,352,210,142
GUNGOREN,MARESAL CAKMAK MAH.,402,370,361,222,139
GUNGOREN,MARESAL CAKMAK MAH.,401,364,358,220,138
GUNGOREN,MARESAL CAKMAK MAH.,415,316,305,163,142
GUNGOREN,MARESAL CAKMAK MAH.,415,311,304,164,140
GUNGOREN,MARESAL CAKMAK MAH.,415,334,333,181,152
GUNGOREN,MARESAL CAKMAK MAH.,415,364,360,200,160
GUNGOREN,MARESAL CAKMAK MAH.,415,375,365,193,172
GUNGOREN,MARESAL CAKMAK MAH.,415,362,358,192,166
GUNGOREN,MARESAL CAKMAK MAH.,414,373,368,228,140
GUNGOREN,MARESAL CAKMAK MAH.,415,371,365,204,161
GUNGOREN,MARESAL CAKMAK MAH.,414,353,346,193,153
GUNGOREN,MARESAL CAKMAK MAH.,414,366,360,193,167
GUNGOREN,MARESAL CAKMAK MAH.,413,361,355,205,150
GUNGOREN,MARESAL CAKMAK MAH.,414,374,369,199,170
GUNGOREN,MARESAL CAKMAK MAH.,414,345,337,194,143
GUNGOREN,MARESAL CAKMAK MAH.,414,343,335,193,142
GUNGOREN,MARESAL CAKMAK MAH.,415,359,354,193,161
GUNGOREN,MARESAL CAKMAK MAH.,415,378,378,189,189
GUNGOREN,MARESAL CAKMAK MAH.,411,352,349,206,143
GUNGOREN,MARESAL CAKMAK MAH.,414,366,360,193,167
GUNGOREN,MARESAL CAKMAK MAH.,415,368,365,191,174
GUNGOREN,MARESAL CAKMAK MAH.,414,356,350,204,146
GUNGOREN,MARESAL CAKMAK MAH.,414,368,364,196,168
GUNGOREN,MARESAL CAKMAK MAH.,415,354,346,213,133
GUNGOREN,MARESAL CAKMAK MAH.,415,359,356,188,168
GUNGOREN,MARESAL CAKMAK MAH.,414,351,348,200,148
GUNGOREN,MARESAL CAKMAK MAH.,415,371,367,211,156
GUNGOREN,MARESAL CAKMAK MAH.,414,369,361,187,174
GUNGOREN,MARESAL CAKMAK MAH.,415,358,358,201,157
GUNGOREN,MARESAL CAKMAK MAH.,414,362,357,218,139
GUNGOREN,MARESAL CAKMAK MAH.,415,369,365,201,164
GUNGOREN,MARESAL CAKMAK MAH.,414,371,366,207,159
ARNAVUTKOY,ADNAN MENDERES MAH.,364,291,285,162,123
ARNAVUTKOY,ADNAN MENDERES MAH.,365,315,309,189,120
ARNAVUTKOY,ADNAN MENDERES MAH.,365,318,309,202,107
ARNAVUTKOY,ADNAN MENDERES MAH.,365,305,299,217,82
ARNAVUTKOY,ADNAN MENDERES MAH.,364,328,320,216,104
ARNAVUTKOY,ADNAN MENDERES MAH.,367,304,300,207,93
ARNAVUTKOY,ADNAN MENDERES MAH.,365,316,314,189,125
ARNAVUTKOY,ANADOLU MAH.,415,341,331,243,88
ARNAVUTKOY,ANADOLU MAH.,415,366,354,268,86
ARNAVUTKOY,ANADOLU MAH.,408,366,360,274,86
ARNAVUTKOY,ANADOLU MAH.,408,354,351,257,94
ARNAVUTKOY,ANADOLU MAH.,409,363,358,232,126
ARNAVUTKOY,ANADOLU MAH.,410,344,339,249,90
ARNAVUTKOY,ANADOLU MAH.,409,339,330,240,90
ARNAVUTKOY,ANADOLU MAH.,408,365,355,249,106
ARNAVUTKOY,ANADOLU MAH.,408,355,348,242,106
ARNAVUTKOY,ANADOLU MAH.,409,363,357,246,111
ARNAVUTKOY,ANADOLU MAH.,410,347,339,256,83
ARNAVUTKOY,ANADOLU MAH.,409,341,330,231,99
ARNAVUTKOY,ANADOLU MAH.,409,361,356,269,87
ARNAVUTKOY,ANADOLU MAH.,410,353,349,227,122
ARNAVUTKOY,ANADOLU MAH.,409,354,346,230,116
ARNAVUTKOY,ANADOLU MAH.,411,363,358,272,86
ARNAVUTKOY,ANADOLU MAH.,402,336,332,234,98
ARNAVUTKOY,ANADOLU MAH.,401,351,338,238,100
ARNAVUTKOY,ANADOLU MAH.,402,355,345,262,83
ARNAVUTKOY,ANADOLU MAH.,401,342,338,213,125
ARNAVUTKOY,ANADOLU MAH.,402,357,351,266,85
ARNAVUTKOY,ANADOLU MAH.,401,352,345,246,99
ARNAVUTKOY,ANADOLU MAH.,401,352,348,264,84
ARNAVUTKOY,ANADOLU MAH.,401,351,348,251,97
ARNAVUTKOY,ANADOLU MAH.,402,362,353,239,114
ARNAVUTKOY,ANADOLU MAH.,402,352,348,244,104
ARNAVUTKOY,ANADOLU MAH.,402,352,347,249,98
ARNAVUTKOY,ANADOLU MAH.,401,356,348,240,108
ARNAVUTKOY,ANADOLU MAH.,401,347,339,225,114
ARNAVUTKOY,ANADOLU MAH.,401,357,352,248,104
ARNAVUTKOY,ANADOLU MAH.,404,325,320,238,82
ARNAVUTKOY,ANADOLU MAH.,403,341,334,239,95
ARNAVUTKOY,ANADOLU MAH.,402,337,331,220,111
ARNAVUTKOY,ANADOLU MAH.,402,350,348,220,128
ARNAVUTKOY,ANADOLU MAH.,401,347,342,233,109
ARNAVUTKOY,ANADOLU MAH.,403,338,332,212,120
ARNAVUTKOY,ANADOLU MAH.,403,356,349,251,98
ARNAVUTKOY,ANADOLU MAH.,401,350,348,242,106
ARNAVUTKOY,ANADOLU MAH.,402,336,321,231,90
ARNAVUTKOY,ANADOLU MAH.,400,355,347,245,102
ARNAVUTKOY,ANADOLU MAH.,379,341,329,251,78
ARNAVUTKOY,ANADOLU MAH.,379,330,327,220,107
ARNAVUTKOY,ANADOLU MAH.,379,306,300,227,73
ARNAVUTKOY,ANADOLU MAH.,380,333,328,243,85
ARNAVUTKOY,ANADOLU MAH.,379,340,332,234,98
ARNAVUTKOY,ANADOLU MAH.,380,327,319,221,98
ARNAVUTKOY,ANADOLU MAH.,380,328,325,238,87
ARNAVUTKOY,ANADOLU MAH.,380,340,335,257,78
ARNAVUTKOY,ARNAVUTKOY MERKEZ MAH.,358,296,292,178,114
ARNAVUTKOY,ARNAVUTKOY MERKEZ MAH.,360,315,312,208,104
ARNAVUTKOY,ARNAVUTKOY MERKEZ MAH.,359,329,323,204,119
ARNAVUTKOY,ARNAVUTKOY MERKEZ MAH.,360,323,316,217,99
ARNAVUTKOY,ARNAVUTKOY MERKEZ MAH.,359,316,311,231,80
ARNAVUTKOY,ARNAVUTKOY MERKEZ MAH.,364,316,313,209,104
ARNAVUTKOY,ARNAVUTKOY MERKEZ MAH.,415,331,316,221,95
ARNAVUTKOY,ARNAVUTKOY MERKEZ MAH.,415,370,364,242,122
ARNAVUTKOY,ARNAVUTKOY MERKEZ MAH.,413,375,368,234,134
ARNAVUTKOY,ARNAVUTKOY MERKEZ MAH.,412,360,347,241,106
ARNAVUTKOY,ARNAVUTKOY MERKEZ MAH.,415,365,360,227,133
ARNAVUTKOY,ARNAVUTKOY MERKEZ MAH.,415,352,341,236,105
ARNAVUTKOY,ARNAVUTKOY MERKEZ MAH.,415,354,342,233,109
ARNAVUTKOY,ARNAVUTKOY MERKEZ MAH.,415,349,344,227,117
ARNAVUTKOY,ARNAVUTKOY MERKEZ MAH.,415,356,351,257,94
ARNAVUTKOY,ARNAVUTKOY MERKEZ MAH.,414,364,356,235,121
ARNAVUTKOY,ARNAVUTKOY MERKEZ MAH.,413,371,366,229,137
ARNAVUTKOY,ARNAVUTKOY MERKEZ MAH.,414,375,369,249,120
ARNAVUTKOY,ARNAVUTKOY MERKEZ MAH.,413,361,355,227,128
ARNAVUTKOY,ARNAVUTKOY MERKEZ MAH.,413,363,361,248,113
ARNAVUTKOY,ARNAVUTKOY MERKEZ MAH.,413,374,370,231,139
ARNAVUTKOY,ARNAVUTKOY MERKEZ MAH.,382,321,314,238,76
ARNAVUTKOY,ARNAVUTKOY MERKEZ MAH.,383,344,337,224,113
ARNAVUTKOY,ARNAVUTKOY MERKEZ MAH.,383,328,317,200,117
ARNAVUTKOY,ARNAVUTKOY MERKEZ MAH.,382,351,342,228,114
ARNAVUTKOY,ARNAVUTKOY MERKEZ MAH.,382,343,337,249,88
ARNAVUTKOY,ARNAVUTKOY MERKEZ MAH.,382,327,319,244,75
ARNAVUTKOY,ARNAVUTKOY MERKEZ MAH.,384,340,328,241,87
ARNAVUTKOY,ARNAVUTKOY MERKEZ MAH.,381,343,337,241,96
ARNAVUTKOY,ARNAVUTKOY MERKEZ MAH.,383,337,330,246,84
ARNAVUTKOY,BAKLALI MAH.,323,295,286,157,129
ARNAVUTKOY,BAKLALI MAH.,322,302,296,187,109
ARNAVUTKOY,BALABAN MAH.,356,310,304,106,198
ARNAVUTKOY,BOGAZKOY ISTIKLAL MAH.,389,331,321,224,97
ARNAVUTKOY,BOGAZKOY ISTIKLAL MAH.,389,339,330,233,97
ARNAVUTKOY,BOGAZKOY ISTIKLAL MAH.,394,334,329,227,102
ARNAVUTKOY,BOGAZKOY ISTIKLAL MAH.,390,341,336,236,100
ARNAVUTKOY,BOGAZKOY ISTIKLAL MAH.,389,348,338,259,79
ARNAVUTKOY,BOGAZKOY ISTIKLAL MAH.,390,340,332,203,129
ARNAVUTKOY,BOGAZKOY ISTIKLAL MAH.,389,339,328,222,106
ARNAVUTKOY,BOGAZKOY ISTIKLAL MAH.,388,334,328,233,95
ARNAVUTKOY,BOGAZKOY ISTIKLAL MAH.,390,342,335,210,125
ARNAVUTKOY,BOGAZKOY ISTIKLAL MAH.,390,339,330,209,121
ARNAVUTKOY,BOGAZKOY ISTIKLAL MAH.,391,344,341,229,112
ARNAVUTKOY,BOGAZKOY ISTIKLAL MAH.,389,349,338,228,110
ARNAVUTKOY,BOGAZKOY ISTIKLAL MAH.,393,354,341,258,83
ARNAVUTKOY,BOGAZKOY ISTIKLAL MAH.,390,342,335,227,108
ARNAVUTKOY,BOGAZKOY ISTIKLAL MAH.,389,336,323,200,123
ARNAVUTKOY,BOLLUCA MAH.,385,320,315,232,83
ARNAVUTKOY,BOLLUCA MAH.,386,345,340,239,101
ARNAVUTKOY,BOLLUCA MAH.,385,328,317,217,100
ARNAVUTKOY,BOLLUCA MAH.,387,344,339,228,111
ARNAVUTKOY,BOLLUCA MAH.,386,339,332,256,76
ARNAVUTKOY,BOLLUCA MAH.,385,341,337,261,76
ARNAVUTKOY,BOLLUCA MAH.,386,332,326,239,87
ARNAVUTKOY,BOLLUCA MAH.,386,342,335,230,105
ARNAVUTKOY,BOLLUCA MAH.,386,336,325,226,99
ARNAVUTKOY,BOLLUCA MAH.,387,337,327,207,120
ARNAVUTKOY,BOLLUCA MAH.,386,335,324,217,107
ARNAVUTKOY,BOYALIK MAH.,272,252,249,108,141
ARNAVUTKOY,BOYALIK MAH.,273,246,243,112,131
ARNAVUTKOY,CILINGIR MAH.,407,350,340,208,132
ARNAVUTKOY,CILINGIR MAH.,406,378,374,217,157
ARNAVUTKOY,DELIKLIKAYA MAH.,397,330,313,156,157
ARNAVUTKOY,DELIKLIKAYA MAH.,399,358,338,125,213
ARNAVUTKOY,DELIKLIKAYA MAH.,398,334,326,142,184
ARNAVUTKOY,DELIKLIKAYA MAH.,398,337,331,139,192
ARNAVUTKOY,DELIKLIKAYA MAH.,396,339,332,136,196
ARNAVUTKOY,DELIKLIKAYA MAH.,397,346,336,172,164
ARNAVUTKOY,DURSUNKOY MAH.,369,334,331,180,151
ARNAVUTKOY,DURUSU MAH.,285,258,246,88,158
ARNAVUTKOY,DURUSU MAH.,283,267,255,102,153
ARNAVUTKOY,FATIH MAH.,396,344,334,251,83
ARNAVUTKOY,FATIH MAH.,396,346,343,245,98
ARNAVUTKOY,FATIH MAH.,396,334,326,242,84
ARNAVUTKOY,FATIH MAH.,395,336,329,240,89
ARNAVUTKOY,HACIMASLI MAH.,211,195,193,107,86
ARNAVUTKOY,HACIMASLI MAH.,212,205,202,136,66
ARNAVUTKOY,HADIMKOY MAH.,406,343,337,215,122
ARNAVUTKOY,HADIMKOY MAH.,406,361,357,232,125
ARNAVUTKOY,HADIMKOY MAH.,407,363,358,254,104
ARNAVUTKOY,HADIMKOY MAH.,406,378,373,242,131
ARNAVUTKOY,HADIMKOY MAH.,407,372,368,263,105
ARNAVUTKOY,HADIMKOY MAH.,406,365,361,277,84
ARNAVUTKOY,HADIMKOY MAH.,406,369,360,252,108
ARNAVUTKOY,HADIMKOY MAH.,406,366,363,262,101
ARNAVUTKOY,HADIMKOY MAH.,407,359,359,265,94
ARNAVUTKOY,HADIMKOY MAH.,407,372,370,250,120
ARNAVUTKOY,HADIMKOY MAH.,407,359,355,252,103
ARNAVUTKOY,HADIMKOY MAH.,407,368,364,236,128
ARNAVUTKOY,HADIMKOY MAH.,407,369,365,256,109
ARNAVUTKOY,HADIMKOY MAH.,407,355,354,224,130
ARNAVUTKOY,HADIMKOY MAH.,407,369,367,248,119
ARNAVUTKOY,HADIMKOY MAH.,396,353,348,199,149
ARNAVUTKOY,HADIMKOY MAH.,392,340,333,193,140
ARNAVUTKOY,HADIMKOY MAH.,391,342,340,215,125
ARNAVUTKOY,HADIMKOY MAH.,392,336,321,193,128
ARNAVUTKOY,HADIMKOY MAH.,391,329,326,202,124
ARNAVUTKOY,HADIMKOY MAH.,391,345,340,216,124
ARNAVUTKOY,HADIMKOY MAH.,392,337,333,232,101
ARNAVUTKOY,HADIMKOY MAH.,393,332,328,204,124
ARNAVUTKOY,HADIMKOY MAH.,382,318,305,157,148
ARNAVUTKOY,HADIMKOY MAH.,385,333,331,218,113
ARNAVUTKOY,HADIMKOY MAH.,382,341,335,200,135
ARNAVUTKOY,HADIMKOY MAH.,381,342,335,206,129
ARNAVUTKOY,HADIMKOY MAH.,382,340,335,214,121
ARNAVUTKOY,HADIMKOY MAH.,382,348,335,185,150
ARNAVUTKOY,HADIMKOY MAH.,382,340,336,206,130
ARNAVUTKOY,HADIMKOY MAH.,385,352,347,206,141
ARNAVUTKOY,HADIMKOY MAH.,381,348,344,209,135
ARNAVUTKOY,HADIMKOY MAH.,381,325,320,216,104
ARNAVUTKOY,HADIMKOY MAH.,383,340,331,199,132
ARNAVUTKOY,HARACCI MAH.,388,321,307,191,116
ARNAVUTKOY,HARACCI MAH.,388,351,347,204,143
ARNAVUTKOY,HARACCI MAH.,389,342,333,226,107
ARNAVUTKOY,HARACCI MAH.,390,339,330,203,127
ARNAVUTKOY,HARACCI MAH.,388,341,336,207,129
ARNAVUTKOY,HARACCI MAH.,415,342,333,213,120
ARNAVUTKOY,HARACCI MAH.,415,370,360,213,147
ARNAVUTKOY,HARACCI MAH.,414,367,360,226,134
ARNAVUTKOY,HARACCI MAH.,415,366,360,208,152
ARNAVUTKOY,HARACCI MAH.,415,371,359,180,179
ARNAVUTKOY,HARACCI MAH.,414,379,371,214,157
ARNAVUTKOY,HARACCI MAH.,414,371,361,183,178
ARNAVUTKOY,HARACCI MAH.,415,364,361,194,167
ARNAVUTKOY,HASTANE MAH.,403,329,323,135,188
ARNAVUTKOY,HASTANE MAH.,402,349,341,168,173
ARNAVUTKOY,HASTANE MAH.,402,348,339,169,170
ARNAVUTKOY,HASTANE MAH.,405,357,351,165,186
ARNAVUTKOY,HASTANE MAH.,402,360,353,160,193
ARNAVUTKOY,HASTANE MAH.,402,356,356,177,179
ARNAVUTKOY,HASTANE MAH.,401,358,347,162,185
ARNAVUTKOY,HASTANE MAH.,401,371,367,188,179
ARNAVUTKOY,HASTANE MAH.,402,354,346,167,179
ARNAVUTKOY,HASTANE MAH.,401,359,358,199,159
ARNAVUTKOY,HASTANE MAH.,402,358,353,195,158
ARNAVUTKOY,HASTANE MAH.,402,378,372,199,173
ARNAVUTKOY,HASTANE MAH.,401,365,360,174,186
ARNAVUTKOY,HICRET MAH.,371,324,314,226,88
ARNAVUTKOY,HICRET MAH.,371,331,324,229,95
ARNAVUTKOY,HICRET MAH.,376,350,335,255,80
ARNAVUTKOY,HICRET MAH.,372,320,310,248,62
ARNAVUTKOY,HICRET MAH.,371,327,317,225,92
ARNAVUTKOY,IMRAHOR MAH.,407,352,341,218,123
ARNAVUTKOY,IMRAHOR MAH.,405,341,330,215,115
ARNAVUTKOY,IMRAHOR MAH.,407,350,340,214,126
ARNAVUTKOY,IMRAHOR MAH.,405,352,339,221,118
ARNAVUTKOY,IMRAHOR MAH.,404,369,356,234,122
ARNAVUTKOY,IMRAHOR MAH.,406,348,340,230,110
ARNAVUTKOY,IMRAHOR MAH.,404,360,349,239,110
ARNAVUTKOY,IMRAHOR MAH.,405,351,339,235,104
ARNAVUTKOY,IMRAHOR MAH.,404,344,326,221,105
ARNAVUTKOY,IMRAHOR MAH.,404,353,341,225,116
ARNAVUTKOY,IMRAHOR MAH.,404,343,339,182,157
ARNAVUTKOY,IMRAHOR MAH.,406,359,356,248,108
ARNAVUTKOY,IMRAHOR MAH.,404,350,347,234,113
ARNAVUTKOY,IMRAHOR MAH.,408,361,351,230,121
ARNAVUTKOY,IMRAHOR MAH.,404,336,328,227,101
ARNAVUTKOY,ISLAMBEY MAH.,397,315,309,236,73
ARNAVUTKOY,ISLAMBEY MAH.,398,355,346,270,76
ARNAVUTKOY,ISLAMBEY MAH.,397,355,351,275,76
ARNAVUTKOY,ISLAMBEY MAH.,398,349,344,271,73
ARNAVUTKOY,ISLAMBEY MAH.,398,342,339,255,84
ARNAVUTKOY,ISLAMBEY MAH.,397,345,336,257,79
ARNAVUTKOY,ISLAMBEY MAH.,397,345,340,224,116
ARNAVUTKOY,ISLAMBEY MAH.,398,334,328,229,99
ARNAVUTKOY,ISLAMBEY MAH.,399,347,342,237,105
ARNAVUTKOY,ISLAMBEY MAH.,398,354,346,255,91
ARNAVUTKOY,ISLAMBEY MAH.,397,339,331,239,92
ARNAVUTKOY,ISLAMBEY MAH.,398,353,352,243,109
ARNAVUTKOY,ISLAMBEY MAH.,396,353,346,265,81
ARNAVUTKOY,ISLAMBEY MAH.,397,353,350,275,75
ARNAVUTKOY,ISLAMBEY MAH.,398,340,332,266,66
ARNAVUTKOY,ISLAMBEY MAH.,398,363,352,268,84
ARNAVUTKOY,ISLAMBEY MAH.,397,344,339,250,89
ARNAVUTKOY,ISLAMBEY MAH.,412,358,348,246,102
ARNAVUTKOY,ISLAMBEY MAH.,415,360,352,249,103
ARNAVUTKOY,ISLAMBEY MAH.,415,358,344,244,100
ARNAVUTKOY,ISLAMBEY MAH.,412,365,358,227,131
ARNAVUTKOY,ISLAMBEY MAH.,415,352,345,240,105
ARNAVUTKOY,ISLAMBEY MAH.,415,375,368,214,154
ARNAVUTKOY,ISLAMBEY MAH.,411,361,354,251,103
ARNAVUTKOY,ISLAMBEY MAH.,413,365,355,266,89
ARNAVUTKOY,ISLAMBEY MAH.,412,355,344,227,117
ARNAVUTKOY,ISLAMBEY MAH.,413,379,378,238,140
ARNAVUTKOY,ISLAMBEY MAH.,412,358,351,201,150
ARNAVUTKOY,KARABURUN MAH.,401,334,319,206,113
ARNAVUTKOY,KARABURUN MAH.,400,352,340,187,153
ARNAVUTKOY,KARABURUN MAH.,401,366,362,211,151
ARNAVUTKOY,KARLIBAYIR MAH.,406,338,335,274,61
ARNAVUTKOY,KARLIBAYIR MAH.,407,374,370,287,83
ARNAVUTKOY,KARLIBAYIR MAH.,405,372,366,298,68
ARNAVUTKOY,KARLIBAYIR MAH.,406,375,366,262,104
ARNAVUTKOY,KARLIBAYIR MAH.,404,369,362,281,81
ARNAVUTKOY,KARLIBAYIR MAH.,406,368,361,262,99
ARNAVUTKOY,KARLIBAYIR MAH.,408,364,353,259,94
ARNAVUTKOY,KARLIBAYIR MAH.,405,369,363,262,101
ARNAVUTKOY,KARLIBAYIR MAH.,405,363,351,246,105
ARNAVUTKOY,KARLIBAYIR MAH.,405,380,372,288,84
ARNAVUTKOY,KARLIBAYIR MAH.,405,355,352,289,63
ARNAVUTKOY,KARLIBAYIR MAH.,405,354,342,242,100
ARNAVUTKOY,KARLIBAYIR MAH.,404,355,351,246,105
ARNAVUTKOY,MARESAL FEVZI CAKMAK MAH.,314,272,258,191,67
ARNAVUTKOY,MARESAL FEVZI CAKMAK MAH.,314,289,279,202,77
ARNAVUTKOY,MARESAL FEVZI CAKMAK MAH.,314,282,281,210,71
ARNAVUTKOY,MARESAL FEVZI CAKMAK MAH.,314,287,281,177,104
ARNAVUTKOY,MARESAL FEVZI CAKMAK MAH.,415,377,370,315,55
ARNAVUTKOY,MARESAL FEVZI CAKMAK MAH.,408,378,372,282,90
ARNAVUTKOY,MARESAL FEVZI CAKMAK MAH.,409,371,364,273,91
ARNAVUTKOY,MARESAL FEVZI CAKMAK MAH.,406,372,361,292,69
ARNAVUTKOY,MAVIGOL MAH.,409,348,336,252,84
ARNAVUTKOY,MAVIGOL MAH.,414,374,363,220,143
ARNAVUTKOY,MAVIGOL MAH.,409,377,369,232,137
ARNAVUTKOY,MAVIGOL MAH.,408,374,366,246,120
ARNAVUTKOY,MAVIGOL MAH.,415,380,375,233,142
ARNAVUTKOY,MAVIGOL MAH.,415,387,381,247,134
ARNAVUTKOY,MAVIGOL MAH.,415,365,359,231,128
ARNAVUTKOY,MAVIGOL MAH.,412,372,366,239,127
ARNAVUTKOY,MAVIGOL MAH.,409,368,357,227,130
ARNAVUTKOY,MAVIGOL MAH.,412,357,351,211,140
ARNAVUTKOY,MEHMET AKIF ERSOY MAH.,391,333,328,259,69
ARNAVUTKOY,MEHMET AKIF ERSOY MAH.,391,350,333,235,98
ARNAVUTKOY,MEHMET AKIF ERSOY MAH.,412,352,341,261,80
ARNAVUTKOY,MEHMET AKIF ERSOY MAH.,411,377,370,277,93
ARNAVUTKOY,MEHMET AKIF ERSOY MAH.,412,376,372,259,113
ARNAVUTKOY,MEHMET AKIF ERSOY MAH.,412,374,368,295,73
ARNAVUTKOY,MEHMET AKIF ERSOY MAH.,412,362,353,249,104
ARNAVUTKOY,MEHMET AKIF ERSOY MAH.,412,367,360,243,117
ARNAVUTKOY,MEHMET AKIF ERSOY MAH.,412,377,373,258,115
ARNAVUTKOY,MEHMET AKIF ERSOY MAH.,410,364,361,274,87
ARNAVUTKOY,MERKEZ ATATURK MAH.,409,352,343,221,122
ARNAVUTKOY,MERKEZ ATATURK MAH.,409,363,350,219,131
ARNAVUTKOY,MERKEZ ATATURK MAH.,409,373,360,246,114
ARNAVUTKOY,MERKEZ ATATURK MAH.,409,370,360,254,106
ARNAVUTKOY,MERKEZ ATATURK MAH.,415,381,373,239,134
ARNAVUTKOY,MERKEZ ATATURK MAH.,410,366,360,222,138
ARNAVUTKOY,MERKEZ ATATURK MAH.,410,358,348,224,124
ARNAVUTKOY,MERKEZ ATATURK MAH.,410,379,374,231,143
ARNAVUTKOY,MERKEZ ATATURK MAH.,410,362,357,228,129
ARNAVUTKOY,MERKEZ ATATURK MAH.,411,377,366,244,122
ARNAVUTKOY,MERKEZ ATATURK MAH.,409,368,360,239,121
ARNAVUTKOY,MUSTAFA KEMAL PASA MAH.,410,343,326,246,80
ARNAVUTKOY,MUSTAFA KEMAL PASA MAH.,407,339,328,226,102
ARNAVUTKOY,MUSTAFA KEMAL PASA MAH.,407,364,360,267,93
ARNAVUTKOY,MUSTAFA KEMAL PASA MAH.,407,360,352,258,94
ARNAVUTKOY,MUSTAFA KEMAL PASA MAH.,407,371,367,270,97
ARNAVUTKOY,MUSTAFA KEMAL PASA MAH.,410,379,367,274,93
ARNAVUTKOY,MUSTAFA KEMAL PASA MAH.,407,356,342,234,108
ARNAVUTKOY,MUSTAFA KEMAL PASA MAH.,408,364,354,255,99
ARNAVUTKOY,MUSTAFA KEMAL PASA MAH.,409,363,361,234,127
ARNAVUTKOY,MUSTAFA KEMAL PASA MAH.,406,356,348,261,87
ARNAVUTKOY,MUSTAFA KEMAL PASA MAH.,406,357,348,267,81
ARNAVUTKOY,MUSTAFA KEMAL PASA MAH.,406,369,357,255,102
ARNAVUTKOY,MUSTAFA KEMAL PASA MAH.,406,356,346,256,90
ARNAVUTKOY,MUSTAFA KEMAL PASA MAH.,406,361,358,255,103
ARNAVUTKOY,MUSTAFA KEMAL PASA MAH.,407,348,336,227,109
ARNAVUTKOY,MUSTAFA KEMAL PASA MAH.,407,352,344,254,90
ARNAVUTKOY,MUSTAFA KEMAL PASA MAH.,407,355,350,254,96
ARNAVUTKOY,MUSTAFA KEMAL PASA MAH.,407,346,341,236,105
ARNAVUTKOY,MUSTAFA KEMAL PASA MAH.,408,350,345,233,112
ARNAVUTKOY,NENEHATUN MAH.,372,333,327,246,81
ARNAVUTKOY,NENEHATUN MAH.,374,310,304,212,92
ARNAVUTKOY,NENEHATUN MAH.,372,330,328,252,76
ARNAVUTKOY,NENEHATUN MAH.,372,332,327,248,79
ARNAVUTKOY,NENEHATUN MAH.,374,343,340,279,61
ARNAVUTKOY,NENEHATUN MAH.,373,332,324,236,88
ARNAVUTKOY,NENEHATUN MAH.,377,336,330,241,89
ARNAVUTKOY,NENEHATUN MAH.,373,334,329,255,74
ARNAVUTKOY,NENEHATUN MAH.,376,334,327,222,105
ARNAVUTKOY,NENEHATUN MAH.,376,330,322,230,92
ARNAVUTKOY,NENEHATUN MAH.,377,329,321,242,79
ARNAVUTKOY,NENEHATUN MAH.,374,319,311,223,88
ARNAVUTKOY,NENEHATUN MAH.,374,341,334,235,99
ARNAVUTKOY,NENEHATUN MAH.,374,330,327,226,101
ARNAVUTKOY,OMERLI MAH.,401,345,338,181,157
ARNAVUTKOY,OMERLI MAH.,401,341,331,188,143
ARNAVUTKOY,OMERLI MAH.,401,343,334,184,150
ARNAVUTKOY,OMERLI MAH.,401,343,333,177,156
ARNAVUTKOY,OMERLI MAH.,401,349,347,206,141
ARNAVUTKOY,OMERLI MAH.,401,353,343,233,110
ARNAVUTKOY,OMERLI MAH.,401,345,339,210,129
ARNAVUTKOY,OMERLI MAH.,401,358,352,197,155
ARNAVUTKOY,OMERLI MAH.,403,363,351,193,158
ARNAVUTKOY,OMERLI MAH.,402,346,344,201,143
ARNAVUTKOY,SAZLIBOSNA MAH.,305,271,267,160,107
ARNAVUTKOY,SAZLIBOSNA MAH.,304,287,282,145,137
ARNAVUTKOY,SAZLIBOSNA MAH.,304,277,275,122,153
ARNAVUTKOY,TASOLUK MAH.,341,288,283,205,78
ARNAVUTKOY,TASOLUK MAH.,339,297,295,223,72
ARNAVUTKOY,TASOLUK MAH.,340,306,302,250,52
ARNAVUTKOY,TASOLUK MAH.,340,309,306,241,65
ARNAVUTKOY,TASOLUK MAH.,340,293,288,236,52
ARNAVUTKOY,TASOLUK MAH.,408,357,347,232,115
ARNAVUTKOY,TASOLUK MAH.,406,365,356,267,89
ARNAVUTKOY,TASOLUK MAH.,406,358,351,282,69
ARNAVUTKOY,TASOLUK MAH.,405,343,337,222,115
ARNAVUTKOY,TASOLUK MAH.,405,349,344,242,102
ARNAVUTKOY,TAYAKADIN MAH.,376,306,299,208,91
ARNAVUTKOY,TAYAKADIN MAH.,376,272,269,162,107
ARNAVUTKOY,TAYAKADIN MAH.,376,278,276,164,112
ARNAVUTKOY,TAYAKADIN MAH.,376,319,314,212,102
ARNAVUTKOY,TAYAKADIN MAH.,376,321,313,206,107
ARNAVUTKOY,TAYAKADIN MAH.,376,322,310,180,130
ARNAVUTKOY,TAYAKADIN MAH.,375,341,337,235,102
ARNAVUTKOY,TAYAKADIN MAH.,376,286,284,179,105
ARNAVUTKOY,TAYAKADIN MAH.,374,302,297,204,93
ARNAVUTKOY,TERKOS MAH.,394,341,337,139,198
ARNAVUTKOY,TERKOS MAH.,392,356,350,151,199
ARNAVUTKOY,YASSIOREN MAH.,403,363,357,159,198
ARNAVUTKOY,YAVUZ SELIM MAH.,376,315,304,217,87
ARNAVUTKOY,YAVUZ SELIM MAH.,376,349,342,255,87
ARNAVUTKOY,YAVUZ SELIM MAH.,375,334,329,241,88
ARNAVUTKOY,YAVUZ SELIM MAH.,375,329,325,234,91
ARNAVUTKOY,YAVUZ SELIM MAH.,376,324,320,225,95
ARNAVUTKOY,YAVUZ SELIM MAH.,381,335,324,235,89
ARNAVUTKOY,YAVUZ SELIM MAH.,376,331,322,238,84
ARNAVUTKOY,YAVUZ SELIM MAH.,376,348,341,233,108
ARNAVUTKOY,YAVUZ SELIM MAH.,375,340,331,256,75
ARNAVUTKOY,YAVUZ SELIM MAH.,372,313,302,217,85
ARNAVUTKOY,YAVUZ SELIM MAH.,371,337,332,203,129
ARNAVUTKOY,YAVUZ SELIM MAH.,372,185,181,127,54
ARNAVUTKOY,YAVUZ SELIM MAH.,372,321,309,201,108
ARNAVUTKOY,YAVUZ SELIM MAH.,376,323,317,218,99
ARNAVUTKOY,YAVUZ SELIM MAH.,372,322,311,177,134
ARNAVUTKOY,YAVUZ SELIM MAH.,370,323,313,193,120
ARNAVUTKOY,YAVUZ SELIM MAH.,369,332,320,203,117
ARNAVUTKOY,YAVUZ SELIM MAH.,372,307,301,204,97
ARNAVUTKOY,YENIKOY MAH.,381,325,316,182,134
ARNAVUTKOY,YENIKOY MAH.,381,339,336,162,174
ARNAVUTKOY,YENIKOY MAH.,380,342,341,162,179
ARNAVUTKOY,YESILBAYIR MAH.,232,211,210,95,115
ARNAVUTKOY,YESILBAYIR MAH.,232,213,210,98,112
ARNAVUTKOY,YUNUS EMRE MAH.,399,343,334,218,116
ARNAVUTKOY,YUNUS EMRE MAH.,401,335,322,204,118
ARNAVUTKOY,YUNUS EMRE MAH.,401,351,345,219,126
ARNAVUTKOY,YUNUS EMRE MAH.,401,344,339,227,112
ARNAVUTKOY,YUNUS EMRE MAH.,403,358,349,219,130
ARNAVUTKOY,YUNUS EMRE MAH.,400,364,355,236,119
ARNAVUTKOY,YUNUS EMRE MAH.,404,349,338,221,117
ARNAVUTKOY,YUNUS EMRE MAH.,401,368,358,253,105
ARNAVUTKOY,YUNUS EMRE MAH.,401,363,357,239,118
ARNAVUTKOY,YUNUS EMRE MAH.,401,342,336,220,116
ARNAVUTKOY,YUNUS EMRE MAH.,400,357,344,220,124
ARNAVUTKOY,YUNUS EMRE MAH.,401,358,346,207,139
ARNAVUTKOY,YUNUS EMRE MAH.,401,354,341,224,117
ARNAVUTKOY,YUNUS EMRE MAH.,401,351,342,227,115
ARNAVUTKOY,YUNUS EMRE MAH.,400,354,336,233,103
ARNAVUTKOY,YUNUS EMRE MAH.,400,358,338,221,117
ARNAVUTKOY,YUNUS EMRE MAH.,399,367,353,226,127
ARNAVUTKOY,YUNUS EMRE MAH.,401,363,360,247,113
ARNAVUTKOY,YUNUS EMRE MAH.,401,353,343,228,115
ARNAVUTKOY,YUNUS EMRE MAH.,401,363,358,260,98
ARNAVUTKOY,YUNUS EMRE MAH.,401,347,336,216,120
ARNAVUTKOY,YUNUS EMRE MAH.,399,346,342,215,127
ARNAVUTKOY,YUNUS EMRE MAH.,401,362,349,220,129
ARNAVUTKOY,YUNUS EMRE MAH.,399,344,329,228,101
KAGITHANE,CAGLAYAN MAH.,397,307,306,180,126
KAGITHANE,CAGLAYAN MAH.,396,344,336,184,152
KAGITHANE,CAGLAYAN MAH.,397,359,358,166,192
KAGITHANE,CAGLAYAN MAH.,397,350,348,176,172
KAGITHANE,CAGLAYAN MAH.,398,348,342,163,179
KAGITHANE,CAGLAYAN MAH.,396,328,322,156,166
KAGITHANE,CAGLAYAN MAH.,395,346,339,165,174
KAGITHANE,CAGLAYAN MAH.,396,326,322,165,157
KAGITHANE,CAGLAYAN MAH.,395,348,341,190,151
KAGITHANE,CAGLAYAN MAH.,396,346,341,167,174
KAGITHANE,CAGLAYAN MAH.,395,346,336,166,170
KAGITHANE,CAGLAYAN MAH.,396,349,345,167,178
KAGITHANE,CAGLAYAN MAH.,397,337,333,174,159
KAGITHANE,CAGLAYAN MAH.,395,344,341,166,175
KAGITHANE,CAGLAYAN MAH.,398,352,347,174,173
KAGITHANE,CAGLAYAN MAH.,395,349,340,172,168
KAGITHANE,CAGLAYAN MAH.,395,345,340,145,195
KAGITHANE,CAGLAYAN MAH.,367,300,296,187,109
KAGITHANE,CAGLAYAN MAH.,367,300,296,150,146
KAGITHANE,CAGLAYAN MAH.,367,321,313,162,151
KAGITHANE,CAGLAYAN MAH.,369,314,313,175,138
KAGITHANE,CAGLAYAN MAH.,367,321,317,156,161
KAGITHANE,CAGLAYAN MAH.,366,300,299,162,137
KAGITHANE,CAGLAYAN MAH.,369,304,300,141,159
KAGITHANE,CAGLAYAN MAH.,411,361,349,143,206
KAGITHANE,CAGLAYAN MAH.,410,358,356,133,223
KAGITHANE,CAGLAYAN MAH.,411,368,360,163,197
KAGITHANE,CAGLAYAN MAH.,411,364,362,167,195
KAGITHANE,CAGLAYAN MAH.,411,354,350,162,188
KAGITHANE,CAGLAYAN MAH.,415,347,345,151,194
KAGITHANE,CAGLAYAN MAH.,411,343,338,136,202
KAGITHANE,CAGLAYAN MAH.,415,360,356,169,187
KAGITHANE,CAGLAYAN MAH.,415,357,355,142,213
KAGITHANE,CAGLAYAN MAH.,412,353,345,180,165
KAGITHANE,CAGLAYAN MAH.,412,348,343,135,208
KAGITHANE,CAGLAYAN MAH.,412,356,356,176,180
KAGITHANE,CAGLAYAN MAH.,410,372,370,152,218
KAGITHANE,CAGLAYAN MAH.,411,370,364,143,221
KAGITHANE,CAGLAYAN MAH.,411,356,351,150,201
KAGITHANE,CAGLAYAN MAH.,388,320,312,110,202
KAGITHANE,CAGLAYAN MAH.,391,324,323,141,182
KAGITHANE,CAGLAYAN MAH.,388,315,313,148,165
KAGITHANE,CAGLAYAN MAH.,387,346,340,165,175
KAGITHANE,CAGLAYAN MAH.,387,354,346,164,182
KAGITHANE,CAGLAYAN MAH.,388,346,340,162,178
KAGITHANE,CAGLAYAN MAH.,387,333,326,135,191
KAGITHANE,CAGLAYAN MAH.,388,333,326,132,194
KAGITHANE,CAGLAYAN MAH.,387,338,332,143,189
KAGITHANE,CAGLAYAN MAH.,388,333,332,145,187
KAGITHANE,CAGLAYAN MAH.,387,344,341,168,173
KAGITHANE,CAGLAYAN MAH.,390,331,328,154,174
KAGITHANE,CAGLAYAN MAH.,387,342,331,155,176
KAGITHANE,CAGLAYAN MAH.,387,333,328,140,188
KAGITHANE,CAGLAYAN MAH.,390,356,351,155,196
KAGITHANE,GURSEL MAH.,399,336,332,192,140
KAGITHANE,GURSEL MAH.,401,341,338,162,176
KAGITHANE,GURSEL MAH.,398,340,338,177,161
KAGITHANE,GURSEL MAH.,397,361,360,179,181
KAGITHANE,GURSEL MAH.,398,351,349,152,197
KAGITHANE,GURSEL MAH.,397,319,313,150,163
KAGITHANE,GURSEL MAH.,397,346,344,171,173
KAGITHANE,GURSEL MAH.,397,333,330,182,148
KAGITHANE,GURSEL MAH.,397,342,340,174,166
KAGITHANE,GURSEL MAH.,398,349,348,187,161
KAGITHANE,GURSEL MAH.,398,358,354,178,176
KAGITHANE,GURSEL MAH.,397,360,356,166,190
KAGITHANE,GURSEL MAH.,397,350,347,169,178
KAGITHANE,GURSEL MAH.,398,335,329,172,157
KAGITHANE,GURSEL MAH.,397,333,328,181,147
KAGITHANE,GURSEL MAH.,400,343,337,160,177
KAGITHANE,GURSEL MAH.,398,352,351,165,186
KAGITHANE,GURSEL MAH.,407,354,339,155,184
KAGITHANE,GURSEL MAH.,407,339,334,195,139
KAGITHANE,GURSEL MAH.,409,361,358,191,167
KAGITHANE,GURSEL MAH.,407,378,376,233,143
KAGITHANE,GURSEL MAH.,407,365,363,180,183
KAGITHANE,GURSEL MAH.,415,368,359,201,158
KAGITHANE,GURSEL MAH.,408,377,373,206,167
KAGITHANE,GURSEL MAH.,409,372,370,164,206
KAGITHANE,GURSEL MAH.,407,371,363,176,187
KAGITHANE,GURSEL MAH.,408,352,348,185,163
KAGITHANE,GURSEL MAH.,406,371,369,182,187
KAGITHANE,GURSEL MAH.,408,358,355,179,176
KAGITHANE,GURSEL MAH.,408,373,370,191,179
KAGITHANE,GURSEL MAH.,408,364,360,175,185
KAGITHANE,GURSEL MAH.,408,365,362,175,187
KAGITHANE,GURSEL MAH.,406,338,334,153,181
KAGITHANE,GURSEL MAH.,408,345,340,200,140
KAGITHANE,GURSEL MAH.,408,369,367,196,171
KAGITHANE,GURSEL MAH.,408,365,358,181,177
KAGITHANE,GURSEL MAH.,407,367,360,179,181
KAGITHANE,GURSEL MAH.,407,345,338,177,161
KAGITHANE,GURSEL MAH.,408,369,365,203,162
KAGITHANE,GURSEL MAH.,407,364,360,183,177
KAGITHANE,GURSEL MAH.,407,359,351,181,170
KAGITHANE,GURSEL MAH.,415,344,336,215,121
KAGITHANE,GURSEL MAH.,412,365,361,184,177
KAGITHANE,GURSEL MAH.,412,368,366,191,175
KAGITHANE,GURSEL MAH.,411,362,357,197,160
KAGITHANE,GURSEL MAH.,410,366,364,211,153
KAGITHANE,GURSEL MAH.,410,363,358,193,165
KAGITHANE,GURSEL MAH.,412,369,363,195,168
KAGITHANE,GURSEL MAH.,411,358,357,189,168
KAGITHANE,GURSEL MAH.,412,353,350,194,156
KAGITHANE,GURSEL MAH.,412,364,357,230,127
KAGITHANE,GURSEL MAH.,412,361,359,216,143
KAGITHANE,GURSEL MAH.,410,362,354,185,169
KAGITHANE,GURSEL MAH.,412,349,341,169,172
KAGITHANE,HAMIDIYE MAH.,375,342,331,131,200
KAGITHANE,HAMIDIYE MAH.,376,352,345,132,213
KAGITHANE,HAMIDIYE MAH.,376,358,357,117,240
KAGITHANE,HAMIDIYE MAH.,375,343,339,110,229
KAGITHANE,HAMIDIYE MAH.,378,355,351,124,227
KAGITHANE,HAMIDIYE MAH.,376,346,342,143,199
KAGITHANE,HAMIDIYE MAH.,403,333,325,174,151
KAGITHANE,HAMIDIYE MAH.,404,362,353,197,156
KAGITHANE,HAMIDIYE MAH.,404,379,372,237,135
KAGITHANE,HAMIDIYE MAH.,403,374,370,240,130
KAGITHANE,HAMIDIYE MAH.,405,372,369,245,124
KAGITHANE,HAMIDIYE MAH.,404,363,357,231,126
KAGITHANE,HAMIDIYE MAH.,404,361,356,233,123
KAGITHANE,HAMIDIYE MAH.,404,374,367,219,148
KAGITHANE,HAMIDIYE MAH.,404,369,366,207,159
KAGITHANE,HAMIDIYE MAH.,406,371,366,232,134
KAGITHANE,HAMIDIYE MAH.,404,372,366,231,135
KAGITHANE,HAMIDIYE MAH.,404,377,371,225,146
KAGITHANE,HAMIDIYE MAH.,403,369,364,228,136
KAGITHANE,HAMIDIYE MAH.,404,378,378,251,127
KAGITHANE,HAMIDIYE MAH.,405,368,362,238,124
KAGITHANE,HAMIDIYE MAH.,405,366,362,216,146
KAGITHANE,HAMIDIYE MAH.,403,360,356,216,140
KAGITHANE,HAMIDIYE MAH.,403,368,361,234,127
KAGITHANE,HAMIDIYE MAH.,403,367,362,237,125
KAGITHANE,HAMIDIYE MAH.,404,372,368,220,148
KAGITHANE,HAMIDIYE MAH.,416,351,341,213,128
KAGITHANE,HAMIDIYE MAH.,416,389,382,226,156
KAGITHANE,HAMIDIYE MAH.,418,372,371,243,128
KAGITHANE,HAMIDIYE MAH.,416,375,370,272,98
KAGITHANE,HAMIDIYE MAH.,415,376,368,220,148
KAGITHANE,HAMIDIYE MAH.,416,377,371,248,123
KAGITHANE,HAMIDIYE MAH.,416,375,365,244,121
KAGITHANE,HAMIDIYE MAH.,415,387,385,243,142
KAGITHANE,HAMIDIYE MAH.,415,379,373,228,145
KAGITHANE,HAMIDIYE MAH.,415,380,371,233,138
KAGITHANE,HAMIDIYE MAH.,415,370,367,258,109
KAGITHANE,HAMIDIYE MAH.,416,386,381,242,139
KAGITHANE,HAMIDIYE MAH.,415,366,364,233,131
KAGITHANE,HAMIDIYE MAH.,416,378,375,244,131
KAGITHANE,HAMIDIYE MAH.,415,384,377,244,133
KAGITHANE,HAMIDIYE MAH.,415,374,368,251,117
KAGITHANE,HAMIDIYE MAH.,414,379,375,229,146
KAGITHANE,HAMIDIYE MAH.,400,355,351,227,124
KAGITHANE,HAMIDIYE MAH.,397,368,358,213,145
KAGITHANE,HAMIDIYE MAH.,396,356,353,210,143
KAGITHANE,HAMIDIYE MAH.,396,356,353,220,133
KAGITHANE,HAMIDIYE MAH.,397,351,344,209,135
KAGITHANE,HAMIDIYE MAH.,396,343,342,200,142
KAGITHANE,HAMIDIYE MAH.,397,349,342,190,152
KAGITHANE,HAMIDIYE MAH.,396,351,344,209,135
KAGITHANE,HAMIDIYE MAH.,396,344,337,207,130
KAGITHANE,HAMIDIYE MAH.,395,352,339,183,156
KAGITHANE,HAMIDIYE MAH.,397,370,366,205,161
KAGITHANE,HAMIDIYE MAH.,395,364,359,188,171
KAGITHANE,HAMIDIYE MAH.,397,371,366,200,166
KAGITHANE,HAMIDIYE MAH.,395,356,352,202,150
KAGITHANE,HAMIDIYE MAH.,395,372,366,196,170
KAGITHANE,HAMIDIYE MAH.,395,355,349,171,178
KAGITHANE,HAMIDIYE MAH.,395,350,342,179,163
KAGITHANE,HAMIDIYE MAH.,395,371,367,202,165
KAGITHANE,HAMIDIYE MAH.,395,357,350,173,177
KAGITHANE,HAMIDIYE MAH.,395,364,360,187,173
KAGITHANE,HAMIDIYE MAH.,396,363,358,196,162
KAGITHANE,HAMIDIYE MAH.,396,356,351,190,161
KAGITHANE,HURRIYET MAH.,403,342,335,208,127
KAGITHANE,HURRIYET MAH.,402,331,318,146,172
KAGITHANE,HURRIYET MAH.,401,334,326,192,134
KAGITHANE,HURRIYET MAH.,402,359,353,210,143
KAGITHANE,HURRIYET MAH.,402,366,363,217,146
KAGITHANE,HURRIYET MAH.,403,353,348,185,163
KAGITHANE,HURRIYET MAH.,402,367,363,204,159
KAGITHANE,HURRIYET MAH.,403,370,364,224,140
KAGITHANE,HURRIYET MAH.,401,366,359,193,166
KAGITHANE,HURRIYET MAH.,403,354,352,185,167
KAGITHANE,HURRIYET MAH.,403,348,341,206,135
KAGITHANE,HURRIYET MAH.,402,368,366,205,161
KAGITHANE,HURRIYET MAH.,403,354,343,211,132
KAGITHANE,HURRIYET MAH.,403,358,356,195,161
KAGITHANE,HURRIYET MAH.,402,344,339,207,132
KAGITHANE,HURRIYET MAH.,403,364,360,201,159
KAGITHANE,HURRIYET MAH.,403,352,349,189,160
KAGITHANE,HURRIYET MAH.,403,354,351,207,144
KAGITHANE,HURRIYET MAH.,402,347,344,172,172
KAGITHANE,HURRIYET MAH.,403,353,349,208,141
KAGITHANE,HURRIYET MAH.,403,344,341,209,132
KAGITHANE,HURRIYET MAH.,403,361,359,189,170
KAGITHANE,HURRIYET MAH.,403,359,351,187,164
KAGITHANE,HURRIYET MAH.,401,358,354,191,163
KAGITHANE,HURRIYET MAH.,403,351,346,178,168
KAGITHANE,HURRIYET MAH.,402,345,338,174,164
KAGITHANE,HURRIYET MAH.,404,373,369,197,172
KAGITHANE,HURRIYET MAH.,402,342,340,184,156
KAGITHANE,HURRIYET MAH.,404,368,364,180,184
KAGITHANE,HURRIYET MAH.,403,357,356,204,152
KAGITHANE,HURRIYET MAH.,412,354,344,184,160
KAGITHANE,HURRIYET MAH.,411,362,360,190,170
KAGITHANE,HURRIYET MAH.,413,377,371,210,161
KAGITHANE,HURRIYET MAH.,411,366,363,201,162
KAGITHANE,HURRIYET MAH.,411,358,353,165,188
KAGITHANE,HURRIYET MAH.,411,368,364,193,171
KAGITHANE,HURRIYET MAH.,411,368,363,179,184
KAGITHANE,MEHMET AKIF ERSOY MAH.,388,322,314,186,128
KAGITHANE,MEHMET AKIF ERSOY MAH.,387,324,322,223,99
KAGITHANE,MEHMET AKIF ERSOY MAH.,387,337,333,217,116
KAGITHANE,MEHMET AKIF ERSOY MAH.,388,355,350,225,125
KAGITHANE,MEHMET AKIF ERSOY MAH.,387,351,349,224,125
KAGITHANE,MEHMET AKIF ERSOY MAH.,388,341,335,201,134
KAGITHANE,MEHMET AKIF ERSOY MAH.,387,329,327,227,100
KAGITHANE,MEHMET AKIF ERSOY MAH.,388,336,331,236,95
KAGITHANE,MEHMET AKIF ERSOY MAH.,388,340,335,231,104
KAGITHANE,MEHMET AKIF ERSOY MAH.,388,340,337,226,111
KAGITHANE,MEHMET AKIF ERSOY MAH.,387,345,343,222,121
KAGITHANE,MEHMET AKIF ERSOY MAH.,388,336,333,197,136
KAGITHANE,MEHMET AKIF ERSOY MAH.,387,342,338,228,110
KAGITHANE,MEHMET AKIF ERSOY MAH.,387,335,329,182,147
KAGITHANE,MEHMET AKIF ERSOY MAH.,403,319,316,175,141
KAGITHANE,MEHMET AKIF ERSOY MAH.,403,366,361,207,154
KAGITHANE,MEHMET AKIF ERSOY MAH.,402,358,356,180,176
KAGITHANE,MEHMET AKIF ERSOY MAH.,406,349,344,207,137
KAGITHANE,MEHMET AKIF ERSOY MAH.,403,363,360,189,171
KAGITHANE,MEHMET AKIF ERSOY MAH.,405,353,348,206,142
KAGITHANE,MEHMET AKIF ERSOY MAH.,402,359,355,202,153
KAGITHANE,MEHMET AKIF ERSOY MAH.,403,361,358,214,144
KAGITHANE,MEHMET AKIF ERSOY MAH.,402,352,350,198,152
KAGITHANE,MERKEZ MAH.,410,329,322,215,107
KAGITHANE,MERKEZ MAH.,411,371,360,178,182
KAGITHANE,MERKEZ MAH.,410,374,370,187,183
KAGITHANE,MERKEZ MAH.,411,360,358,190,168
KAGITHANE,MERKEZ MAH.,410,369,365,199,166
KAGITHANE,MERKEZ MAH.,409,369,363,216,147
KAGITHANE,MERKEZ MAH.,410,364,361,212,149
KAGITHANE,MERKEZ MAH.,409,371,366,188,178
KAGITHANE,MERKEZ MAH.,410,368,365,210,155
KAGITHANE,MERKEZ MAH.,410,384,379,185,194
KAGITHANE,MERKEZ MAH.,409,385,381,186,195
KAGITHANE,MERKEZ MAH.,410,362,358,187,171
KAGITHANE,MERKEZ MAH.,389,336,326,217,109
KAGITHANE,MERKEZ MAH.,390,350,348,244,104
KAGITHANE,MERKEZ MAH.,391,351,345,231,114
KAGITHANE,MERKEZ MAH.,390,358,353,227,126
KAGITHANE,MERKEZ MAH.,391,352,348,236,112
KAGITHANE,MERKEZ MAH.,391,342,338,222,116
KAGITHANE,MERKEZ MAH.,390,322,314,188,126
KAGITHANE,MERKEZ MAH.,391,354,348,208,140
KAGITHANE,MERKEZ MAH.,389,339,334,201,133
KAGITHANE,MERKEZ MAH.,390,352,348,201,147
KAGITHANE,MERKEZ MAH.,391,348,345,212,133
KAGITHANE,MERKEZ MAH.,390,344,339,219,120
KAGITHANE,MERKEZ MAH.,390,335,325,204,121
KAGITHANE,MERKEZ MAH.,395,356,349,218,131
KAGITHANE,MERKEZ MAH.,383,324,322,135,187
KAGITHANE,MERKEZ MAH.,386,351,345,128,217
KAGITHANE,MERKEZ MAH.,383,345,341,158,183
KAGITHANE,MERKEZ MAH.,384,349,346,139,207
KAGITHANE,MERKEZ MAH.,384,347,343,138,205
KAGITHANE,MERKEZ MAH.,383,359,358,143,215
KAGITHANE,MERKEZ MAH.,384,342,338,154,184
KAGITHANE,MERKEZ MAH.,383,361,356,164,192
KAGITHANE,MERKEZ MAH.,384,349,347,158,189
KAGITHANE,MERKEZ MAH.,384,350,346,149,197
KAGITHANE,MERKEZ MAH.,403,317,311,180,131
KAGITHANE,MERKEZ MAH.,404,359,357,175,182
KAGITHANE,MERKEZ MAH.,404,339,334,178,156
KAGITHANE,MERKEZ MAH.,404,354,351,219,132
KAGITHANE,MERKEZ MAH.,403,341,334,185,149
KAGITHANE,MERKEZ MAH.,405,339,333,187,146
KAGITHANE,MERKEZ MAH.,404,351,346,213,133
KAGITHANE,MERKEZ MAH.,405,354,349,224,125
KAGITHANE,MERKEZ MAH.,404,353,349,173,176
KAGITHANE,MERKEZ MAH.,400,355,348,124,224
KAGITHANE,MERKEZ MAH.,398,359,354,152,202
KAGITHANE,MERKEZ MAH.,398,352,350,136,214
KAGITHANE,MERKEZ MAH.,397,348,343,154,189
KAGITHANE,MERKEZ MAH.,398,363,354,131,223
KAGITHANE,MERKEZ MAH.,398,370,364,118,246
KAGITHANE,MERKEZ MAH.,398,359,359,132,227
KAGITHANE,MERKEZ MAH.,397,356,353,120,233
KAGITHANE,NURTEPE MAH.,415,361,351,141,210
KAGITHANE,NURTEPE MAH.,415,366,363,133,230
KAGITHANE,NURTEPE MAH.,415,375,366,145,221
KAGITHANE,NURTEPE MAH.,411,378,372,162,210
KAGITHANE,NURTEPE MAH.,411,381,378,148,230
KAGITHANE,NURTEPE MAH.,415,377,371,149,222
KAGITHANE,NURTEPE MAH.,411,377,370,151,219
KAGITHANE,NURTEPE MAH.,411,390,387,153,234
KAGITHANE,NURTEPE MAH.,411,386,378,131,247
KAGITHANE,NURTEPE MAH.,411,378,373,143,230
KAGITHANE,NURTEPE MAH.,412,369,361,118,243
KAGITHANE,NURTEPE MAH.,411,369,365,129,236
KAGITHANE,NURTEPE MAH.,412,377,374,162,212
KAGITHANE,NURTEPE MAH.,411,373,367,152,215
KAGITHANE,NURTEPE MAH.,411,374,370,143,227
KAGITHANE,NURTEPE MAH.,412,375,371,133,238
KAGITHANE,NURTEPE MAH.,412,382,379,168,211
KAGITHANE,NURTEPE MAH.,410,381,376,169,207
KAGITHANE,NURTEPE MAH.,399,342,341,98,243
KAGITHANE,NURTEPE MAH.,401,331,329,103,226
KAGITHANE,NURTEPE MAH.,399,358,357,110,247
KAGITHANE,NURTEPE MAH.,400,353,350,124,226
KAGITHANE,NURTEPE MAH.,398,361,358,110,248
KAGITHANE,NURTEPE MAH.,399,365,364,108,256
KAGITHANE,NURTEPE MAH.,399,362,357,121,236
KAGITHANE,NURTEPE MAH.,399,357,353,113,240
KAGITHANE,NURTEPE MAH.,398,344,340,112,228
KAGITHANE,NURTEPE MAH.,400,339,334,117,217
KAGITHANE,NURTEPE MAH.,401,359,354,119,235
KAGITHANE,NURTEPE MAH.,399,351,346,123,223
KAGITHANE,NURTEPE MAH.,399,361,356,129,227
KAGITHANE,NURTEPE MAH.,400,368,360,118,242
KAGITHANE,NURTEPE MAH.,398,349,347,130,217
KAGITHANE,NURTEPE MAH.,399,338,335,108,227
KAGITHANE,NURTEPE MAH.,399,360,354,147,207
KAGITHANE,NURTEPE MAH.,399,370,369,112,257
KAGITHANE,NURTEPE MAH.,400,375,367,133,234
KAGITHANE,NURTEPE MAH.,398,355,355,130,225
KAGITHANE,NURTEPE MAH.,374,308,305,154,151
KAGITHANE,NURTEPE MAH.,373,333,331,165,166
KAGITHANE,NURTEPE MAH.,373,334,331,152,179
KAGITHANE,NURTEPE MAH.,372,341,335,164,171
KAGITHANE,NURTEPE MAH.,375,335,335,180,155
KAGITHANE,NURTEPE MAH.,372,340,338,173,165
KAGITHANE,NURTEPE MAH.,373,332,330,129,201
KAGITHANE,NURTEPE MAH.,373,333,328,164,164
KAGITHANE,TALATPASA MAH.,404,325,319,207,112
KAGITHANE,TALATPASA MAH.,403,316,314,159,155
KAGITHANE,TALATPASA MAH.,404,353,350,198,152
KAGITHANE,TALATPASA MAH.,403,358,353,237,116
KAGITHANE,TALATPASA MAH.,404,367,362,213,149
KAGITHANE,TALATPASA MAH.,403,337,335,173,162
KAGITHANE,TALATPASA MAH.,404,366,363,178,185
KAGITHANE,TALATPASA MAH.,404,371,367,182,185
KAGITHANE,TALATPASA MAH.,404,360,357,207,150
KAGITHANE,TALATPASA MAH.,404,358,354,180,174
KAGITHANE,TALATPASA MAH.,403,347,345,197,148
KAGITHANE,TALATPASA MAH.,403,358,357,225,132
KAGITHANE,TALATPASA MAH.,403,365,358,183,175
KAGITHANE,TALATPASA MAH.,402,357,352,185,167
KAGITHANE,TALATPASA MAH.,406,371,364,210,154
KAGITHANE,TALATPASA MAH.,404,361,360,223,137
KAGITHANE,TALATPASA MAH.,403,373,370,211,159
KAGITHANE,TALATPASA MAH.,404,375,369,212,157
KAGITHANE,TALATPASA MAH.,403,355,351,190,161
KAGITHANE,TALATPASA MAH.,404,360,360,177,183
KAGITHANE,TALATPASA MAH.,403,362,357,159,198
KAGITHANE,TALATPASA MAH.,403,352,350,202,148
KAGITHANE,TALATPASA MAH.,404,361,359,178,181
KAGITHANE,TALATPASA MAH.,400,329,321,216,105
KAGITHANE,TALATPASA MAH.,402,337,332,230,102
KAGITHANE,TALATPASA MAH.,400,351,348,254,94
KAGITHANE,TALATPASA MAH.,401,359,354,254,100
KAGITHANE,TALATPASA MAH.,400,358,355,273,82
KAGITHANE,TALATPASA MAH.,401,364,362,270,92
KAGITHANE,TALATPASA MAH.,400,354,349,241,108
KAGITHANE,TALATPASA MAH.,399,359,358,242,116
KAGITHANE,TALATPASA MAH.,400,351,347,252,95
KAGITHANE,TALATPASA MAH.,400,370,367,242,125
KAGITHANE,TALATPASA MAH.,400,352,348,250,98
KAGITHANE,TALATPASA MAH.,400,357,356,258,98
KAGITHANE,TALATPASA MAH.,400,359,354,256,98
KAGITHANE,TALATPASA MAH.,399,366,359,264,95
KAGITHANE,TALATPASA MAH.,400,351,347,253,94
KAGITHANE,TALATPASA MAH.,399,359,358,256,102
KAGITHANE,TALATPASA MAH.,400,352,344,242,102
KAGITHANE,TALATPASA MAH.,415,346,343,193,150
KAGITHANE,TALATPASA MAH.,415,341,335,206,129
KAGITHANE,TALATPASA MAH.,413,343,341,193,148
KAGITHANE,TALATPASA MAH.,415,347,345,190,155
KAGITHANE,TALATPASA MAH.,413,370,361,217,144
KAGITHANE,TALATPASA MAH.,412,368,362,204,158
KAGITHANE,TALATPASA MAH.,413,359,354,221,133
KAGITHANE,TALATPASA MAH.,412,372,370,219,151
KAGITHANE,TALATPASA MAH.,413,355,349,218,131
KAGITHANE,TALATPASA MAH.,413,376,370,220,150
KAGITHANE,TALATPASA MAH.,415,379,372,228,144
KAGITHANE,TALATPASA MAH.,412,366,365,239,126
KAGITHANE,TALATPASA MAH.,413,381,371,194,177
KAGITHANE,TALATPASA MAH.,412,367,364,205,159
KAGITHANE,TALATPASA MAH.,413,366,363,203,160
KAGITHANE,TALATPASA MAH.,413,367,364,203,161
KAGITHANE,TALATPASA MAH.,412,359,356,246,110
KAGITHANE,TALATPASA MAH.,411,360,351,208,143
KAGITHANE,TALATPASA MAH.,413,350,346,217,129
KAGITHANE,TALATPASA MAH.,413,369,363,228,135
KAGITHANE,TALATPASA MAH.,415,361,358,201,157
KAGITHANE,YAHYA KEMAL MAH.,415,323,318,170,148
KAGITHANE,YAHYA KEMAL MAH.,412,339,335,177,158
KAGITHANE,YAHYA KEMAL MAH.,411,363,358,189,169
KAGITHANE,YAHYA KEMAL MAH.,411,353,353,200,153
KAGITHANE,YAHYA KEMAL MAH.,410,342,341,189,152
KAGITHANE,YAHYA KEMAL MAH.,411,343,340,195,145
KAGITHANE,YAHYA KEMAL MAH.,410,344,340,177,163
KAGITHANE,YAHYA KEMAL MAH.,411,358,356,220,136
KAGITHANE,YAHYA KEMAL MAH.,411,334,331,198,133
KAGITHANE,YAHYA KEMAL MAH.,410,343,337,195,142
KAGITHANE,YAHYA KEMAL MAH.,410,351,348,200,148
KAGITHANE,YAHYA KEMAL MAH.,411,343,339,203,136
KAGITHANE,YAHYA KEMAL MAH.,411,348,343,220,123
KAGITHANE,YAHYA KEMAL MAH.,415,355,348,197,151
KAGITHANE,YAHYA KEMAL MAH.,411,364,361,209,152
KAGITHANE,YAHYA KEMAL MAH.,411,355,354,200,154
KAGITHANE,YAHYA KEMAL MAH.,411,356,354,188,166
KAGITHANE,YAHYA KEMAL MAH.,410,351,346,187,159
KAGITHANE,YAHYA KEMAL MAH.,399,301,290,187,103
KAGITHANE,YAHYA KEMAL MAH.,396,330,325,177,148
KAGITHANE,YAHYA KEMAL MAH.,397,339,336,188,148
KAGITHANE,YAHYA KEMAL MAH.,397,348,348,207,141
KAGITHANE,YAHYA KEMAL MAH.,396,366,362,176,186
KAGITHANE,YAHYA KEMAL MAH.,398,343,337,200,137
KAGITHANE,YAHYA KEMAL MAH.,396,346,343,237,106
KAGITHANE,YAHYA KEMAL MAH.,398,357,353,228,125
KAGITHANE,YAHYA KEMAL MAH.,398,352,346,190,156
KAGITHANE,YAHYA KEMAL MAH.,397,352,350,220,130
KAGITHANE,YAHYA KEMAL MAH.,398,342,335,203,132
KAGITHANE,YAHYA KEMAL MAH.,398,347,343,202,141
KAGITHANE,YAHYA KEMAL MAH.,398,348,343,213,130
KAGITHANE,YAHYA KEMAL MAH.,400,349,345,195,150
KAGITHANE,CELIKTEPE MAH.,408,328,317,198,119
KAGITHANE,CELIKTEPE MAH.,409,334,328,160,168
KAGITHANE,CELIKTEPE MAH.,409,370,364,159,205
KAGITHANE,CELIKTEPE MAH.,409,363,362,192,170
KAGITHANE,CELIKTEPE MAH.,409,367,364,178,186
KAGITHANE,CELIKTEPE MAH.,409,364,359,165,194
KAGITHANE,CELIKTEPE MAH.,409,335,332,137,195
KAGITHANE,CELIKTEPE MAH.,411,349,345,154,191
KAGITHANE,CELIKTEPE MAH.,411,370,367,209,158
KAGITHANE,CELIKTEPE MAH.,408,364,358,175,183
KAGITHANE,CELIKTEPE MAH.,409,363,358,169,189
KAGITHANE,CELIKTEPE MAH.,409,355,352,164,188
KAGITHANE,CELIKTEPE MAH.,409,370,366,207,159
KAGITHANE,CELIKTEPE MAH.,409,346,342,172,170
KAGITHANE,CELIKTEPE MAH.,409,361,360,160,200
KAGITHANE,CELIKTEPE MAH.,408,356,353,173,180
KAGITHANE,CELIKTEPE MAH.,415,338,336,226,110
KAGITHANE,CELIKTEPE MAH.,415,345,331,187,144
KAGITHANE,CELIKTEPE MAH.,415,337,327,192,135
KAGITHANE,CELIKTEPE MAH.,415,353,347,189,158
KAGITHANE,CELIKTEPE MAH.,415,373,367,214,153
KAGITHANE,CELIKTEPE MAH.,415,363,356,207,149
KAGITHANE,CELIKTEPE MAH.,415,375,371,192,179
KAGITHANE,CELIKTEPE MAH.,415,384,376,204,172
KAGITHANE,CELIKTEPE MAH.,415,372,368,203,165
KAGITHANE,CELIKTEPE MAH.,415,364,358,217,141
KAGITHANE,CELIKTEPE MAH.,415,377,372,194,178
KAGITHANE,CELIKTEPE MAH.,415,367,358,204,154
KAGITHANE,CELIKTEPE MAH.,415,371,366,187,179
KAGITHANE,CELIKTEPE MAH.,415,361,360,192,168
KAGITHANE,CELIKTEPE MAH.,413,372,365,198,167
KAGITHANE,CELIKTEPE MAH.,414,374,371,199,172
KAGITHANE,CELIKTEPE MAH.,415,366,363,188,175
KAGITHANE,CELIKTEPE MAH.,415,365,363,193,170
KAGITHANE,CELIKTEPE MAH.,413,373,370,187,183
KAGITHANE,CELIKTEPE MAH.,415,358,358,158,200
KAGITHANE,CELIKTEPE MAH.,414,374,368,173,195
KAGITHANE,CELIKTEPE MAH.,415,368,367,203,164
KAGITHANE,CELIKTEPE MAH.,413,370,365,190,175
KAGITHANE,CELIKTEPE MAH.,414,376,370,203,167
KAGITHANE,CELIKTEPE MAH.,413,368,364,187,177
KAGITHANE,CELIKTEPE MAH.,415,379,374,188,186
KAGITHANE,CELIKTEPE MAH.,413,386,380,198,182
KAGITHANE,CELIKTEPE MAH.,415,365,361,191,170
KAGITHANE,CELIKTEPE MAH.,415,353,351,204,147
KAGITHANE,CELIKTEPE MAH.,415,363,356,176,180
KAGITHANE,CELIKTEPE MAH.,415,370,368,191,177
KAGITHANE,CELIKTEPE MAH.,413,360,356,200,156
KAGITHANE,CELIKTEPE MAH.,415,366,361,195,166
KAGITHANE,CELIKTEPE MAH.,415,357,357,191,166
KAGITHANE,CELIKTEPE MAH.,414,348,344,191,153
KAGITHANE,CELIKTEPE MAH.,414,373,373,203,170
KAGITHANE,CELIKTEPE MAH.,415,367,365,202,163
KAGITHANE,CELIKTEPE MAH.,415,370,365,180,185
KAGITHANE,CELIKTEPE MAH.,415,376,370,200,170
KAGITHANE,CELIKTEPE MAH.,414,367,361,197,164
KAGITHANE,CELIKTEPE MAH.,415,369,365,178,187
KAGITHANE,CELIKTEPE MAH.,415,364,362,186,176
KAGITHANE,CELIKTEPE MAH.,413,370,365,198,167
KAGITHANE,CELIKTEPE MAH.,413,369,362,200,162
KAGITHANE,EMNIYET EVLERI MAH.,408,344,342,152,190
KAGITHANE,EMNIYET EVLERI MAH.,408,352,348,163,185
KAGITHANE,EMNIYET EVLERI MAH.,410,373,372,147,225
KAGITHANE,EMNIYET EVLERI MAH.,407,367,365,133,232
KAGITHANE,EMNIYET EVLERI MAH.,407,376,372,141,231
KAGITHANE,EMNIYET EVLERI MAH.,407,372,365,144,221
KAGITHANE,EMNIYET EVLERI MAH.,407,373,370,145,225
KAGITHANE,EMNIYET EVLERI MAH.,408,376,367,151,216
KAGITHANE,EMNIYET EVLERI MAH.,407,361,357,127,230
KAGITHANE,EMNIYET EVLERI MAH.,415,365,363,162,201
KAGITHANE,EMNIYET EVLERI MAH.,407,358,350,138,212
KAGITHANE,EMNIYET EVLERI MAH.,408,377,374,138,236
KAGITHANE,EMNIYET EVLERI MAH.,408,348,347,150,197
KAGITHANE,EMNIYET EVLERI MAH.,407,373,371,131,240
KAGITHANE,EMNIYET EVLERI MAH.,408,378,375,132,243
KAGITHANE,EMNIYET EVLERI MAH.,408,378,375,144,231
KAGITHANE,GULTEPE MAH.,410,325,314,176,138
KAGITHANE,GULTEPE MAH.,409,318,309,182,127
KAGITHANE,GULTEPE MAH.,410,363,359,172,187
KAGITHANE,GULTEPE MAH.,409,370,361,197,164
KAGITHANE,GULTEPE MAH.,410,365,360,201,159
KAGITHANE,GULTEPE MAH.,410,373,368,186,182
KAGITHANE,GULTEPE MAH.,409,364,358,204,154
KAGITHANE,GULTEPE MAH.,410,367,366,200,166
KAGITHANE,GULTEPE MAH.,410,350,347,195,152
KAGITHANE,GULTEPE MAH.,409,366,362,183,179
KAGITHANE,GULTEPE MAH.,410,367,363,212,151
KAGITHANE,GULTEPE MAH.,410,352,349,205,144
KAGITHANE,GULTEPE MAH.,409,360,357,178,179
KAGITHANE,GULTEPE MAH.,409,346,339,189,150
KAGITHANE,GULTEPE MAH.,410,348,340,185,155
KAGITHANE,GULTEPE MAH.,410,354,346,203,143
KAGITHANE,GULTEPE MAH.,410,353,346,193,153
KAGITHANE,GULTEPE MAH.,410,361,353,174,179
KAGITHANE,GULTEPE MAH.,409,370,364,204,160
KAGITHANE,GULTEPE MAH.,410,366,357,173,184
KAGITHANE,GULTEPE MAH.,410,363,359,194,165
KAGITHANE,GULTEPE MAH.,409,352,350,212,138
KAGITHANE,GULTEPE MAH.,410,363,360,199,161
KAGITHANE,GULTEPE MAH.,410,354,353,177,176
KAGITHANE,GULTEPE MAH.,410,361,359,199,160
KAGITHANE,HARMANTEPE MAH.,397,317,304,146,158
KAGITHANE,HARMANTEPE MAH.,396,334,329,155,174
KAGITHANE,HARMANTEPE MAH.,396,358,354,170,184
KAGITHANE,HARMANTEPE MAH.,396,352,348,167,181
KAGITHANE,HARMANTEPE MAH.,396,336,330,177,153
KAGITHANE,HARMANTEPE MAH.,396,336,330,189,141
KAGITHANE,HARMANTEPE MAH.,396,349,345,195,150
KAGITHANE,HARMANTEPE MAH.,396,345,343,192,151
KAGITHANE,HARMANTEPE MAH.,396,361,358,229,129
KAGITHANE,HARMANTEPE MAH.,396,358,355,177,178
KAGITHANE,HARMANTEPE MAH.,400,366,358,195,163
KAGITHANE,HARMANTEPE MAH.,395,357,352,179,173
KAGITHANE,HARMANTEPE MAH.,396,353,347,182,165
KAGITHANE,HARMANTEPE MAH.,396,356,352,176,176
KAGITHANE,HARMANTEPE MAH.,407,319,308,149,159
KAGITHANE,HARMANTEPE MAH.,407,338,327,181,146
KAGITHANE,HARMANTEPE MAH.,408,367,357,192,165
KAGITHANE,HARMANTEPE MAH.,407,353,347,181,166
KAGITHANE,HARMANTEPE MAH.,407,361,352,196,156
KAGITHANE,HARMANTEPE MAH.,408,360,356,199,157
KAGITHANE,HARMANTEPE MAH.,407,358,355,204,151
KAGITHANE,HARMANTEPE MAH.,410,366,365,220,145
KAGITHANE,HARMANTEPE MAH.,406,341,334,166,168
KAGITHANE,HARMANTEPE MAH.,407,355,349,197,152
KAGITHANE,HARMANTEPE MAH.,408,359,356,194,162
KAGITHANE,HARMANTEPE MAH.,406,350,347,187,160
KAGITHANE,HARMANTEPE MAH.,407,360,356,193,163
KAGITHANE,HARMANTEPE MAH.,407,354,351,187,164
KAGITHANE,HARMANTEPE MAH.,407,357,353,206,147
KAGITHANE,HARMANTEPE MAH.,407,348,343,184,159
KAGITHANE,HARMANTEPE MAH.,407,349,344,190,154
KAGITHANE,HARMANTEPE MAH.,407,350,345,187,158
KAGITHANE,HARMANTEPE MAH.,407,354,348,163,185
KAGITHANE,HARMANTEPE MAH.,407,360,356,205,151
KAGITHANE,HARMANTEPE MAH.,391,319,314,179,135
KAGITHANE,HARMANTEPE MAH.,394,354,354,206,148
KAGITHANE,HARMANTEPE MAH.,390,347,346,166,180
KAGITHANE,HARMANTEPE MAH.,392,348,343,190,153
KAGITHANE,HARMANTEPE MAH.,392,346,343,199,144
KAGITHANE,HARMANTEPE MAH.,391,342,339,197,142
KAGITHANE,ORTABAYIR MAH.,402,347,342,197,145
KAGITHANE,ORTABAYIR MAH.,402,344,337,195,142
KAGITHANE,ORTABAYIR MAH.,402,367,364,175,189
KAGITHANE,ORTABAYIR MAH.,402,371,369,180,189
KAGITHANE,ORTABAYIR MAH.,402,358,356,164,192
KAGITHANE,ORTABAYIR MAH.,402,357,352,180,172
KAGITHANE,ORTABAYIR MAH.,402,367,363,162,201
KAGITHANE,ORTABAYIR MAH.,401,367,363,170,193
KAGITHANE,ORTABAYIR MAH.,402,370,369,183,186
KAGITHANE,ORTABAYIR MAH.,402,367,363,179,184
KAGITHANE,ORTABAYIR MAH.,404,357,355,181,174
KAGITHANE,ORTABAYIR MAH.,403,373,362,168,194
KAGITHANE,ORTABAYIR MAH.,402,356,353,188,165
KAGITHANE,ORTABAYIR MAH.,402,365,365,183,182
KAGITHANE,ORTABAYIR MAH.,401,370,366,198,168
KAGITHANE,ORTABAYIR MAH.,402,361,356,184,172
KAGITHANE,ORTABAYIR MAH.,402,351,346,156,190
KAGITHANE,ORTABAYIR MAH.,401,347,341,168,173
KAGITHANE,ORTABAYIR MAH.,401,348,343,168,175
KAGITHANE,ORTABAYIR MAH.,404,367,360,161,199
KAGITHANE,ORTABAYIR MAH.,385,301,299,104,195
KAGITHANE,ORTABAYIR MAH.,385,346,344,112,232
KAGITHANE,ORTABAYIR MAH.,385,341,339,128,211
KAGITHANE,ORTABAYIR MAH.,386,330,327,126,201
KAGITHANE,ORTABAYIR MAH.,384,344,339,116,223
KAGITHANE,ORTABAYIR MAH.,385,340,336,146,190
KAGITHANE,ORTABAYIR MAH.,384,357,349,150,199
KAGITHANE,ORTABAYIR MAH.,384,349,347,125,222
KAGITHANE,ORTABAYIR MAH.,408,334,331,161,170
KAGITHANE,ORTABAYIR MAH.,410,347,342,154,188
KAGITHANE,ORTABAYIR MAH.,410,369,365,141,224
KAGITHANE,ORTABAYIR MAH.,408,358,356,134,222
KAGITHANE,ORTABAYIR MAH.,410,355,348,144,204
KAGITHANE,ORTABAYIR MAH.,410,354,351,161,190
KAGITHANE,ORTABAYIR MAH.,410,368,363,127,236
KAGITHANE,ORTABAYIR MAH.,410,366,363,145,218
KAGITHANE,ORTABAYIR MAH.,410,355,350,147,203
KAGITHANE,ORTABAYIR MAH.,408,368,361,144,217
KAGITHANE,ORTABAYIR MAH.,409,348,342,135,207
KAGITHANE,ORTABAYIR MAH.,410,369,366,153,213
KAGITHANE,ORTABAYIR MAH.,410,380,367,169,198
KAGITHANE,ORTABAYIR MAH.,410,361,357,121,236
KAGITHANE,ORTABAYIR MAH.,409,368,360,134,226
KAGITHANE,ORTABAYIR MAH.,410,367,364,168,196
KAGITHANE,SEYRANTEPE MAH.,377,325,311,173,138
KAGITHANE,SEYRANTEPE MAH.,378,339,336,176,160
KAGITHANE,SEYRANTEPE MAH.,375,324,321,182,139
KAGITHANE,SEYRANTEPE MAH.,378,334,332,207,125
KAGITHANE,SEYRANTEPE MAH.,377,333,329,177,152
KAGITHANE,SEYRANTEPE MAH.,376,339,331,189,142
KAGITHANE,SEYRANTEPE MAH.,375,328,324,174,150
KAGITHANE,SEYRANTEPE MAH.,376,338,330,193,137
KAGITHANE,SEYRANTEPE MAH.,378,334,331,170,161
KAGITHANE,SEYRANTEPE MAH.,398,335,329,167,162
KAGITHANE,SEYRANTEPE MAH.,398,342,338,184,154
KAGITHANE,SEYRANTEPE MAH.,399,349,343,170,173
KAGITHANE,SEYRANTEPE MAH.,399,354,347,198,149
KAGITHANE,SEYRANTEPE MAH.,399,358,353,210,143
KAGITHANE,SEYRANTEPE MAH.,401,348,347,188,159
KAGITHANE,SEYRANTEPE MAH.,398,355,350,192,158
KAGITHANE,SEYRANTEPE MAH.,398,352,344,217,127
KAGITHANE,SEYRANTEPE MAH.,399,347,344,196,148
KAGITHANE,SEYRANTEPE MAH.,399,359,353,208,145
KAGITHANE,SEYRANTEPE MAH.,398,346,343,196,147
KAGITHANE,SEYRANTEPE MAH.,399,357,352,191,161
KAGITHANE,SEYRANTEPE MAH.,400,354,353,199,154
KAGITHANE,SEYRANTEPE MAH.,400,345,338,162,176
KAGITHANE,SEYRANTEPE MAH.,399,354,353,185,168
KAGITHANE,SEYRANTEPE MAH.,399,346,335,169,166
KAGITHANE,SEYRANTEPE MAH.,400,353,352,197,155
KAGITHANE,SEYRANTEPE MAH.,398,352,351,195,156
KAGITHANE,SEYRANTEPE MAH.,399,362,359,197,162
KAGITHANE,SEYRANTEPE MAH.,410,360,355,155,200
KAGITHANE,SEYRANTEPE MAH.,415,398,391,188,203
KAGITHANE,SEYRANTEPE MAH.,415,364,361,179,182
KAGITHANE,SEYRANTEPE MAH.,409,371,368,165,203
KAGITHANE,SEYRANTEPE MAH.,410,366,363,181,182
KAGITHANE,SEYRANTEPE MAH.,410,364,361,186,175
KAGITHANE,SEYRANTEPE MAH.,411,382,379,192,187
KAGITHANE,SEYRANTEPE MAH.,410,370,370,151,219
KAGITHANE,SEYRANTEPE MAH.,410,361,357,163,194
KAGITHANE,SEYRANTEPE MAH.,409,376,373,177,196
KAGITHANE,SEYRANTEPE MAH.,410,376,374,175,199
KAGITHANE,SEYRANTEPE MAH.,415,368,366,200,166
KAGITHANE,SEYRANTEPE MAH.,410,362,359,186,173
KAGITHANE,SULTAN SELIM MAH.,415,327,324,222,102
KAGITHANE,SULTAN SELIM MAH.,415,320,308,212,96
KAGITHANE,SULTAN SELIM MAH.,411,346,342,220,122
KAGITHANE,SULTAN SELIM MAH.,415,368,362,250,112
KAGITHANE,SULTAN SELIM MAH.,411,354,352,248,104
KAGITHANE,SULTAN SELIM MAH.,411,349,346,250,96
KAGITHANE,SULTAN SELIM MAH.,412,369,367,235,132
KAGITHANE,SULTAN SELIM MAH.,412,361,354,214,140
KAGITHANE,SULTAN SELIM MAH.,411,366,363,255,108
KAGITHANE,SULTAN SELIM MAH.,410,375,369,227,142
KAGITHANE,SULTAN SELIM MAH.,411,346,344,202,142
KAGITHANE,SULTAN SELIM MAH.,411,367,363,243,120
KAGITHANE,SULTAN SELIM MAH.,410,357,356,238,118
KAGITHANE,SULTAN SELIM MAH.,411,364,363,232,131
KAGITHANE,SULTAN SELIM MAH.,410,372,367,230,137
KAGITHANE,SULTAN SELIM MAH.,411,378,373,252,121
KAGITHANE,SULTAN SELIM MAH.,411,357,356,249,107
KAGITHANE,SULTAN SELIM MAH.,411,362,360,229,131
KAGITHANE,SULTAN SELIM MAH.,411,351,349,227,122
KAGITHANE,SULTAN SELIM MAH.,411,370,366,251,115
KAGITHANE,SULTAN SELIM MAH.,410,357,351,238,113
KAGITHANE,SULTAN SELIM MAH.,410,359,354,244,110
KAGITHANE,SULTAN SELIM MAH.,410,354,352,233,119
KAGITHANE,SULTAN SELIM MAH.,410,355,345,218,127
KAGITHANE,SULTAN SELIM MAH.,410,368,366,225,141
KAGITHANE,SULTAN SELIM MAH.,411,366,359,221,138
KAGITHANE,SULTAN SELIM MAH.,411,372,371,240,131
KAGITHANE,SULTAN SELIM MAH.,411,347,339,211,128
KAGITHANE,SULTAN SELIM MAH.,396,326,321,213,108
KAGITHANE,SULTAN SELIM MAH.,395,348,342,223,119
KAGITHANE,SULTAN SELIM MAH.,395,348,341,202,139
KAGITHANE,SULTAN SELIM MAH.,395,346,345,215,130
KAGITHANE,SULTAN SELIM MAH.,397,354,341,225,116
KAGITHANE,SULTAN SELIM MAH.,396,350,346,252,94
KAGITHANE,SULTAN SELIM MAH.,397,345,343,234,109
KAGITHANE,SULTAN SELIM MAH.,395,355,355,256,99
KAGITHANE,SULTAN SELIM MAH.,396,332,329,207,122
KAGITHANE,SULTAN SELIM MAH.,395,372,368,244,124
KAGITHANE,SULTAN SELIM MAH.,396,337,333,225,108
KAGITHANE,SULTAN SELIM MAH.,395,344,340,218,122
KAGITHANE,SULTAN SELIM MAH.,396,361,355,246,109
KAGITHANE,SULTAN SELIM MAH.,399,357,351,234,117
KAGITHANE,SULTAN SELIM MAH.,395,346,341,221,120
KAGITHANE,SULTAN SELIM MAH.,396,353,352,235,117
KAGITHANE,SULTAN SELIM MAH.,400,342,340,211,129
KAGITHANE,SULTAN SELIM MAH.,400,318,310,179,131
KAGITHANE,SULTAN SELIM MAH.,400,351,348,196,152
KAGITHANE,SULTAN SELIM MAH.,401,345,339,193,146
KAGITHANE,SULTAN SELIM MAH.,401,343,341,159,182
KAGITHANE,SULTAN SELIM MAH.,402,351,350,197,153
KAGITHANE,SULTAN SELIM MAH.,402,362,360,221,139
KAGITHANE,SULTAN SELIM MAH.,399,350,345,221,124
KAGITHANE,SULTAN SELIM MAH.,400,347,345,193,152
KAGITHANE,SULTAN SELIM MAH.,400,355,350,197,153
KAGITHANE,SULTAN SELIM MAH.,399,349,345,191,154
KAGITHANE,SULTAN SELIM MAH.,400,356,352,198,154
KAGITHANE,SULTAN SELIM MAH.,400,345,340,193,147
KAGITHANE,SULTAN SELIM MAH.,399,349,346,174,172
KAGITHANE,SULTAN SELIM MAH.,399,345,343,210,133
KAGITHANE,SULTAN SELIM MAH.,399,282,282,161,121
KAGITHANE,SULTAN SELIM MAH.,399,355,351,203,148
KAGITHANE,SULTAN SELIM MAH.,399,329,326,176,150
KAGITHANE,SULTAN SELIM MAH.,399,361,355,202,153
KAGITHANE,SULTAN SELIM MAH.,399,347,339,162,177
KAGITHANE,SULTAN SELIM MAH.,400,344,340,201,139
KAGITHANE,SIRINTEPE MAH.,397,333,322,235,87
KAGITHANE,SIRINTEPE MAH.,400,359,350,252,98
KAGITHANE,SIRINTEPE MAH.,398,350,343,261,82
KAGITHANE,SIRINTEPE MAH.,397,345,335,229,106
KAGITHANE,SIRINTEPE MAH.,400,364,359,251,108
KAGITHANE,SIRINTEPE MAH.,398,367,360,266,94
KAGITHANE,SIRINTEPE MAH.,398,350,349,241,108
KAGITHANE,SIRINTEPE MAH.,398,373,370,273,97
KAGITHANE,SIRINTEPE MAH.,399,350,346,251,95
KAGITHANE,SIRINTEPE MAH.,398,354,347,229,118
KAGITHANE,SIRINTEPE MAH.,397,356,351,248,103
KAGITHANE,SIRINTEPE MAH.,398,355,351,248,103
KAGITHANE,SIRINTEPE MAH.,397,356,349,226,123
KAGITHANE,SIRINTEPE MAH.,397,357,353,249,104
KAGITHANE,SIRINTEPE MAH.,397,354,347,233,114
KAGITHANE,SIRINTEPE MAH.,398,359,353,259,94
KAGITHANE,SIRINTEPE MAH.,397,351,347,244,103
KAGITHANE,SIRINTEPE MAH.,398,354,351,245,106
KAGITHANE,SIRINTEPE MAH.,397,343,339,227,112
KAGITHANE,SIRINTEPE MAH.,397,339,331,248,83
KAGITHANE,SIRINTEPE MAH.,415,336,324,217,107
KAGITHANE,SIRINTEPE MAH.,415,357,342,210,132
KAGITHANE,SIRINTEPE MAH.,415,355,355,215,140
KAGITHANE,SIRINTEPE MAH.,415,363,355,214,141
KAGITHANE,SIRINTEPE MAH.,415,375,366,238,128
KAGITHANE,SIRINTEPE MAH.,414,375,370,222,148
KAGITHANE,SIRINTEPE MAH.,412,361,358,224,134
KAGITHANE,SIRINTEPE MAH.,414,362,355,222,133
KAGITHANE,SIRINTEPE MAH.,415,357,351,233,118
KAGITHANE,SIRINTEPE MAH.,414,364,360,235,125
KAGITHANE,SIRINTEPE MAH.,414,366,356,217,139
KAGITHANE,SIRINTEPE MAH.,415,366,361,194,167
KAGITHANE,SIRINTEPE MAH.,414,379,370,219,151
KAGITHANE,SIRINTEPE MAH.,414,370,357,215,142
KAGITHANE,SIRINTEPE MAH.,415,360,354,208,146
KAGITHANE,SIRINTEPE MAH.,415,359,353,211,142
KAGITHANE,SIRINTEPE MAH.,414,355,352,193,159
KAGITHANE,SIRINTEPE MAH.,414,356,350,213,137
KAGITHANE,TELSIZLER MAH.,407,321,312,138,174
KAGITHANE,TELSIZLER MAH.,406,318,308,141,167
KAGITHANE,TELSIZLER MAH.,407,342,331,146,185
KAGITHANE,TELSIZLER MAH.,407,345,336,153,183
KAGITHANE,TELSIZLER MAH.,407,344,341,154,187
KAGITHANE,TELSIZLER MAH.,407,360,354,176,178
KAGITHANE,TELSIZLER MAH.,406,348,347,141,206
KAGITHANE,TELSIZLER MAH.,407,347,342,185,157
KAGITHANE,TELSIZLER MAH.,407,348,340,160,180
KAGITHANE,TELSIZLER MAH.,407,361,352,151,201
KAGITHANE,TELSIZLER MAH.,406,341,337,150,187
KAGITHANE,TELSIZLER MAH.,405,351,348,143,205
KAGITHANE,TELSIZLER MAH.,406,349,345,156,189
KAGITHANE,TELSIZLER MAH.,407,354,347,177,170
KAGITHANE,TELSIZLER MAH.,407,361,355,158,197
KAGITHANE,TELSIZLER MAH.,407,342,336,163,173
KAGITHANE,TELSIZLER MAH.,407,351,345,176,169
KAGITHANE,TELSIZLER MAH.,406,340,336,163,173
KAGITHANE,TELSIZLER MAH.,409,336,332,156,176
KAGITHANE,TELSIZLER MAH.,405,340,334,168,166
KAGITHANE,TELSIZLER MAH.,406,362,360,167,193
KAGITHANE,TELSIZLER MAH.,406,348,342,160,182
KAGITHANE,YESILCE MAH.,404,338,326,180,146
KAGITHANE,YESILCE MAH.,405,342,333,209,124
KAGITHANE,YESILCE MAH.,403,352,347,216,131
KAGITHANE,YESILCE MAH.,404,340,336,216,120
KAGITHANE,YESILCE MAH.,405,353,350,225,125
KAGITHANE,YESILCE MAH.,404,339,333,198,135
KAGITHANE,YESILCE MAH.,403,370,367,192,175
KAGITHANE,YESILCE MAH.,404,362,356,228,128
KAGITHANE,YESILCE MAH.,404,356,346,210,136
KAGITHANE,YESILCE MAH.,404,357,355,219,136
KAGITHANE,YESILCE MAH.,403,355,352,218,134
KAGITHANE,YESILCE MAH.,404,366,361,222,139
KAGITHANE,YESILCE MAH.,403,352,344,213,131
KAGITHANE,YESILCE MAH.,403,355,353,201,152
KAGITHANE,YESILCE MAH.,407,345,340,213,127
KAGITHANE,YESILCE MAH.,404,343,342,198,144
KAGITHANE,YESILCE MAH.,403,345,343,214,129
KAGITHANE,YESILCE MAH.,404,359,355,227,128
KAGITHANE,YESILCE MAH.,403,358,353,215,138
KAGITHANE,YESILCE MAH.,403,369,361,247,114
KAGITHANE,YESILCE MAH.,406,349,345,205,140
KAGITHANE,YESILCE MAH.,404,375,368,214,154
SULTANGAZI,ESENTEPE MAH.,404,341,335,245,90
SULTANGAZI,ESENTEPE MAH.,406,358,348,276,72
SULTANGAZI,ESENTEPE MAH.,406,370,363,284,79
SULTANGAZI,ESENTEPE MAH.,405,368,365,278,87
SULTANGAZI,ESENTEPE MAH.,406,363,356,259,97
SULTANGAZI,ESENTEPE MAH.,404,360,356,251,105
SULTANGAZI,ESENTEPE MAH.,406,373,368,277,91
SULTANGAZI,ESENTEPE MAH.,406,362,357,267,90
SULTANGAZI,ESENTEPE MAH.,405,369,365,271,94
SULTANGAZI,ESENTEPE MAH.,405,371,369,274,95
SULTANGAZI,ESENTEPE MAH.,406,362,360,267,93
SULTANGAZI,ESENTEPE MAH.,407,353,349,266,83
SULTANGAZI,ESENTEPE MAH.,405,358,349,243,106
SULTANGAZI,ESENTEPE MAH.,406,361,350,257,93
SULTANGAZI,ESENTEPE MAH.,408,378,370,287,83
SULTANGAZI,ESENTEPE MAH.,406,363,359,290,69
SULTANGAZI,ESENTEPE MAH.,408,362,356,260,96
SULTANGAZI,ESENTEPE MAH.,406,368,363,290,73
SULTANGAZI,ESENTEPE MAH.,405,369,369,278,91
SULTANGAZI,ESENTEPE MAH.,406,358,357,277,80
SULTANGAZI,ESENTEPE MAH.,407,376,365,279,86
SULTANGAZI,ESENTEPE MAH.,406,367,362,258,104
SULTANGAZI,ESENTEPE MAH.,405,349,341,260,81
SULTANGAZI,ESENTEPE MAH.,405,363,358,277,81
SULTANGAZI,ESENTEPE MAH.,405,353,347,255,92
SULTANGAZI,ESENTEPE MAH.,405,363,355,267,88
SULTANGAZI,ESENTEPE MAH.,405,361,357,247,110
SULTANGAZI,ESENTEPE MAH.,405,359,352,253,99
SULTANGAZI,ESENTEPE MAH.,405,359,353,268,85
SULTANGAZI,ESENTEPE MAH.,405,378,372,274,98
SULTANGAZI,ESENTEPE MAH.,405,362,361,253,108
SULTANGAZI,ESENTEPE MAH.,405,367,360,263,97
SULTANGAZI,ESENTEPE MAH.,405,372,369,281,88
SULTANGAZI,ESENTEPE MAH.,399,332,328,214,114
SULTANGAZI,ESENTEPE MAH.,401,347,343,236,107
SULTANGAZI,ESENTEPE MAH.,399,357,348,237,111
SULTANGAZI,ESENTEPE MAH.,400,347,339,243,96
SULTANGAZI,ESENTEPE MAH.,398,350,346,250,96
SULTANGAZI,ESENTEPE MAH.,398,351,343,232,111
SULTANGAZI,ESENTEPE MAH.,398,362,355,249,106
SULTANGAZI,ESENTEPE MAH.,398,359,353,224,129
SULTANGAZI,ESENTEPE MAH.,399,354,347,230,117
SULTANGAZI,ESENTEPE MAH.,398,356,350,235,115
SULTANGAZI,ESENTEPE MAH.,398,360,354,253,101
SULTANGAZI,ESENTEPE MAH.,398,367,357,248,109
SULTANGAZI,ESENTEPE MAH.,398,359,353,257,96
SULTANGAZI,ESENTEPE MAH.,399,360,353,255,98
SULTANGAZI,ESENTEPE MAH.,398,352,343,231,112
SULTANGAZI,ESENTEPE MAH.,398,339,333,230,103
SULTANGAZI,ESENTEPE MAH.,399,343,333,229,104
SULTANGAZI,ESENTEPE MAH.,399,355,350,252,98
SULTANGAZI,ESENTEPE MAH.,402,334,327,166,161
SULTANGAZI,ESENTEPE MAH.,401,347,341,186,155
SULTANGAZI,ESENTEPE MAH.,402,351,348,183,165
SULTANGAZI,ESENTEPE MAH.,401,341,330,184,146
SULTANGAZI,ESENTEPE MAH.,403,364,361,238,123
SULTANGAZI,ESENTEPE MAH.,401,360,355,200,155
SULTANGAZI,ESENTEPE MAH.,403,363,356,185,171
SULTANGAZI,ESENTEPE MAH.,402,360,357,188,169
SULTANGAZI,ESENTEPE MAH.,402,359,352,191,161
SULTANGAZI,ESENTEPE MAH.,405,366,366,175,191
SULTANGAZI,ESENTEPE MAH.,401,357,349,185,164
SULTANGAZI,ESENTEPE MAH.,403,355,352,192,160
SULTANGAZI,ESENTEPE MAH.,401,345,344,201,143
SULTANGAZI,ESENTEPE MAH.,402,351,344,171,173
SULTANGAZI,ESENTEPE MAH.,400,339,330,174,156
SULTANGAZI,ESENTEPE MAH.,401,346,343,187,156
SULTANGAZI,ESENTEPE MAH.,403,355,348,190,158
SULTANGAZI,ESENTEPE MAH.,402,332,321,195,126
SULTANGAZI,ESENTEPE MAH.,401,360,358,217,141
SULTANGAZI,ESENTEPE MAH.,400,343,337,174,163
SULTANGAZI,ESENTEPE MAH.,402,359,351,179,172
SULTANGAZI,ESENTEPE MAH.,402,344,340,207,133
SULTANGAZI,ESENTEPE MAH.,401,352,345,200,145
SULTANGAZI,ESENTEPE MAH.,400,337,332,169,163
SULTANGAZI,ESENTEPE MAH.,400,360,357,199,158
SULTANGAZI,ESENTEPE MAH.,400,355,349,183,166
SULTANGAZI,ESENTEPE MAH.,401,354,349,167,182
SULTANGAZI,ESENTEPE MAH.,403,351,348,191,157
SULTANGAZI,ESENTEPE MAH.,408,335,331,225,106
SULTANGAZI,ESENTEPE MAH.,408,360,353,239,114
SULTANGAZI,ESENTEPE MAH.,415,374,365,245,120
SULTANGAZI,ESENTEPE MAH.,409,351,348,219,129
SULTANGAZI,ESENTEPE MAH.,415,367,358,242,116
SULTANGAZI,ESENTEPE MAH.,408,365,361,242,119
SULTANGAZI,ESENTEPE MAH.,408,365,357,210,147
SULTANGAZI,ESENTEPE MAH.,408,368,357,257,100
SULTANGAZI,ESENTEPE MAH.,408,369,360,227,133
SULTANGAZI,ESENTEPE MAH.,408,367,363,232,131
SULTANGAZI,ESENTEPE MAH.,409,362,357,236,121
SULTANGAZI,ESENTEPE MAH.,409,380,371,262,109
SULTANGAZI,ESENTEPE MAH.,408,372,367,242,125
SULTANGAZI,ESENTEPE MAH.,406,368,360,219,141
SULTANGAZI,ESENTEPE MAH.,406,371,365,264,101
SULTANGAZI,ESENTEPE MAH.,409,354,350,223,127
SULTANGAZI,ESENTEPE MAH.,409,349,345,221,124
SULTANGAZI,ESENTEPE MAH.,408,373,367,246,121
SULTANGAZI,GAZI MAH.,415,372,369,81,288
SULTANGAZI,GAZI MAH.,412,379,374,53,321
SULTANGAZI,GAZI MAH.,415,372,367,82,285
SULTANGAZI,GAZI MAH.,411,364,361,76,285
SULTANGAZI,GAZI MAH.,412,369,362,83,279
SULTANGAZI,GAZI MAH.,412,374,371,87,284
SULTANGAZI,GAZI MAH.,411,384,381,68,313
SULTANGAZI,GAZI MAH.,415,374,369,71,298
SULTANGAZI,GAZI MAH.,415,383,378,83,295
SULTANGAZI,GAZI MAH.,411,382,380,75,305
SULTANGAZI,GAZI MAH.,415,388,386,76,310
SULTANGAZI,GAZI MAH.,415,378,373,69,304
SULTANGAZI,GAZI MAH.,415,385,384,80,304
SULTANGAZI,GAZI MAH.,411,395,394,98,296
SULTANGAZI,GAZI MAH.,410,367,367,81,286
SULTANGAZI,GAZI MAH.,411,365,361,117,244
SULTANGAZI,GAZI MAH.,414,371,370,102,268
SULTANGAZI,GAZI MAH.,411,375,366,105,261
SULTANGAZI,GAZI MAH.,411,377,375,75,300
SULTANGAZI,GAZI MAH.,412,383,375,54,321
SULTANGAZI,GAZI MAH.,412,374,370,89,281
SULTANGAZI,GAZI MAH.,411,382,381,72,309
SULTANGAZI,GAZI MAH.,410,383,377,92,285
SULTANGAZI,GAZI MAH.,412,380,375,104,271
SULTANGAZI,GAZI MAH.,410,373,369,110,259
SULTANGAZI,GAZI MAH.,410,365,362,81,281
SULTANGAZI,GAZI MAH.,415,371,367,102,265
SULTANGAZI,GAZI MAH.,412,385,377,82,295
SULTANGAZI,GAZI MAH.,411,385,381,77,304
SULTANGAZI,GAZI MAH.,411,373,366,74,292
SULTANGAZI,GAZI MAH.,410,373,372,88,284
SULTANGAZI,GAZI MAH.,411,361,356,80,276
SULTANGAZI,GAZI MAH.,411,383,380,67,313
SULTANGAZI,GAZI MAH.,402,346,344,56,288
SULTANGAZI,GAZI MAH.,404,353,350,59,291
SULTANGAZI,GAZI MAH.,405,370,369,60,309
SULTANGAZI,GAZI MAH.,403,362,358,57,301
SULTANGAZI,GAZI MAH.,404,379,379,61,318
SULTANGAZI,GAZI MAH.,403,366,363,66,297
SULTANGAZI,GAZI MAH.,401,363,359,85,274
SULTANGAZI,GAZI MAH.,401,375,374,71,303
SULTANGAZI,GAZI MAH.,401,355,351,63,288
SULTANGAZI,GAZI MAH.,402,366,362,92,270
SULTANGAZI,GAZI MAH.,401,369,366,52,314
SULTANGAZI,GAZI MAH.,401,363,359,70,289
SULTANGAZI,GAZI MAH.,402,363,362,62,300
SULTANGAZI,GAZI MAH.,401,369,364,57,307
SULTANGAZI,GAZI MAH.,401,367,365,49,316
SULTANGAZI,GAZI MAH.,402,380,374,69,305
SULTANGAZI,GAZI MAH.,401,367,364,85,279
SULTANGAZI,GAZI MAH.,402,358,350,52,298
SULTANGAZI,GAZI MAH.,401,362,359,64,295
SULTANGAZI,GAZI MAH.,402,376,371,62,309
SULTANGAZI,GAZI MAH.,401,369,367,50,317
SULTANGAZI,GAZI MAH.,401,368,365,51,314
SULTANGAZI,GAZI MAH.,402,369,366,64,302
SULTANGAZI,GAZI MAH.,401,374,372,72,300
SULTANGAZI,GAZI MAH.,402,368,363,63,300
SULTANGAZI,GAZI MAH.,402,369,367,69,298
SULTANGAZI,GAZI MAH.,402,358,356,61,295
SULTANGAZI,YUNUS EMRE MAH.,415,327,321,168,153
SULTANGAZI,YUNUS EMRE MAH.,410,358,354,217,137
SULTANGAZI,YUNUS EMRE MAH.,415,365,357,217,140
SULTANGAZI,YUNUS EMRE MAH.,415,362,356,187,169
SULTANGAZI,YUNUS EMRE MAH.,415,359,347,171,176
SULTANGAZI,YUNUS EMRE MAH.,415,353,349,171,178
SULTANGAZI,YUNUS EMRE MAH.,415,372,366,212,154
SULTANGAZI,YUNUS EMRE MAH.,415,379,372,210,162
SULTANGAZI,YUNUS EMRE MAH.,415,370,363,183,180
SULTANGAZI,YUNUS EMRE MAH.,414,368,360,201,159
SULTANGAZI,YUNUS EMRE MAH.,415,360,359,209,150
SULTANGAZI,YUNUS EMRE MAH.,415,366,360,199,161
SULTANGAZI,YUNUS EMRE MAH.,411,369,360,195,165
SULTANGAZI,YUNUS EMRE MAH.,413,358,351,198,153
SULTANGAZI,YUNUS EMRE MAH.,412,378,369,231,138
SULTANGAZI,YUNUS EMRE MAH.,412,368,363,188,175
SULTANGAZI,YUNUS EMRE MAH.,412,389,384,184,200
SULTANGAZI,YUNUS EMRE MAH.,413,379,373,229,144
SULTANGAZI,YUNUS EMRE MAH.,412,369,362,189,173
SULTANGAZI,YUNUS EMRE MAH.,413,349,347,200,147
SULTANGAZI,YUNUS EMRE MAH.,413,359,355,205,150
SULTANGAZI,YUNUS EMRE MAH.,411,374,368,203,165
SULTANGAZI,YUNUS EMRE MAH.,415,371,368,112,256
SULTANGAZI,YUNUS EMRE MAH.,415,369,364,108,256
SULTANGAZI,YUNUS EMRE MAH.,415,369,364,110,254
SULTANGAZI,YUNUS EMRE MAH.,415,380,374,128,246
SULTANGAZI,YUNUS EMRE MAH.,415,386,384,122,262
SULTANGAZI,YUNUS EMRE MAH.,415,391,386,117,269
SULTANGAZI,YUNUS EMRE MAH.,414,377,376,108,268
SULTANGAZI,YUNUS EMRE MAH.,415,377,369,126,243
SULTANGAZI,YUNUS EMRE MAH.,415,373,365,105,260
SULTANGAZI,YUNUS EMRE MAH.,410,374,369,122,247
SULTANGAZI,YUNUS EMRE MAH.,414,372,366,125,241
SULTANGAZI,YUNUS EMRE MAH.,415,356,351,123,228
SULTANGAZI,YUNUS EMRE MAH.,415,366,359,132,227
SULTANGAZI,YUNUS EMRE MAH.,413,346,342,134,208
SULTANGAZI,YUNUS EMRE MAH.,412,364,358,152,206
SULTANGAZI,YUNUS EMRE MAH.,411,375,373,148,225
SULTANGAZI,YUNUS EMRE MAH.,412,393,389,160,229
SULTANGAZI,YUNUS EMRE MAH.,413,375,372,147,225
SULTANGAZI,YUNUS EMRE MAH.,411,380,378,125,253
SULTANGAZI,YUNUS EMRE MAH.,413,359,354,96,258
SULTANGAZI,YUNUS EMRE MAH.,414,369,362,140,222
SULTANGAZI,YUNUS EMRE MAH.,414,374,369,123,246
SULTANGAZI,YUNUS EMRE MAH.,413,380,379,103,276
SULTANGAZI,YUNUS EMRE MAH.,413,377,372,115,257
SULTANGAZI,YUNUS EMRE MAH.,405,375,373,92,281
SULTANGAZI,YUNUS EMRE MAH.,405,375,374,88,286
SULTANGAZI,YUNUS EMRE MAH.,405,367,362,74,288
SULTANGAZI,YUNUS EMRE MAH.,405,370,366,100,266
SULTANGAZI,YUNUS EMRE MAH.,405,373,370,80,290
SULTANGAZI,YUNUS EMRE MAH.,406,370,362,104,258
SULTANGAZI,YUNUS EMRE MAH.,405,378,370,71,299
SULTANGAZI,YUNUS EMRE MAH.,405,364,360,99,261
SULTANGAZI,YUNUS EMRE MAH.,405,375,371,92,279
SULTANGAZI,YUNUS EMRE MAH.,415,349,342,106,236
SULTANGAZI,YUNUS EMRE MAH.,415,372,365,124,241
SULTANGAZI,YUNUS EMRE MAH.,411,368,364,171,193
SULTANGAZI,YUNUS EMRE MAH.,415,372,368,176,192
SULTANGAZI,YUNUS EMRE MAH.,415,390,387,158,229
SULTANGAZI,YUNUS EMRE MAH.,415,364,358,164,194
SULTANGAZI,YUNUS EMRE MAH.,415,370,366,121,245
SULTANGAZI,YUNUS EMRE MAH.,415,359,356,122,234
SULTANGAZI,YUNUS EMRE MAH.,414,375,372,148,224
SULTANGAZI,YUNUS EMRE MAH.,415,382,374,144,230
SULTANGAZI,YUNUS EMRE MAH.,413,379,374,165,209
SULTANGAZI,YUNUS EMRE MAH.,413,369,365,152,213
SULTANGAZI,YUNUS EMRE MAH.,415,375,375,140,235
SULTANGAZI,YUNUS EMRE MAH.,415,384,381,171,210
SULTANGAZI,YUNUS EMRE MAH.,413,371,367,169,198
SULTANGAZI,YUNUS EMRE MAH.,412,347,342,139,203
SULTANGAZI,YUNUS EMRE MAH.,413,371,365,145,220
SULTANGAZI,YUNUS EMRE MAH.,412,366,365,162,203
SULTANGAZI,YUNUS EMRE MAH.,415,373,368,171,197
SULTANGAZI,YUNUS EMRE MAH.,412,370,364,132,232
SULTANGAZI,ZUBEYDE HANIM MAH.,415,374,368,83,285
SULTANGAZI,ZUBEYDE HANIM MAH.,411,353,352,68,284
SULTANGAZI,ZUBEYDE HANIM MAH.,410,369,368,118,250
SULTANGAZI,ZUBEYDE HANIM MAH.,411,384,369,120,249
SULTANGAZI,ZUBEYDE HANIM MAH.,408,366,364,114,250
SULTANGAZI,ZUBEYDE HANIM MAH.,411,355,353,106,247
SULTANGAZI,ZUBEYDE HANIM MAH.,415,373,369,119,250
SULTANGAZI,ZUBEYDE HANIM MAH.,410,364,357,104,253
SULTANGAZI,ZUBEYDE HANIM MAH.,415,368,355,116,239
SULTANGAZI,ZUBEYDE HANIM MAH.,410,384,378,116,262
SULTANGAZI,ZUBEYDE HANIM MAH.,410,376,370,145,225
SULTANGAZI,ZUBEYDE HANIM MAH.,411,365,361,100,261
SULTANGAZI,ZUBEYDE HANIM MAH.,409,378,378,122,256
SULTANGAZI,ZUBEYDE HANIM MAH.,410,360,354,116,238
SULTANGAZI,ZUBEYDE HANIM MAH.,411,373,370,114,256
SULTANGAZI,ZUBEYDE HANIM MAH.,410,362,361,108,253
SULTANGAZI,ZUBEYDE HANIM MAH.,411,349,346,112,234
SULTANGAZI,ZUBEYDE HANIM MAH.,410,368,365,135,230
SULTANGAZI,ZUBEYDE HANIM MAH.,409,365,356,112,244
SULTANGAZI,ZUBEYDE HANIM MAH.,409,372,369,129,240
SULTANGAZI,ZUBEYDE HANIM MAH.,409,357,347,131,216
SULTANGAZI,ZUBEYDE HANIM MAH.,408,362,353,143,210
SULTANGAZI,ZUBEYDE HANIM MAH.,411,365,359,126,233
SULTANGAZI,ZUBEYDE HANIM MAH.,409,353,346,115,231
SULTANGAZI,ZUBEYDE HANIM MAH.,409,358,349,112,237
SULTANGAZI,ZUBEYDE HANIM MAH.,410,362,356,117,239
SULTANGAZI,ZUBEYDE HANIM MAH.,415,381,376,102,274
SULTANGAZI,ZUBEYDE HANIM MAH.,409,369,365,96,269
SULTANGAZI,ZUBEYDE HANIM MAH.,410,356,349,111,238
SULTANGAZI,ZUBEYDE HANIM MAH.,410,384,377,120,257
SULTANGAZI,ZUBEYDE HANIM MAH.,410,364,360,110,250
SULTANGAZI,ZUBEYDE HANIM MAH.,410,372,369,133,236
SULTANGAZI,ZUBEYDE HANIM MAH.,410,354,348,121,227
SULTANGAZI,ZUBEYDE HANIM MAH.,412,363,360,129,231
SULTANGAZI,ZUBEYDE HANIM MAH.,410,369,363,116,247
SULTANGAZI,ZUBEYDE HANIM MAH.,411,366,360,118,242
SULTANGAZI,ZUBEYDE HANIM MAH.,415,374,369,136,233
SULTANGAZI,ZUBEYDE HANIM MAH.,409,364,356,114,242
SULTANGAZI,ZUBEYDE HANIM MAH.,409,370,369,123,246
SULTANGAZI,ZUBEYDE HANIM MAH.,410,373,369,148,221
SULTANGAZI,ZUBEYDE HANIM MAH.,410,376,371,134,237
SULTANGAZI,ZUBEYDE HANIM MAH.,409,377,370,136,234
SULTANGAZI,ZUBEYDE HANIM MAH.,410,366,358,104,254
SULTANGAZI,ZUBEYDE HANIM MAH.,410,370,366,127,239
SULTANGAZI,ZUBEYDE HANIM MAH.,409,369,364,111,253
SULTANGAZI,ZUBEYDE HANIM MAH.,409,366,359,116,243
SULTANGAZI,ZUBEYDE HANIM MAH.,410,372,368,141,227
SULTANGAZI,ZUBEYDE HANIM MAH.,409,359,355,107,248
SULTANGAZI,ZUBEYDE HANIM MAH.,415,383,380,141,239
SULTANGAZI,ZUBEYDE HANIM MAH.,411,369,365,133,232
SULTANGAZI,ZUBEYDE HANIM MAH.,410,362,355,123,232
SULTANGAZI,ZUBEYDE HANIM MAH.,410,355,352,120,232
SULTANGAZI,ZUBEYDE HANIM MAH.,410,378,373,130,243
SULTANGAZI,ZUBEYDE HANIM MAH.,410,375,370,122,248
SULTANGAZI,50. YIL MAH.,415,352,349,257,92
SULTANGAZI,50. YIL MAH.,415,342,331,263,68
SULTANGAZI,50. YIL MAH.,415,363,356,263,93
SULTANGAZI,50. YIL MAH.,415,361,357,266,91
SULTANGAZI,50. YIL MAH.,415,388,383,308,75
SULTANGAZI,50. YIL MAH.,410,371,369,280,89
SULTANGAZI,50. YIL MAH.,415,377,370,279,91
SULTANGAZI,50. YIL MAH.,415,374,373,268,105
SULTANGAZI,50. YIL MAH.,415,374,365,280,85
SULTANGAZI,50. YIL MAH.,415,368,359,277,82
SULTANGAZI,50. YIL MAH.,415,374,373,295,78
SULTANGAZI,50. YIL MAH.,415,358,353,253,100
SULTANGAZI,50. YIL MAH.,412,357,354,288,66
SULTANGAZI,50. YIL MAH.,415,372,369,287,82
SULTANGAZI,50. YIL MAH.,411,376,371,302,69
SULTANGAZI,50. YIL MAH.,415,364,357,287,70
SULTANGAZI,50. YIL MAH.,414,373,368,305,63
SULTANGAZI,50. YIL MAH.,414,372,368,262,106
SULTANGAZI,50. YIL MAH.,411,361,356,287,69
SULTANGAZI,50. YIL MAH.,414,383,378,294,84
SULTANGAZI,50. YIL MAH.,414,381,356,263,93
SULTANGAZI,50. YIL MAH.,415,358,353,263,90
SULTANGAZI,50. YIL MAH.,412,365,357,273,84
SULTANGAZI,50. YIL MAH.,412,369,362,271,91
SULTANGAZI,50. YIL MAH.,412,360,355,256,99
SULTANGAZI,50. YIL MAH.,415,370,368,264,104
SULTANGAZI,50. YIL MAH.,415,377,369,243,126
SULTANGAZI,50. YIL MAH.,413,371,367,278,89
SULTANGAZI,50. YIL MAH.,414,373,370,279,91
SULTANGAZI,50. YIL MAH.,410,374,371,268,103
SULTANGAZI,50. YIL MAH.,410,362,354,273,81
SULTANGAZI,50. YIL MAH.,415,372,366,276,90
SULTANGAZI,50. YIL MAH.,412,377,373,282,91
SULTANGAZI,50. YIL MAH.,415,362,358,271,87
SULTANGAZI,50. YIL MAH.,415,371,364,276,88
SULTANGAZI,50. YIL MAH.,415,379,374,278,96
SULTANGAZI,50. YIL MAH.,415,366,356,256,100
SULTANGAZI,50. YIL MAH.,412,372,362,278,84
SULTANGAZI,50. YIL MAH.,415,378,354,240,114
SULTANGAZI,50. YIL MAH.,412,371,362,288,74
SULTANGAZI,50. YIL MAH.,411,368,356,270,86
SULTANGAZI,50. YIL MAH.,411,358,357,261,96
SULTANGAZI,50. YIL MAH.,412,372,372,286,86
SULTANGAZI,50. YIL MAH.,411,333,323,235,88
SULTANGAZI,50. YIL MAH.,411,371,363,278,85
SULTANGAZI,50. YIL MAH.,412,367,360,275,85
SULTANGAZI,50. YIL MAH.,410,367,363,284,79
SULTANGAZI,50. YIL MAH.,411,370,360,268,92
SULTANGAZI,50. YIL MAH.,411,354,350,265,85
SULTANGAZI,50. YIL MAH.,411,355,351,268,83
SULTANGAZI,50. YIL MAH.,410,363,358,269,89
SULTANGAZI,50. YIL MAH.,410,362,359,290,69
SULTANGAZI,50. YIL MAH.,411,373,368,277,91
SULTANGAZI,50. YIL MAH.,411,383,379,271,108
SULTANGAZI,50. YIL MAH.,411,363,359,280,79
SULTANGAZI,50. YIL MAH.,410,366,362,282,80
SULTANGAZI,50. YIL MAH.,411,362,357,271,86
SULTANGAZI,50. YIL MAH.,411,373,367,278,89
SULTANGAZI,50. YIL MAH.,399,327,322,228,94
SULTANGAZI,50. YIL MAH.,400,350,346,226,120
SULTANGAZI,50. YIL MAH.,399,362,361,287,74
SULTANGAZI,50. YIL MAH.,400,359,356,285,71
SULTANGAZI,50. YIL MAH.,401,375,372,295,77
SULTANGAZI,50. YIL MAH.,400,353,348,265,83
SULTANGAZI,50. YIL MAH.,399,367,362,288,74
SULTANGAZI,50. YIL MAH.,404,364,361,261,100
SULTANGAZI,50. YIL MAH.,402,366,364,264,100
SULTANGAZI,50. YIL MAH.,400,367,363,289,74
SULTANGAZI,50. YIL MAH.,400,352,348,269,79
SULTANGAZI,50. YIL MAH.,400,352,346,264,82
SULTANGAZI,50. YIL MAH.,402,373,372,284,88
SULTANGAZI,50. YIL MAH.,400,360,358,268,90
SULTANGAZI,50. YIL MAH.,399,368,362,273,89
SULTANGAZI,50. YIL MAH.,400,363,359,278,81
SULTANGAZI,50. YIL MAH.,400,366,362,257,105
SULTANGAZI,50. YIL MAH.,400,352,349,263,86
SULTANGAZI,50. YIL MAH.,406,332,330,267,63
SULTANGAZI,50. YIL MAH.,408,359,351,278,73
SULTANGAZI,50. YIL MAH.,407,368,362,266,96
SULTANGAZI,50. YIL MAH.,407,366,362,269,93
SULTANGAZI,50. YIL MAH.,406,377,372,267,105
SULTANGAZI,50. YIL MAH.,407,365,362,266,96
SULTANGAZI,50. YIL MAH.,409,360,355,252,103
SULTANGAZI,50. YIL MAH.,406,369,365,267,98
SULTANGAZI,50. YIL MAH.,405,370,363,300,63
SULTANGAZI,50. YIL MAH.,405,373,371,303,68
SULTANGAZI,50. YIL MAH.,406,357,355,269,86
SULTANGAZI,50. YIL MAH.,406,371,365,295,70
SULTANGAZI,50. YIL MAH.,406,370,365,284,81
SULTANGAZI,50. YIL MAH.,407,356,351,262,89
SULTANGAZI,50. YIL MAH.,406,349,344,260,84
SULTANGAZI,50. YIL MAH.,407,375,371,259,112
SULTANGAZI,50. YIL MAH.,402,344,337,272,65
SULTANGAZI,50. YIL MAH.,401,338,332,269,63
SULTANGAZI,50. YIL MAH.,400,361,356,279,77
SULTANGAZI,50. YIL MAH.,400,360,356,265,91
SULTANGAZI,50. YIL MAH.,400,367,364,269,95
SULTANGAZI,50. YIL MAH.,400,366,359,293,66
SULTANGAZI,50. YIL MAH.,401,362,358,275,83
SULTANGAZI,50. YIL MAH.,400,354,347,246,101
SULTANGAZI,50. YIL MAH.,400,355,345,278,67
SULTANGAZI,50. YIL MAH.,401,359,358,275,83
SULTANGAZI,50. YIL MAH.,400,368,367,319,48
SULTANGAZI,50. YIL MAH.,400,365,361,305,56
SULTANGAZI,50. YIL MAH.,400,355,351,294,57
SULTANGAZI,50. YIL MAH.,400,367,358,281,77
SULTANGAZI,50. YIL MAH.,402,377,376,311,65
SULTANGAZI,50. YIL MAH.,401,364,360,276,84
SULTANGAZI,50. YIL MAH.,402,358,351,291,60
SULTANGAZI,50. YIL MAH.,403,365,362,270,92
SULTANGAZI,50. YIL MAH.,399,363,354,274,80
SULTANGAZI,50. YIL MAH.,402,376,370,302,68
SULTANGAZI,50. YIL MAH.,400,340,339,253,86
SULTANGAZI,50. YIL MAH.,401,346,336,270,66
SULTANGAZI,50. YIL MAH.,401,368,357,290,67
SULTANGAZI,50. YIL MAH.,401,362,355,297,58
SULTANGAZI,75. YIL MAH.,404,345,333,144,189
SULTANGAZI,75. YIL MAH.,406,354,346,190,156
SULTANGAZI,75. YIL MAH.,403,367,367,187,180
SULTANGAZI,75. YIL MAH.,405,385,379,170,209
SULTANGAZI,75. YIL MAH.,403,378,375,189,186
SULTANGAZI,75. YIL MAH.,404,370,368,184,184
SULTANGAZI,75. YIL MAH.,403,371,367,180,187
SULTANGAZI,75. YIL MAH.,403,367,365,187,178
SULTANGAZI,75. YIL MAH.,404,369,364,160,204
SULTANGAZI,75. YIL MAH.,405,367,367,187,180
SULTANGAZI,75. YIL MAH.,403,367,355,178,177
SULTANGAZI,75. YIL MAH.,404,355,349,180,169
SULTANGAZI,75. YIL MAH.,403,361,356,193,163
SULTANGAZI,75. YIL MAH.,404,351,346,183,163
SULTANGAZI,75. YIL MAH.,403,357,355,158,197
SULTANGAZI,75. YIL MAH.,404,370,368,175,193
SULTANGAZI,75. YIL MAH.,404,361,357,173,184
SULTANGAZI,75. YIL MAH.,407,359,353,160,193
SULTANGAZI,75. YIL MAH.,406,361,359,151,208
SULTANGAZI,75. YIL MAH.,406,377,377,158,219
SULTANGAZI,75. YIL MAH.,408,360,358,151,207
SULTANGAZI,75. YIL MAH.,406,373,370,152,218
SULTANGAZI,75. YIL MAH.,406,380,379,169,210
SULTANGAZI,75. YIL MAH.,406,362,359,180,179
SULTANGAZI,75. YIL MAH.,406,380,375,171,204
SULTANGAZI,75. YIL MAH.,408,359,349,184,165
SULTANGAZI,75. YIL MAH.,407,358,353,170,183
SULTANGAZI,75. YIL MAH.,405,356,356,186,170
SULTANGAZI,75. YIL MAH.,406,372,371,179,192
SULTANGAZI,75. YIL MAH.,406,372,367,171,196
SULTANGAZI,75. YIL MAH.,406,373,365,148,217
SULTANGAZI,75. YIL MAH.,407,365,359,153,206
SULTANGAZI,75. YIL MAH.,406,355,354,141,213
SULTANGAZI,75. YIL MAH.,406,377,376,185,191
SULTANGAZI,75. YIL MAH.,406,365,358,174,184
SULTANGAZI,75. YIL MAH.,406,374,370,152,218
SULTANGAZI,75. YIL MAH.,406,371,367,151,216
SULTANGAZI,75. YIL MAH.,406,373,370,174,196
SULTANGAZI,75. YIL MAH.,406,375,372,181,191
SULTANGAZI,75. YIL MAH.,397,353,346,136,210
SULTANGAZI,75. YIL MAH.,400,353,349,149,200
SULTANGAZI,75. YIL MAH.,399,365,363,116,247
SULTANGAZI,75. YIL MAH.,397,356,353,161,192
SULTANGAZI,75. YIL MAH.,399,356,347,136,211
SULTANGAZI,75. YIL MAH.,398,364,358,162,196
SULTANGAZI,75. YIL MAH.,398,356,344,131,213
SULTANGAZI,75. YIL MAH.,398,354,352,141,211
SULTANGAZI,75. YIL MAH.,398,372,366,155,211
SULTANGAZI,75. YIL MAH.,398,368,365,160,205
SULTANGAZI,75. YIL MAH.,398,355,347,135,212
SULTANGAZI,75. YIL MAH.,398,351,347,159,188
SULTANGAZI,75. YIL MAH.,396,343,339,145,194
SULTANGAZI,75. YIL MAH.,397,345,341,121,220
SULTANGAZI,75. YIL MAH.,397,360,356,123,233
SULTANGAZI,CEBECI MAH.,408,341,333,214,119
SULTANGAZI,CEBECI MAH.,408,355,347,234,113
SULTANGAZI,CEBECI MAH.,408,362,349,230,119
SULTANGAZI,CEBECI MAH.,408,375,367,271,96
SULTANGAZI,CEBECI MAH.,408,356,355,260,95
SULTANGAZI,CEBECI MAH.,408,362,358,272,86
SULTANGAZI,CEBECI MAH.,409,357,351,262,89
SULTANGAZI,CEBECI MAH.,408,379,372,283,89
SULTANGAZI,CEBECI MAH.,408,373,369,267,102
SULTANGAZI,CEBECI MAH.,407,373,371,270,101
SULTANGAZI,CEBECI MAH.,408,350,348,268,80
SULTANGAZI,CEBECI MAH.,408,363,353,263,90
SULTANGAZI,CEBECI MAH.,408,357,351,248,103
SULTANGAZI,CEBECI MAH.,410,371,367,286,81
SULTANGAZI,CEBECI MAH.,409,361,350,259,91
SULTANGAZI,CEBECI MAH.,409,366,362,243,119
SULTANGAZI,CEBECI MAH.,408,358,350,263,87
SULTANGAZI,CEBECI MAH.,408,367,358,245,113
SULTANGAZI,CEBECI MAH.,408,368,363,265,98
SULTANGAZI,CEBECI MAH.,410,347,343,245,98
SULTANGAZI,CEBECI MAH.,410,370,369,269,100
SULTANGAZI,CEBECI MAH.,408,372,366,241,125
SULTANGAZI,CEBECI MAH.,407,360,356,241,115
SULTANGAZI,CEBECI MAH.,408,354,349,254,95
SULTANGAZI,CEBECI MAH.,394,331,327,243,84
SULTANGAZI,CEBECI MAH.,395,349,345,273,72
SULTANGAZI,CEBECI MAH.,392,356,352,281,71
SULTANGAZI,CEBECI MAH.,393,349,346,262,84
SULTANGAZI,CEBECI MAH.,393,343,336,250,86
SULTANGAZI,CEBECI MAH.,393,362,360,282,78
SULTANGAZI,CEBECI MAH.,393,363,361,279,82
SULTANGAZI,CEBECI MAH.,393,362,357,263,94
SULTANGAZI,CEBECI MAH.,393,356,353,288,65
SULTANGAZI,CEBECI MAH.,393,352,346,261,85
SULTANGAZI,CEBECI MAH.,393,346,344,271,73
SULTANGAZI,CEBECI MAH.,393,352,350,282,68
SULTANGAZI,CEBECI MAH.,393,352,346,271,75
SULTANGAZI,CEBECI MAH.,392,356,350,281,69
SULTANGAZI,CEBECI MAH.,393,351,343,288,55
SULTANGAZI,CEBECI MAH.,405,322,316,191,125
SULTANGAZI,CEBECI MAH.,405,355,351,207,144
SULTANGAZI,CEBECI MAH.,406,353,347,218,129
SULTANGAZI,CEBECI MAH.,415,369,361,243,118
SULTANGAZI,CEBECI MAH.,404,367,364,223,141
SULTANGAZI,CEBECI MAH.,405,372,367,243,124
SULTANGAZI,CEBECI MAH.,405,366,360,242,118
SULTANGAZI,CEBECI MAH.,405,351,347,235,112
SULTANGAZI,CEBECI MAH.,406,362,356,209,147
SULTANGAZI,CEBECI MAH.,406,368,365,249,116
SULTANGAZI,CEBECI MAH.,405,367,367,247,120
SULTANGAZI,CEBECI MAH.,405,366,361,232,129
SULTANGAZI,CEBECI MAH.,407,372,367,239,128
SULTANGAZI,CEBECI MAH.,404,357,351,235,116
SULTANGAZI,CEBECI MAH.,406,357,351,206,145
SULTANGAZI,CEBECI MAH.,405,377,371,239,132
SULTANGAZI,CEBECI MAH.,406,363,359,212,147
SULTANGAZI,CEBECI MAH.,403,362,354,206,148
SULTANGAZI,CEBECI MAH.,394,314,307,195,112
SULTANGAZI,CEBECI MAH.,395,355,330,222,108
SULTANGAZI,CEBECI MAH.,395,351,346,236,110
SULTANGAZI,CEBECI MAH.,394,360,355,238,117
SULTANGAZI,CEBECI MAH.,395,355,350,218,132
SULTANGAZI,CEBECI MAH.,396,351,349,225,124
SULTANGAZI,CEBECI MAH.,395,359,355,225,130
SULTANGAZI,CEBECI MAH.,397,356,350,216,134
SULTANGAZI,CEBECI MAH.,395,352,350,217,133
SULTANGAZI,CEBECI MAH.,396,354,352,208,144
SULTANGAZI,CEBECI MAH.,394,353,348,215,133
SULTANGAZI,CEBECI MAH.,394,347,346,239,107
SULTANGAZI,CEBECI MAH.,395,366,358,255,103
SULTANGAZI,CEBECI MAH.,395,351,346,231,115
SULTANGAZI,CEBECI MAH.,395,350,348,216,132
SULTANGAZI,CEBECI MAH.,395,362,361,230,131
SULTANGAZI,CEBECI MAH.,394,356,351,209,142
SULTANGAZI,CEBECI MAH.,395,363,359,219,140
SULTANGAZI,CEBECI MAH.,415,333,320,227,93
SULTANGAZI,CEBECI MAH.,410,337,329,222,107
SULTANGAZI,CEBECI MAH.,412,374,371,261,110
SULTANGAZI,CEBECI MAH.,415,362,355,269,86
SULTANGAZI,CEBECI MAH.,412,360,350,260,90
SULTANGAZI,CEBECI MAH.,412,366,361,277,84
SULTANGAZI,CEBECI MAH.,411,367,364,275,89
SULTANGAZI,CEBECI MAH.,411,375,362,248,114
SULTANGAZI,CEBECI MAH.,411,368,362,261,101
SULTANGAZI,CEBECI MAH.,411,350,343,255,88
SULTANGAZI,CEBECI MAH.,412,379,372,283,89
SULTANGAZI,CEBECI MAH.,410,371,366,253,113
SULTANGAZI,CEBECI MAH.,410,365,362,264,98
SULTANGAZI,CEBECI MAH.,410,367,360,263,97
SULTANGAZI,CEBECI MAH.,411,373,361,285,76
SULTANGAZI,CEBECI MAH.,415,382,375,253,122
SULTANGAZI,CEBECI MAH.,410,362,354,234,120
SULTANGAZI,CEBECI MAH.,410,360,355,248,107
SULTANGAZI,CEBECI MAH.,410,373,367,278,89
SULTANGAZI,CEBECI MAH.,410,367,365,265,100
SULTANGAZI,CEBECI MAH.,410,364,361,252,109
SULTANGAZI,CEBECI MAH.,410,371,362,272,90
SULTANGAZI,CEBECI MAH.,411,366,360,245,115
SULTANGAZI,CEBECI MAH.,411,357,351,260,91
SULTANGAZI,CEBECI MAH.,410,358,354,257,97
SULTANGAZI,CUMHURIYET MAH.,410,339,331,175,156
SULTANGAZI,CUMHURIYET MAH.,409,376,369,233,136
SULTANGAZI,CUMHURIYET MAH.,411,355,349,225,124
SULTANGAZI,CUMHURIYET MAH.,409,360,359,224,135
SULTANGAZI,CUMHURIYET MAH.,408,367,363,215,148
SULTANGAZI,CUMHURIYET MAH.,409,379,374,236,138
SULTANGAZI,CUMHURIYET MAH.,409,374,371,248,123
SULTANGAZI,CUMHURIYET MAH.,409,369,363,226,137
SULTANGAZI,CUMHURIYET MAH.,410,351,344,214,130
SULTANGAZI,CUMHURIYET MAH.,409,378,370,224,146
SULTANGAZI,CUMHURIYET MAH.,410,370,366,231,135
SULTANGAZI,CUMHURIYET MAH.,409,368,362,231,131
SULTANGAZI,CUMHURIYET MAH.,408,364,358,234,124
SULTANGAZI,CUMHURIYET MAH.,408,371,370,218,152
SULTANGAZI,CUMHURIYET MAH.,410,367,363,256,107
SULTANGAZI,CUMHURIYET MAH.,409,365,362,242,120
SULTANGAZI,CUMHURIYET MAH.,395,345,337,182,155
SULTANGAZI,CUMHURIYET MAH.,394,366,358,211,147
SULTANGAZI,CUMHURIYET MAH.,395,359,355,221,134
SULTANGAZI,CUMHURIYET MAH.,395,356,355,231,124
SULTANGAZI,CUMHURIYET MAH.,396,363,356,211,145
SULTANGAZI,CUMHURIYET MAH.,395,361,349,197,152
SULTANGAZI,CUMHURIYET MAH.,394,349,347,197,150
SULTANGAZI,CUMHURIYET MAH.,394,365,363,208,155
SULTANGAZI,ESKI HABIPLER MAH.,405,341,335,234,101
SULTANGAZI,ESKI HABIPLER MAH.,405,369,364,292,72
SULTANGAZI,ESKI HABIPLER MAH.,409,363,359,298,61
SULTANGAZI,ESKI HABIPLER MAH.,404,372,363,277,86
SULTANGAZI,ESKI HABIPLER MAH.,406,367,361,281,80
SULTANGAZI,ESKI HABIPLER MAH.,406,371,365,293,72
SULTANGAZI,ESKI HABIPLER MAH.,405,376,370,315,55
SULTANGAZI,ESKI HABIPLER MAH.,406,373,369,291,78
SULTANGAZI,ESKI HABIPLER MAH.,406,372,372,280,92
SULTANGAZI,ESKI HABIPLER MAH.,405,369,367,299,68
SULTANGAZI,HABIBLER MAH.,403,341,336,243,93
SULTANGAZI,HABIBLER MAH.,402,352,344,236,108
SULTANGAZI,HABIBLER MAH.,400,352,345,255,90
SULTANGAZI,HABIBLER MAH.,400,352,347,248,99
SULTANGAZI,HABIBLER MAH.,400,351,344,239,105
SULTANGAZI,HABIBLER MAH.,400,366,360,272,88
SULTANGAZI,HABIBLER MAH.,401,355,348,255,93
SULTANGAZI,HABIBLER MAH.,401,356,349,257,92
SULTANGAZI,HABIBLER MAH.,400,358,351,262,89
SULTANGAZI,HABIBLER MAH.,399,360,357,267,90
SULTANGAZI,HABIBLER MAH.,400,352,337,237,100
SULTANGAZI,HABIBLER MAH.,403,346,340,245,95
SULTANGAZI,ISMETPASA MAH.,412,352,345,265,80
SULTANGAZI,ISMETPASA MAH.,415,338,327,245,82
SULTANGAZI,ISMETPASA MAH.,415,352,347,249,98
SULTANGAZI,ISMETPASA MAH.,415,363,352,274,78
SULTANGAZI,ISMETPASA MAH.,415,371,370,286,84
SULTANGAZI,ISMETPASA MAH.,415,376,374,294,80
SULTANGAZI,ISMETPASA MAH.,412,373,367,287,80
SULTANGAZI,ISMETPASA MAH.,415,361,348,257,91
SULTANGAZI,ISMETPASA MAH.,412,372,366,290,76
SULTANGAZI,ISMETPASA MAH.,415,351,343,259,84
SULTANGAZI,ISMETPASA MAH.,409,358,347,277,70
SULTANGAZI,ISMETPASA MAH.,415,369,362,295,67
SULTANGAZI,ISMETPASA MAH.,413,368,363,292,71
SULTANGAZI,ISMETPASA MAH.,413,362,360,291,69
SULTANGAZI,ISMETPASA MAH.,413,366,360,276,84
SULTANGAZI,ISMETPASA MAH.,413,351,346,244,102
SULTANGAZI,ISMETPASA MAH.,412,363,356,272,84
SULTANGAZI,ISMETPASA MAH.,415,362,357,299,58
SULTANGAZI,ISMETPASA MAH.,408,371,365,285,80
SULTANGAZI,ISMETPASA MAH.,412,371,368,264,104
SULTANGAZI,ISMETPASA MAH.,411,346,336,265,71
SULTANGAZI,ISMETPASA MAH.,413,351,345,273,72
SULTANGAZI,ISMETPASA MAH.,411,371,360,288,72
SULTANGAZI,ISMETPASA MAH.,415,361,355,268,87
SULTANGAZI,ISMETPASA MAH.,412,355,354,266,88
SULTANGAZI,ISMETPASA MAH.,412,364,357,278,79
SULTANGAZI,ISMETPASA MAH.,412,370,366,275,91
SULTANGAZI,ISMETPASA MAH.,409,349,340,275,65
SULTANGAZI,ISMETPASA MAH.,411,368,359,282,77
SULTANGAZI,ISMETPASA MAH.,401,338,333,286,47
SULTANGAZI,ISMETPASA MAH.,399,367,358,273,85
SULTANGAZI,ISMETPASA MAH.,405,366,361,292,69
SULTANGAZI,ISMETPASA MAH.,400,351,348,263,85
SULTANGAZI,ISMETPASA MAH.,399,358,352,263,89
SULTANGAZI,ISMETPASA MAH.,400,350,345,253,92
SULTANGAZI,ISMETPASA MAH.,399,357,354,279,75
SULTANGAZI,ISMETPASA MAH.,402,357,354,243,111
SULTANGAZI,ISMETPASA MAH.,400,346,340,235,105
SULTANGAZI,ISMETPASA MAH.,399,353,350,290,60
SULTANGAZI,ISMETPASA MAH.,401,364,360,291,69
SULTANGAZI,ISMETPASA MAH.,399,354,348,266,82
SULTANGAZI,ISMETPASA MAH.,400,351,349,265,84
SULTANGAZI,ISMETPASA MAH.,400,366,352,268,84
SULTANGAZI,ISMETPASA MAH.,399,351,344,269,75
SULTANGAZI,ISMETPASA MAH.,400,364,353,257,96
SULTANGAZI,ISMETPASA MAH.,399,359,352,255,97
SULTANGAZI,ISMETPASA MAH.,403,353,345,284,61
SULTANGAZI,ISMETPASA MAH.,402,346,344,280,64
SULTANGAZI,ISMETPASA MAH.,402,371,368,294,74
SULTANGAZI,ISMETPASA MAH.,402,341,336,244,92
SULTANGAZI,ISMETPASA MAH.,404,373,372,266,106
SULTANGAZI,ISMETPASA MAH.,402,355,348,262,86
SULTANGAZI,ISMETPASA MAH.,402,343,336,260,76
SULTANGAZI,ISMETPASA MAH.,402,366,360,270,90
SULTANGAZI,ISMETPASA MAH.,403,345,335,253,82
SULTANGAZI,ISMETPASA MAH.,402,373,367,274,93
SULTANGAZI,ISMETPASA MAH.,402,377,374,281,93
SULTANGAZI,ISMETPASA MAH.,402,373,370,279,91
SULTANGAZI,ISMETPASA MAH.,403,373,367,292,75
SULTANGAZI,ISMETPASA MAH.,402,354,351,283,68
SULTANGAZI,ISMETPASA MAH.,402,362,353,260,93
SULTANGAZI,ISMETPASA MAH.,401,364,357,276,81
SULTANGAZI,ISMETPASA MAH.,401,369,367,261,106
SULTANGAZI,ISMETPASA MAH.,403,362,355,301,54
SULTANGAZI,ISMETPASA MAH.,401,353,350,253,97
SULTANGAZI,ISMETPASA MAH.,401,367,364,289,75
SULTANGAZI,ISMETPASA MAH.,403,356,352,288,64
SULTANGAZI,ISMETPASA MAH.,402,361,357,271,86
SULTANGAZI,ISMETPASA MAH.,402,370,364,270,94
SULTANGAZI,ISMETPASA MAH.,415,317,306,236,70
SULTANGAZI,ISMETPASA MAH.,415,361,359,288,71
SULTANGAZI,ISMETPASA MAH.,415,360,354,262,92
SULTANGAZI,ISMETPASA MAH.,415,385,381,283,98
SULTANGAZI,ISMETPASA MAH.,414,370,367,268,99
SULTANGAZI,ISMETPASA MAH.,413,348,342,239,103
SULTANGAZI,ISMETPASA MAH.,414,365,359,262,97
SULTANGAZI,ISMETPASA MAH.,414,356,348,267,81
SULTANGAZI,ISMETPASA MAH.,413,359,354,279,75
SULTANGAZI,ISMETPASA MAH.,413,364,358,259,99
SULTANGAZI,ISMETPASA MAH.,414,353,350,262,88
SULTANGAZI,ISMETPASA MAH.,414,355,349,253,96
SULTANGAZI,ISMETPASA MAH.,414,361,358,242,116
SULTANGAZI,ISMETPASA MAH.,413,360,354,276,78
SULTANGAZI,ISMETPASA MAH.,415,354,351,242,109
SULTANGAZI,ISMETPASA MAH.,414,366,361,265,96
SULTANGAZI,ISMETPASA MAH.,410,346,344,240,104
SULTANGAZI,ISMETPASA MAH.,412,374,371,291,80
SULTANGAZI,MALKOCOGLU MAH.,415,374,368,317,51
SULTANGAZI,MALKOCOGLU MAH.,411,372,365,308,57
SULTANGAZI,MALKOCOGLU MAH.,411,367,359,309,50
SULTANGAZI,MALKOCOGLU MAH.,411,370,367,297,70
SULTANGAZI,MALKOCOGLU MAH.,415,378,376,307,69
SULTANGAZI,MALKOCOGLU MAH.,410,381,380,323,57
SULTANGAZI,MALKOCOGLU MAH.,411,360,357,287,70
SULTANGAZI,MALKOCOGLU MAH.,409,378,374,315,59
SULTANGAZI,MALKOCOGLU MAH.,411,364,359,301,58
SULTANGAZI,MALKOCOGLU MAH.,411,379,374,313,61
SULTANGAZI,MALKOCOGLU MAH.,411,384,381,330,51
SULTANGAZI,MALKOCOGLU MAH.,411,374,367,305,62
SULTANGAZI,MALKOCOGLU MAH.,409,364,355,285,70
SULTANGAZI,MALKOCOGLU MAH.,410,366,362,296,66
SULTANGAZI,MALKOCOGLU MAH.,411,382,376,315,61
SULTANGAZI,MALKOCOGLU MAH.,410,363,353,278,75
SULTANGAZI,MALKOCOGLU MAH.,408,362,357,315,42
SULTANGAZI,MALKOCOGLU MAH.,411,378,369,290,79
SULTANGAZI,MALKOCOGLU MAH.,411,364,363,299,64
SULTANGAZI,MALKOCOGLU MAH.,409,378,372,328,44
SULTANGAZI,MALKOCOGLU MAH.,408,381,378,315,63
SULTANGAZI,SULTANCIFTLIGI MAH.,398,336,333,265,68
SULTANGAZI,SULTANCIFTLIGI MAH.,399,357,354,275,79
SULTANGAZI,SULTANCIFTLIGI MAH.,399,360,353,229,124
SULTANGAZI,SULTANCIFTLIGI MAH.,402,350,345,250,95
SULTANGAZI,SULTANCIFTLIGI MAH.,399,369,365,287,78
SULTANGAZI,SULTANCIFTLIGI MAH.,402,374,371,286,85
SULTANGAZI,SULTANCIFTLIGI MAH.,399,369,365,282,83
SULTANGAZI,SULTANCIFTLIGI MAH.,400,353,348,252,96
SULTANGAZI,SULTANCIFTLIGI MAH.,399,356,352,275,77
SULTANGAZI,SULTANCIFTLIGI MAH.,399,364,361,263,98
SULTANGAZI,SULTANCIFTLIGI MAH.,400,357,353,224,129
SULTANGAZI,SULTANCIFTLIGI MAH.,399,349,344,244,100
SULTANGAZI,SULTANCIFTLIGI MAH.,398,355,352,267,85
SULTANGAZI,SULTANCIFTLIGI MAH.,398,370,365,262,103
SULTANGAZI,SULTANCIFTLIGI MAH.,399,367,365,263,102
SULTANGAZI,SULTANCIFTLIGI MAH.,398,359,356,234,122
SULTANGAZI,SULTANCIFTLIGI MAH.,399,364,361,300,61
SULTANGAZI,SULTANCIFTLIGI MAH.,398,356,347,264,83
SULTANGAZI,SULTANCIFTLIGI MAH.,398,355,350,289,61
SULTANGAZI,SULTANCIFTLIGI MAH.,411,340,329,230,99
SULTANGAZI,SULTANCIFTLIGI MAH.,411,334,328,239,89
SULTANGAZI,SULTANCIFTLIGI MAH.,412,376,374,264,110
SULTANGAZI,SULTANCIFTLIGI MAH.,411,361,357,267,90
SULTANGAZI,SULTANCIFTLIGI MAH.,411,360,354,245,109
SULTANGAZI,SULTANCIFTLIGI MAH.,411,374,368,270,98
SULTANGAZI,SULTANCIFTLIGI MAH.,411,374,370,276,94
SULTANGAZI,SULTANCIFTLIGI MAH.,411,383,380,289,91
SULTANGAZI,SULTANCIFTLIGI MAH.,411,373,363,283,80
SULTANGAZI,SULTANCIFTLIGI MAH.,411,369,365,275,90
SULTANGAZI,SULTANCIFTLIGI MAH.,410,364,362,249,113
SULTANGAZI,SULTANCIFTLIGI MAH.,415,361,360,268,92
SULTANGAZI,SULTANCIFTLIGI MAH.,411,377,371,273,98
SULTANGAZI,SULTANCIFTLIGI MAH.,411,356,352,252,100
SULTANGAZI,SULTANCIFTLIGI MAH.,411,369,364,266,98
SULTANGAZI,SULTANCIFTLIGI MAH.,411,372,368,269,99
SULTANGAZI,SULTANCIFTLIGI MAH.,410,376,374,278,96
SULTANGAZI,SULTANCIFTLIGI MAH.,415,366,360,243,117
SULTANGAZI,SULTANCIFTLIGI MAH.,410,364,360,240,120
SULTANGAZI,SULTANCIFTLIGI MAH.,411,374,367,271,96
SULTANGAZI,SULTANCIFTLIGI MAH.,411,363,359,270,89
SULTANGAZI,SULTANCIFTLIGI MAH.,411,369,363,261,102
SULTANGAZI,SULTANCIFTLIGI MAH.,412,364,356,261,95
SULTANGAZI,SULTANCIFTLIGI MAH.,405,346,343,258,85
SULTANGAZI,SULTANCIFTLIGI MAH.,405,324,319,209,110
SULTANGAZI,SULTANCIFTLIGI MAH.,405,350,347,274,73
SULTANGAZI,SULTANCIFTLIGI MAH.,405,358,353,264,89
SULTANGAZI,SULTANCIFTLIGI MAH.,404,371,360,243,117
SULTANGAZI,SULTANCIFTLIGI MAH.,404,372,366,267,99
SULTANGAZI,SULTANCIFTLIGI MAH.,405,362,362,275,87
SULTANGAZI,SULTANCIFTLIGI MAH.,404,357,351,280,71
SULTANGAZI,SULTANCIFTLIGI MAH.,404,364,361,259,102
SULTANGAZI,SULTANCIFTLIGI MAH.,406,352,349,255,94
SULTANGAZI,SULTANCIFTLIGI MAH.,405,358,356,255,101
SULTANGAZI,SULTANCIFTLIGI MAH.,404,342,341,257,84
SULTANGAZI,SULTANCIFTLIGI MAH.,404,362,358,263,95
SULTANGAZI,SULTANCIFTLIGI MAH.,404,367,362,263,99
SULTANGAZI,SULTANCIFTLIGI MAH.,405,349,344,239,105
SULTANGAZI,SULTANCIFTLIGI MAH.,404,370,364,288,76
SULTANGAZI,SULTANCIFTLIGI MAH.,404,345,339,233,106
SULTANGAZI,SULTANCIFTLIGI MAH.,405,360,355,269,86
SULTANGAZI,SULTANCIFTLIGI MAH.,405,354,349,263,86
SULTANGAZI,SULTANCIFTLIGI MAH.,405,365,362,265,97
SULTANGAZI,SULTANCIFTLIGI MAH.,404,380,379,277,102
SULTANGAZI,SULTANCIFTLIGI MAH.,405,355,346,247,99
SULTANGAZI,UGUR MUMCU MAH.,410,333,328,192,136
SULTANGAZI,UGUR MUMCU MAH.,410,353,351,237,114
SULTANGAZI,UGUR MUMCU MAH.,409,374,373,244,129
SULTANGAZI,UGUR MUMCU MAH.,409,359,354,205,149
SULTANGAZI,UGUR MUMCU MAH.,410,373,372,220,152
SULTANGAZI,UGUR MUMCU MAH.,410,374,372,242,130
SULTANGAZI,UGUR MUMCU MAH.,410,364,360,232,128
SULTANGAZI,UGUR MUMCU MAH.,410,377,373,240,133
SULTANGAZI,UGUR MUMCU MAH.,409,378,375,254,121
SULTANGAZI,UGUR MUMCU MAH.,409,362,359,204,155
SULTANGAZI,UGUR MUMCU MAH.,409,371,371,253,118
SULTANGAZI,UGUR MUMCU MAH.,409,360,352,241,111
SULTANGAZI,UGUR MUMCU MAH.,409,361,356,214,142
SULTANGAZI,UGUR MUMCU MAH.,409,366,365,212,153
SULTANGAZI,UGUR MUMCU MAH.,409,359,354,229,125
SULTANGAZI,UGUR MUMCU MAH.,409,369,367,225,142
SULTANGAZI,UGUR MUMCU MAH.,409,372,366,233,133
SULTANGAZI,UGUR MUMCU MAH.,409,380,373,228,145
SULTANGAZI,UGUR MUMCU MAH.,408,357,357,232,125
SULTANGAZI,UGUR MUMCU MAH.,402,335,331,149,182
SULTANGAZI,UGUR MUMCU MAH.,401,361,356,206,150
SULTANGAZI,UGUR MUMCU MAH.,400,366,362,214,148
SULTANGAZI,UGUR MUMCU MAH.,401,359,356,187,169
SULTANGAZI,UGUR MUMCU MAH.,401,371,364,218,146
SULTANGAZI,UGUR MUMCU MAH.,399,353,347,210,137
SULTANGAZI,UGUR MUMCU MAH.,399,374,371,216,155
SULTANGAZI,UGUR MUMCU MAH.,399,346,343,180,163
SULTANGAZI,UGUR MUMCU MAH.,401,369,363,220,143
SULTANGAZI,UGUR MUMCU MAH.,415,329,321,194,127
SULTANGAZI,UGUR MUMCU MAH.,418,349,344,243,101
SULTANGAZI,UGUR MUMCU MAH.,417,374,370,260,110
SULTANGAZI,UGUR MUMCU MAH.,415,381,379,260,119
SULTANGAZI,UGUR MUMCU MAH.,417,364,363,266,97
SULTANGAZI,UGUR MUMCU MAH.,414,372,367,235,132
SULTANGAZI,UGUR MUMCU MAH.,415,366,362,231,131
SULTANGAZI,UGUR MUMCU MAH.,415,374,372,256,116
SULTANGAZI,UGUR MUMCU MAH.,414,383,379,253,126
SULTANGAZI,UGUR MUMCU MAH.,416,386,381,275,106
SULTANGAZI,UGUR MUMCU MAH.,415,375,369,233,136
SULTANGAZI,UGUR MUMCU MAH.,415,374,368,261,107
SULTANGAZI,UGUR MUMCU MAH.,414,365,359,250,109
SULTANGAZI,UGUR MUMCU MAH.,417,384,382,269,113
SULTANGAZI,UGUR MUMCU MAH.,414,372,369,255,114
SULTANGAZI,UGUR MUMCU MAH.,414,378,369,251,118
SULTANGAZI,UGUR MUMCU MAH.,415,379,374,241,133
SULTANGAZI,UGUR MUMCU MAH.,414,368,366,236,130
SULTANGAZI,UGUR MUMCU MAH.,415,387,387,248,139
SULTANGAZI,UGUR MUMCU MAH.,415,373,368,249,119
SULTANGAZI,UGUR MUMCU MAH.,400,349,342,252,90
SULTANGAZI,UGUR MUMCU MAH.,400,364,360,261,99
SULTANGAZI,UGUR MUMCU MAH.,400,351,340,258,82
SULTANGAZI,UGUR MUMCU MAH.,400,368,364,279,85
SULTANGAZI,UGUR MUMCU MAH.,402,348,346,265,81
SULTANGAZI,UGUR MUMCU MAH.,400,373,366,263,103
SULTANGAZI,UGUR MUMCU MAH.,401,372,368,257,111
SULTANGAZI,UGUR MUMCU MAH.,401,370,368,274,94
SULTANGAZI,UGUR MUMCU MAH.,401,362,359,270,89
SULTANGAZI,UGUR MUMCU MAH.,401,367,366,272,94
SULTANGAZI,UGUR MUMCU MAH.,401,371,363,264,99
SULTANGAZI,UGUR MUMCU MAH.,400,370,363,290,73
SULTANGAZI,UGUR MUMCU MAH.,400,350,345,250,95
SULTANGAZI,UGUR MUMCU MAH.,401,362,357,268,89
SULTANGAZI,UGUR MUMCU MAH.,400,348,344,260,84
SULTANGAZI,UGUR MUMCU MAH.,400,363,358,277,81
SULTANGAZI,UGUR MUMCU MAH.,400,378,374,280,94
SULTANGAZI,UGUR MUMCU MAH.,400,347,341,265,76
SULTANGAZI,UGUR MUMCU MAH.,400,354,351,270,81
SULTANGAZI,UGUR MUMCU MAH.,401,360,353,259,94
SULTANGAZI,UGUR MUMCU MAH.,401,365,360,275,85
SULTANGAZI,UGUR MUMCU MAH.,401,374,372,293,79
SULTANGAZI,YAYLA MAH.,390,332,324,261,63
SULTANGAZI,YAYLA MAH.,390,366,362,283,79
SULTANGAZI,YAYLA MAH.,390,353,346,267,79
SULTANGAZI,YAYLA MAH.,390,352,350,266,84
SULTANGAZI,YAYLA MAH.,390,354,349,281,68
SULTANGAZI,YAYLA MAH.,392,365,351,282,69
SULTANGAZI,YAYLA MAH.,390,352,350,275,75
SULTANGAZI,YAYLA MAH.,390,357,355,286,69
SULTANGAZI,YAYLA MAH.,389,365,356,301,55
SULTANGAZI,YAYLA MAH.,390,360,353,280,73
SULTANGAZI,YAYLA MAH.,389,354,349,284,65
SULTANGAZI,YAYLA MAH.,388,359,358,277,81
SULTANGAZI,YAYLA MAH.,389,349,344,278,66
SULTANGAZI,YAYLA MAH.,390,344,334,267,67
ESENLER,CIFTE HAVUZLAR MAH.,370,322,317,156,161
ESENLER,CIFTE HAVUZLAR MAH.,373,338,336,181,155
ESENLER,CIFTE HAVUZLAR MAH.,372,318,313,152,161
ESENLER,CIFTE HAVUZLAR MAH.,372,331,328,167,161
ESENLER,CIFTE HAVUZLAR MAH.,376,356,352,183,169
ESENLER,DAVUTPASA MAH.,402,350,344,206,138
ESENLER,DAVUTPASA MAH.,401,337,330,210,120
ESENLER,DAVUTPASA MAH.,402,341,337,181,156
ESENLER,DAVUTPASA MAH.,400,357,351,235,116
ESENLER,DAVUTPASA MAH.,400,361,353,218,135
ESENLER,DAVUTPASA MAH.,400,356,351,209,142
ESENLER,DAVUTPASA MAH.,400,351,349,204,145
ESENLER,DAVUTPASA MAH.,400,351,347,198,149
ESENLER,DAVUTPASA MAH.,399,353,346,203,143
ESENLER,DAVUTPASA MAH.,399,371,367,203,164
ESENLER,DAVUTPASA MAH.,400,357,353,226,127
ESENLER,DAVUTPASA MAH.,399,355,345,173,172
ESENLER,DAVUTPASA MAH.,400,343,343,207,136
ESENLER,DAVUTPASA MAH.,399,350,348,195,153
ESENLER,DAVUTPASA MAH.,400,372,372,203,169
ESENLER,DAVUTPASA MAH.,399,356,350,197,153
ESENLER,DAVUTPASA MAH.,400,372,358,203,155
ESENLER,DAVUTPASA MAH.,399,347,347,201,146
ESENLER,DAVUTPASA MAH.,399,361,351,171,180
ESENLER,DAVUTPASA MAH.,397,328,323,189,134
ESENLER,DAVUTPASA MAH.,397,355,344,207,137
ESENLER,DAVUTPASA MAH.,397,351,342,207,135
ESENLER,DAVUTPASA MAH.,397,365,363,230,133
ESENLER,DAVUTPASA MAH.,399,356,354,198,156
ESENLER,DAVUTPASA MAH.,397,350,347,221,126
ESENLER,DAVUTPASA MAH.,397,355,350,211,139
ESENLER,DAVUTPASA MAH.,396,345,345,209,136
ESENLER,DAVUTPASA MAH.,397,343,338,206,132
ESENLER,DAVUTPASA MAH.,397,343,337,204,133
ESENLER,DAVUTPASA MAH.,396,339,335,188,147
ESENLER,FATIH MAH.,399,318,309,211,98
ESENLER,FATIH MAH.,398,336,327,259,68
ESENLER,FATIH MAH.,399,359,357,247,110
ESENLER,FATIH MAH.,405,344,336,242,94
ESENLER,FATIH MAH.,399,348,341,234,107
ESENLER,FATIH MAH.,399,341,332,254,78
ESENLER,FATIH MAH.,399,366,360,261,99
ESENLER,FATIH MAH.,398,364,362,269,93
ESENLER,FATIH MAH.,397,360,353,245,108
ESENLER,FATIH MAH.,398,348,342,264,78
ESENLER,FATIH MAH.,399,367,365,250,115
ESENLER,FATIH MAH.,397,361,358,262,96
ESENLER,FATIH MAH.,398,346,337,258,79
ESENLER,FATIH MAH.,399,361,353,288,65
ESENLER,FATIH MAH.,399,373,371,269,102
ESENLER,FATIH MAH.,399,352,350,251,99
ESENLER,FATIH MAH.,398,352,347,254,93
ESENLER,FATIH MAH.,399,351,344,265,79
ESENLER,FATIH MAH.,398,348,345,246,99
ESENLER,FATIH MAH.,398,359,356,253,103
ESENLER,FATIH MAH.,398,352,345,244,101
ESENLER,FATIH MAH.,399,361,358,277,81
ESENLER,FATIH MAH.,398,357,350,253,97
ESENLER,FATIH MAH.,411,350,341,267,74
ESENLER,FATIH MAH.,415,359,355,248,107
ESENLER,FATIH MAH.,415,372,366,269,97
ESENLER,FATIH MAH.,415,373,369,271,98
ESENLER,FATIH MAH.,410,371,365,270,95
ESENLER,FATIH MAH.,414,355,347,218,129
ESENLER,FATIH MAH.,411,346,343,256,87
ESENLER,FATIH MAH.,411,358,355,262,93
ESENLER,FATIH MAH.,415,357,354,267,87
ESENLER,FATIH MAH.,410,365,363,258,105
ESENLER,FATIH MAH.,410,343,342,274,68
ESENLER,FATIH MAH.,410,379,376,272,104
ESENLER,FATIH MAH.,411,374,368,263,105
ESENLER,FATIH MAH.,410,367,360,245,115
ESENLER,FATIH MAH.,411,355,348,246,102
ESENLER,FATIH MAH.,410,365,364,228,136
ESENLER,FATIH MAH.,411,359,350,269,81
ESENLER,FATIH MAH.,411,376,375,271,104
ESENLER,FATIH MAH.,410,371,367,261,106
ESENLER,FATIH MAH.,410,363,356,271,85
ESENLER,FATIH MAH.,410,372,367,255,112
ESENLER,FATIH MAH.,411,378,375,258,117
ESENLER,FATIH MAH.,410,370,363,254,109
ESENLER,FATIH MAH.,411,363,361,244,117
ESENLER,FATIH MAH.,403,332,325,282,43
ESENLER,FATIH MAH.,402,316,303,226,77
ESENLER,FATIH MAH.,405,348,340,259,81
ESENLER,FATIH MAH.,404,353,347,247,100
ESENLER,FATIH MAH.,402,361,354,228,126
ESENLER,FATIH MAH.,402,351,348,259,89
ESENLER,FATIH MAH.,402,339,334,249,85
ESENLER,FATIH MAH.,402,365,359,265,94
ESENLER,FATIH MAH.,402,369,362,259,103
ESENLER,FATIH MAH.,402,352,345,265,80
ESENLER,FATIH MAH.,402,356,352,255,97
ESENLER,FATIH MAH.,401,356,351,249,102
ESENLER,FATIH MAH.,401,348,345,270,75
ESENLER,FATIH MAH.,401,346,343,242,101
ESENLER,FATIH MAH.,401,353,344,241,103
ESENLER,FATIH MAH.,402,349,347,254,93
ESENLER,FATIH MAH.,401,361,353,243,110
ESENLER,FATIH MAH.,404,368,362,290,72
ESENLER,FATIH MAH.,402,367,363,282,81
ESENLER,FATIH MAH.,401,361,358,266,92
ESENLER,FATIH MAH.,403,368,366,282,84
ESENLER,FATIH MAH.,402,361,352,264,88
ESENLER,FATIH MAH.,401,361,350,252,98
ESENLER,FATIH MAH.,402,364,357,254,103
ESENLER,FATIH MAH.,401,349,347,256,91
ESENLER,FATIH MAH.,401,362,357,269,88
ESENLER,FATIH MAH.,402,358,352,260,92
ESENLER,FATIH MAH.,402,359,353,261,92
ESENLER,FATIH MAH.,401,336,334,240,94
ESENLER,FATIH MAH.,402,365,355,269,86
ESENLER,FATIH MAH.,401,348,344,259,85
ESENLER,FEVZI CAKMAK MAH.,404,342,336,216,120
ESENLER,FEVZI CAKMAK MAH.,404,337,325,214,111
ESENLER,FEVZI CAKMAK MAH.,405,366,361,222,139
ESENLER,FEVZI CAKMAK MAH.,407,356,352,195,157
ESENLER,FEVZI CAKMAK MAH.,403,363,361,201,160
ESENLER,FEVZI CAKMAK MAH.,404,371,368,216,152
ESENLER,FEVZI CAKMAK MAH.,405,359,354,235,119
ESENLER,FEVZI CAKMAK MAH.,405,344,339,210,129
ESENLER,FEVZI CAKMAK MAH.,404,359,351,214,137
ESENLER,FEVZI CAKMAK MAH.,404,361,349,212,137
ESENLER,FEVZI CAKMAK MAH.,405,354,348,221,127
ESENLER,FEVZI CAKMAK MAH.,404,367,364,232,132
ESENLER,FEVZI CAKMAK MAH.,406,352,347,203,144
ESENLER,FEVZI CAKMAK MAH.,407,372,369,214,155
ESENLER,FEVZI CAKMAK MAH.,404,357,354,246,108
ESENLER,FEVZI CAKMAK MAH.,403,353,347,228,119
ESENLER,FEVZI CAKMAK MAH.,403,361,359,219,140
ESENLER,FEVZI CAKMAK MAH.,403,355,349,208,141
ESENLER,FEVZI CAKMAK MAH.,404,370,365,240,125
ESENLER,FEVZI CAKMAK MAH.,405,358,354,222,132
ESENLER,FEVZI CAKMAK MAH.,403,368,367,259,108
ESENLER,FEVZI CAKMAK MAH.,404,337,333,215,118
ESENLER,FEVZI CAKMAK MAH.,404,360,355,226,129
ESENLER,FEVZI CAKMAK MAH.,403,372,362,219,143
ESENLER,FEVZI CAKMAK MAH.,398,323,311,192,119
ESENLER,FEVZI CAKMAK MAH.,396,353,351,233,118
ESENLER,FEVZI CAKMAK MAH.,397,359,354,216,138
ESENLER,FEVZI CAKMAK MAH.,398,354,353,228,125
ESENLER,FEVZI CAKMAK MAH.,398,362,355,238,117
ESENLER,FEVZI CAKMAK MAH.,397,366,361,236,125
ESENLER,FEVZI CAKMAK MAH.,397,374,368,234,134
ESENLER,FEVZI CAKMAK MAH.,397,359,354,224,130
ESENLER,FEVZI CAKMAK MAH.,396,362,359,225,134
ESENLER,FEVZI CAKMAK MAH.,397,362,354,229,125
ESENLER,FEVZI CAKMAK MAH.,397,362,358,258,100
ESENLER,FEVZI CAKMAK MAH.,399,354,351,238,113
ESENLER,FEVZI CAKMAK MAH.,397,363,356,250,106
ESENLER,FEVZI CAKMAK MAH.,397,357,350,241,109
ESENLER,FEVZI CAKMAK MAH.,401,345,339,167,172
ESENLER,FEVZI CAKMAK MAH.,400,317,312,196,116
ESENLER,FEVZI CAKMAK MAH.,400,356,356,224,132
ESENLER,FEVZI CAKMAK MAH.,401,370,359,245,114
ESENLER,FEVZI CAKMAK MAH.,401,356,353,226,127
ESENLER,FEVZI CAKMAK MAH.,400,350,344,217,127
ESENLER,FEVZI CAKMAK MAH.,401,369,361,213,148
ESENLER,FEVZI CAKMAK MAH.,400,353,352,236,116
ESENLER,FEVZI CAKMAK MAH.,403,364,358,223,135
ESENLER,FEVZI CAKMAK MAH.,401,354,352,200,152
ESENLER,FEVZI CAKMAK MAH.,400,359,349,217,132
ESENLER,FEVZI CAKMAK MAH.,400,350,342,226,116
ESENLER,FEVZI CAKMAK MAH.,401,330,322,179,143
ESENLER,FEVZI CAKMAK MAH.,401,347,342,212,130
ESENLER,FEVZI CAKMAK MAH.,401,360,357,220,137
ESENLER,FEVZI CAKMAK MAH.,400,358,352,255,97
ESENLER,FEVZI CAKMAK MAH.,400,360,356,235,121
ESENLER,FEVZI CAKMAK MAH.,401,351,348,221,127
ESENLER,FEVZI CAKMAK MAH.,399,345,343,221,122
ESENLER,MENDERES MAH.,408,350,345,247,98
ESENLER,MENDERES MAH.,415,340,335,237,98
ESENLER,MENDERES MAH.,410,352,347,228,119
ESENLER,MENDERES MAH.,409,372,368,222,146
ESENLER,MENDERES MAH.,409,381,377,257,120
ESENLER,MENDERES MAH.,410,355,350,231,119
ESENLER,MENDERES MAH.,410,368,366,226,140
ESENLER,MENDERES MAH.,410,368,364,260,104
ESENLER,MENDERES MAH.,409,348,344,217,127
ESENLER,MENDERES MAH.,408,368,362,247,115
ESENLER,MENDERES MAH.,409,374,367,257,110
ESENLER,MENDERES MAH.,408,360,354,253,101
ESENLER,MENDERES MAH.,408,379,375,270,105
ESENLER,MENDERES MAH.,409,378,376,276,100
ESENLER,MENDERES MAH.,409,366,360,278,82
ESENLER,MENDERES MAH.,409,370,367,242,125
ESENLER,MENDERES MAH.,409,363,356,262,94
ESENLER,MENDERES MAH.,408,353,348,248,100
ESENLER,MENDERES MAH.,408,375,372,284,88
ESENLER,MENDERES MAH.,409,372,369,262,107
ESENLER,MENDERES MAH.,408,373,368,234,134
ESENLER,MENDERES MAH.,415,361,356,248,108
ESENLER,MENDERES MAH.,409,369,366,250,116
ESENLER,MENDERES MAH.,408,368,363,260,103
ESENLER,MENDERES MAH.,409,361,359,256,103
ESENLER,MENDERES MAH.,409,365,361,229,132
ESENLER,MENDERES MAH.,409,372,369,240,129
ESENLER,MENDERES MAH.,408,363,358,233,125
ESENLER,MENDERES MAH.,402,327,322,200,122
ESENLER,MENDERES MAH.,401,312,305,202,103
ESENLER,MENDERES MAH.,404,331,324,198,126
ESENLER,MENDERES MAH.,407,354,348,224,124
ESENLER,MENDERES MAH.,406,363,360,235,125
ESENLER,MENDERES MAH.,404,342,338,237,101
ESENLER,MENDERES MAH.,404,355,352,237,115
ESENLER,MENDERES MAH.,402,354,352,255,97
ESENLER,MENDERES MAH.,406,365,358,232,126
ESENLER,MENDERES MAH.,403,368,363,251,112
ESENLER,MENDERES MAH.,401,360,357,237,120
ESENLER,MENDERES MAH.,402,357,353,236,117
ESENLER,MENDERES MAH.,402,352,347,238,109
ESENLER,MENDERES MAH.,403,361,356,224,132
ESENLER,MENDERES MAH.,401,349,346,221,125
ESENLER,MENDERES MAH.,403,368,365,236,129
ESENLER,MENDERES MAH.,401,349,345,228,117
ESENLER,MENDERES MAH.,401,365,361,217,144
ESENLER,MENDERES MAH.,401,355,351,209,142
ESENLER,MENDERES MAH.,401,352,350,212,138
ESENLER,MENDERES MAH.,401,356,348,255,93
ESENLER,MENDERES MAH.,401,361,358,218,140
ESENLER,MENDERES MAH.,402,370,365,255,110
ESENLER,MENDERES MAH.,401,362,358,218,140
ESENLER,MENDERES MAH.,401,365,360,210,150
ESENLER,MENDERES MAH.,401,352,349,199,150
ESENLER,MENDERES MAH.,402,362,354,221,133
ESENLER,MENDERES MAH.,402,362,356,230,126
ESENLER,MENDERES MAH.,404,354,346,218,128
ESENLER,MIMAR SINAN MAH.,373,325,319,181,138
ESENLER,MIMAR SINAN MAH.,374,347,344,201,143
ESENLER,MIMAR SINAN MAH.,373,358,349,222,127
ESENLER,MIMAR SINAN MAH.,373,358,355,213,142
ESENLER,MIMAR SINAN MAH.,374,333,328,216,112
ESENLER,MIMAR SINAN MAH.,374,358,349,190,159
ESENLER,MIMAR SINAN MAH.,373,362,356,218,138
ESENLER,MIMAR SINAN MAH.,373,339,336,206,130
ESENLER,MIMAR SINAN MAH.,416,311,306,189,117
ESENLER,MIMAR SINAN MAH.,416,337,334,194,140
ESENLER,MIMAR SINAN MAH.,416,361,356,209,147
ESENLER,MIMAR SINAN MAH.,415,357,350,225,125
ESENLER,MIMAR SINAN MAH.,416,364,359,205,154
ESENLER,MIMAR SINAN MAH.,414,364,358,223,135
ESENLER,MIMAR SINAN MAH.,416,370,365,228,137
ESENLER,MIMAR SINAN MAH.,416,364,363,238,125
ESENLER,MIMAR SINAN MAH.,416,357,353,221,132
ESENLER,MIMAR SINAN MAH.,415,374,368,203,165
ESENLER,MIMAR SINAN MAH.,415,353,349,221,128
ESENLER,MIMAR SINAN MAH.,416,369,364,225,139
ESENLER,MIMAR SINAN MAH.,415,364,359,221,138
ESENLER,MIMAR SINAN MAH.,415,361,356,224,132
ESENLER,MIMAR SINAN MAH.,417,386,384,216,168
ESENLER,MIMAR SINAN MAH.,414,369,366,242,124
ESENLER,NAMIK KEMAL MAH.,397,334,325,146,179
ESENLER,NAMIK KEMAL MAH.,394,350,337,201,136
ESENLER,NAMIK KEMAL MAH.,399,379,372,186,186
ESENLER,NAMIK KEMAL MAH.,395,365,361,189,172
ESENLER,NAMIK KEMAL MAH.,394,366,364,205,159
ESENLER,NAMIK KEMAL MAH.,394,364,355,214,141
ESENLER,NAMIK KEMAL MAH.,394,356,351,210,141
ESENLER,NAMIK KEMAL MAH.,394,361,355,194,161
ESENLER,NAMIK KEMAL MAH.,394,352,347,167,180
ESENLER,NAMIK KEMAL MAH.,393,346,342,183,159
ESENLER,NAMIK KEMAL MAH.,393,357,350,196,154
ESENLER,NAMIK KEMAL MAH.,394,369,357,187,170
ESENLER,NAMIK KEMAL MAH.,393,366,361,190,171
ESENLER,NAMIK KEMAL MAH.,394,354,349,172,177
ESENLER,NAMIK KEMAL MAH.,394,351,343,195,148
ESENLER,NAMIK KEMAL MAH.,393,360,358,224,134
ESENLER,NAMIK KEMAL MAH.,396,359,351,183,168
ESENLER,NAMIK KEMAL MAH.,411,339,330,202,128
ESENLER,NAMIK KEMAL MAH.,415,376,368,208,160
ESENLER,NAMIK KEMAL MAH.,415,369,366,225,141
ESENLER,NAMIK KEMAL MAH.,413,359,349,206,143
ESENLER,NAMIK KEMAL MAH.,413,368,366,221,145
ESENLER,NAMIK KEMAL MAH.,413,356,348,205,143
ESENLER,NAMIK KEMAL MAH.,412,384,376,195,181
ESENLER,NAMIK KEMAL MAH.,412,377,373,191,182
ESENLER,NAMIK KEMAL MAH.,413,377,377,248,129
ESENLER,NAMIK KEMAL MAH.,415,382,382,227,155
ESENLER,NAMIK KEMAL MAH.,410,356,353,211,142
ESENLER,NAMIK KEMAL MAH.,411,369,365,223,142
ESENLER,NINE HATUN MAH.,411,330,318,207,111
ESENLER,NINE HATUN MAH.,410,328,324,181,143
ESENLER,NINE HATUN MAH.,415,360,356,232,124
ESENLER,NINE HATUN MAH.,410,365,352,223,129
ESENLER,NINE HATUN MAH.,409,364,362,231,131
ESENLER,NINE HATUN MAH.,410,363,354,230,124
ESENLER,NINE HATUN MAH.,410,367,359,216,143
ESENLER,NINE HATUN MAH.,410,368,362,211,151
ESENLER,NINE HATUN MAH.,409,367,358,214,144
ESENLER,NINE HATUN MAH.,410,362,360,213,147
ESENLER,NINE HATUN MAH.,410,371,365,250,115
ESENLER,NINE HATUN MAH.,410,348,343,214,129
ESENLER,NINE HATUN MAH.,410,360,358,215,143
ESENLER,NINE HATUN MAH.,409,348,346,211,135
ESENLER,NINE HATUN MAH.,409,374,369,217,152
ESENLER,NINE HATUN MAH.,409,368,363,230,133
ESENLER,NINE HATUN MAH.,410,364,358,209,149
ESENLER,NINE HATUN MAH.,409,367,361,237,124
ESENLER,NINE HATUN MAH.,410,357,352,250,102
ESENLER,NINE HATUN MAH.,409,366,361,249,112
ESENLER,NINE HATUN MAH.,409,344,339,226,113
ESENLER,NINE HATUN MAH.,410,354,349,221,128
ESENLER,NINE HATUN MAH.,410,379,370,270,100
ESENLER,NINE HATUN MAH.,415,363,360,211,149
ESENLER,NINE HATUN MAH.,410,355,349,224,125
ESENLER,NINE HATUN MAH.,404,319,315,190,125
ESENLER,NINE HATUN MAH.,406,357,349,212,137
ESENLER,NINE HATUN MAH.,404,361,360,251,109
ESENLER,NINE HATUN MAH.,405,352,349,224,125
ESENLER,NINE HATUN MAH.,406,359,355,232,123
ESENLER,NINE HATUN MAH.,405,372,370,215,155
ESENLER,NINE HATUN MAH.,403,365,356,232,124
ESENLER,NINE HATUN MAH.,404,364,358,224,134
ESENLER,NINE HATUN MAH.,404,350,349,226,123
ESENLER,NINE HATUN MAH.,404,363,357,239,118
ESENLER,NINE HATUN MAH.,403,355,350,243,107
ESENLER,NINE HATUN MAH.,403,349,345,224,121
ESENLER,NINE HATUN MAH.,406,363,360,236,124
ESENLER,NINE HATUN MAH.,404,340,337,213,124
ESENLER,NINE HATUN MAH.,404,354,351,248,103
ESENLER,NINE HATUN MAH.,403,362,354,232,122
ESENLER,NINE HATUN MAH.,403,357,353,238,115
ESENLER,NINE HATUN MAH.,415,342,333,232,101
ESENLER,NINE HATUN MAH.,415,330,324,231,93
ESENLER,NINE HATUN MAH.,415,324,320,222,98
ESENLER,NINE HATUN MAH.,415,364,361,237,124
ESENLER,NINE HATUN MAH.,415,383,379,258,121
ESENLER,NINE HATUN MAH.,414,379,375,234,141
ESENLER,NINE HATUN MAH.,415,361,358,232,126
ESENLER,NINE HATUN MAH.,415,366,359,224,135
ESENLER,NINE HATUN MAH.,415,364,361,235,126
ESENLER,NINE HATUN MAH.,414,365,360,236,124
ESENLER,NINE HATUN MAH.,415,364,362,241,121
ESENLER,NINE HATUN MAH.,415,372,366,230,136
ESENLER,NINE HATUN MAH.,415,371,367,227,140
ESENLER,NINE HATUN MAH.,414,367,362,227,135
ESENLER,NINE HATUN MAH.,414,377,370,237,133
ESENLER,NINE HATUN MAH.,415,378,373,245,128
ESENLER,NINE HATUN MAH.,414,363,360,238,122
ESENLER,NINE HATUN MAH.,414,378,374,265,109
ESENLER,NINE HATUN MAH.,413,367,367,268,99
ESENLER,NINE HATUN MAH.,414,362,357,271,86
ESENLER,NINE HATUN MAH.,413,359,351,225,126
ESENLER,NINE HATUN MAH.,413,372,365,247,118
ESENLER,NINE HATUN MAH.,415,369,363,236,127
ESENLER,NINE HATUN MAH.,413,368,365,247,118
ESENLER,NINE HATUN MAH.,413,361,352,239,113
ESENLER,NINE HATUN MAH.,413,362,356,223,133
ESENLER,NINE HATUN MAH.,412,362,353,237,116
ESENLER,NINE HATUN MAH.,411,359,354,247,107
ESENLER,NINE HATUN MAH.,413,382,377,259,118
ESENLER,NINE HATUN MAH.,414,370,366,248,118
ESENLER,NINE HATUN MAH.,412,353,347,224,123
ESENLER,NINE HATUN MAH.,414,367,363,246,117
ESENLER,YAVUZ SELIM MAH.,389,311,303,171,132
ESENLER,YAVUZ SELIM MAH.,390,337,331,177,154
ESENLER,YAVUZ SELIM MAH.,389,344,338,169,169
ESENLER,YAVUZ SELIM MAH.,389,343,336,199,137
ESENLER,YAVUZ SELIM MAH.,389,360,347,209,138
ESENLER,YAVUZ SELIM MAH.,388,334,327,183,144
ESENLER,YAVUZ SELIM MAH.,388,360,354,211,143
ESENLER,BIRLIK MAH.,401,329,327,190,137
ESENLER,BIRLIK MAH.,401,329,317,217,100
ESENLER,BIRLIK MAH.,401,362,356,206,150
ESENLER,BIRLIK MAH.,401,368,366,237,129
ESENLER,BIRLIK MAH.,401,353,347,236,111
ESENLER,BIRLIK MAH.,404,362,351,236,115
ESENLER,BIRLIK MAH.,400,365,354,242,112
ESENLER,BIRLIK MAH.,404,355,347,240,107
ESENLER,BIRLIK MAH.,401,362,358,220,138
ESENLER,BIRLIK MAH.,400,344,342,221,121
ESENLER,BIRLIK MAH.,401,364,360,262,98
ESENLER,BIRLIK MAH.,401,363,360,236,124
ESENLER,BIRLIK MAH.,402,372,363,241,122
ESENLER,BIRLIK MAH.,404,357,353,253,100
ESENLER,BIRLIK MAH.,401,349,346,211,135
ESENLER,BIRLIK MAH.,404,359,354,223,131
ESENLER,BIRLIK MAH.,401,364,359,230,129
ESENLER,BIRLIK MAH.,401,360,359,229,130
ESENLER,BIRLIK MAH.,402,352,349,239,110
ESENLER,BIRLIK MAH.,401,368,362,247,115
ESENLER,BIRLIK MAH.,403,354,351,222,129
ESENLER,BIRLIK MAH.,400,356,353,215,138
ESENLER,BIRLIK MAH.,401,367,359,230,129
ESENLER,BIRLIK MAH.,401,359,354,236,118
ESENLER,BIRLIK MAH.,400,348,342,234,108
ESENLER,BIRLIK MAH.,401,357,355,234,121
ESENLER,BIRLIK MAH.,400,352,350,248,102
ESENLER,BIRLIK MAH.,401,366,363,241,122
ESENLER,BIRLIK MAH.,400,358,354,244,110
ESENLER,BIRLIK MAH.,407,343,337,198,139
ESENLER,BIRLIK MAH.,406,351,348,219,129
ESENLER,BIRLIK MAH.,409,368,366,238,128
ESENLER,BIRLIK MAH.,407,363,352,210,142
ESENLER,BIRLIK MAH.,408,356,350,181,169
ESENLER,BIRLIK MAH.,410,375,367,232,135
ESENLER,BIRLIK MAH.,406,364,360,213,147
ESENLER,BIRLIK MAH.,408,364,362,225,137
ESENLER,BIRLIK MAH.,407,372,368,257,111
ESENLER,BIRLIK MAH.,406,372,362,239,123
ESENLER,BIRLIK MAH.,407,357,350,235,115
ESENLER,BIRLIK MAH.,406,368,362,248,114
ESENLER,BIRLIK MAH.,407,371,368,252,116
ESENLER,BIRLIK MAH.,406,375,374,222,152
ESENLER,BIRLIK MAH.,406,373,370,256,114
ESENLER,BIRLIK MAH.,407,371,369,255,114
ESENLER,BIRLIK MAH.,407,365,363,236,127
ESENLER,BIRLIK MAH.,407,374,371,259,112
ESENLER,BIRLIK MAH.,406,364,361,226,135
ESENLER,BIRLIK MAH.,407,359,352,241,111
ESENLER,HAVAALANI MAH.,414,337,318,247,71
ESENLER,HAVAALANI MAH.,415,360,355,261,94
ESENLER,HAVAALANI MAH.,414,365,360,255,105
ESENLER,HAVAALANI MAH.,415,374,367,288,79
ESENLER,HAVAALANI MAH.,414,380,373,267,106
ESENLER,HAVAALANI MAH.,415,372,364,264,100
ESENLER,HAVAALANI MAH.,414,390,386,279,107
ESENLER,HAVAALANI MAH.,413,385,384,306,78
ESENLER,HAVAALANI MAH.,414,381,378,262,116
ESENLER,HAVAALANI MAH.,413,374,371,288,83
ESENLER,HAVAALANI MAH.,413,370,364,263,101
ESENLER,HAVAALANI MAH.,413,380,374,259,115
ESENLER,HAVAALANI MAH.,414,376,374,275,99
ESENLER,HAVAALANI MAH.,413,395,393,310,83
ESENLER,HAVAALANI MAH.,414,362,359,259,100
ESENLER,HAVAALANI MAH.,415,376,370,273,97
ESENLER,HAVAALANI MAH.,413,374,370,288,82
ESENLER,HAVAALANI MAH.,413,378,372,272,100
ESENLER,HAVAALANI MAH.,414,377,362,268,94
ESENLER,HAVAALANI MAH.,414,366,359,249,110
ESENLER,HAVAALANI MAH.,410,346,339,260,79
ESENLER,HAVAALANI MAH.,410,366,357,251,106
ESENLER,HAVAALANI MAH.,410,382,371,290,81
ESENLER,HAVAALANI MAH.,410,379,374,271,103
ESENLER,HAVAALANI MAH.,410,367,366,274,92
ESENLER,HAVAALANI MAH.,410,372,369,265,104
ESENLER,HAVAALANI MAH.,415,377,372,260,112
ESENLER,HAVAALANI MAH.,410,378,374,290,84
ESENLER,HAVAALANI MAH.,409,360,354,230,124
ESENLER,HAVAALANI MAH.,410,375,369,287,82
ESENLER,HAVAALANI MAH.,409,366,361,287,74
ESENLER,HAVAALANI MAH.,410,383,381,259,122
ESENLER,HAVAALANI MAH.,410,376,373,298,75
ESENLER,HAVAALANI MAH.,412,377,370,248,122
ESENLER,HAVAALANI MAH.,409,371,366,272,94
ESENLER,HAVAALANI MAH.,409,365,361,245,116
ESENLER,HAVAALANI MAH.,415,383,379,279,100
ESENLER,HAVAALANI MAH.,409,373,370,269,101
ESENLER,HAVAALANI MAH.,409,355,353,260,93
ESENLER,HAVAALANI MAH.,410,361,356,265,91
ESENLER,HAVAALANI MAH.,409,363,354,255,99
ESENLER,HAVAALANI MAH.,409,359,350,264,86
ESENLER,HAVAALANI MAH.,409,390,386,286,100
ESENLER,HAVAALANI MAH.,396,318,304,230,74
ESENLER,HAVAALANI MAH.,397,364,363,277,86
ESENLER,HAVAALANI MAH.,396,368,365,257,108
ESENLER,HAVAALANI MAH.,396,359,351,271,80
ESENLER,HAVAALANI MAH.,395,363,358,274,84
ESENLER,HAVAALANI MAH.,396,365,358,280,78
ESENLER,HAVAALANI MAH.,395,347,338,245,93
ESENLER,HAVAALANI MAH.,396,354,351,241,110
ESENLER,HAVAALANI MAH.,396,347,346,258,88
ESENLER,HAVAALANI MAH.,396,370,365,271,94
ESENLER,HAVAALANI MAH.,398,370,369,286,83
ESENLER,HAVAALANI MAH.,397,360,354,284,70
ESENLER,KAZIM KARABEKIR MAH.,397,336,329,210,119
ESENLER,KAZIM KARABEKIR MAH.,397,323,318,196,122
ESENLER,KAZIM KARABEKIR MAH.,398,364,357,220,137
ESENLER,KAZIM KARABEKIR MAH.,397,354,353,223,130
ESENLER,KAZIM KARABEKIR MAH.,399,353,346,218,128
ESENLER,KAZIM KARABEKIR MAH.,400,347,344,215,129
ESENLER,KAZIM KARABEKIR MAH.,399,359,356,218,138
ESENLER,KAZIM KARABEKIR MAH.,397,350,346,215,131
ESENLER,KAZIM KARABEKIR MAH.,400,354,349,209,140
ESENLER,KAZIM KARABEKIR MAH.,401,348,339,214,125
ESENLER,KAZIM KARABEKIR MAH.,399,376,371,240,131
ESENLER,KAZIM KARABEKIR MAH.,398,359,355,232,123
ESENLER,KAZIM KARABEKIR MAH.,398,354,347,217,130
ESENLER,KAZIM KARABEKIR MAH.,398,371,368,231,137
ESENLER,KAZIM KARABEKIR MAH.,400,369,366,194,172
ESENLER,KAZIM KARABEKIR MAH.,398,349,345,241,104
ESENLER,KAZIM KARABEKIR MAH.,398,361,353,202,151
ESENLER,KAZIM KARABEKIR MAH.,398,363,362,246,116
ESENLER,KAZIM KARABEKIR MAH.,398,357,357,214,143
ESENLER,KAZIM KARABEKIR MAH.,403,334,334,197,137
ESENLER,KAZIM KARABEKIR MAH.,401,346,338,174,164
ESENLER,KAZIM KARABEKIR MAH.,402,351,341,204,137
ESENLER,KAZIM KARABEKIR MAH.,402,352,349,221,128
ESENLER,KAZIM KARABEKIR MAH.,402,358,352,240,112
ESENLER,KAZIM KARABEKIR MAH.,402,353,348,197,151
ESENLER,KAZIM KARABEKIR MAH.,404,358,352,208,144
ESENLER,KAZIM KARABEKIR MAH.,402,357,350,194,156
ESENLER,KAZIM KARABEKIR MAH.,404,365,362,215,147
ESENLER,KAZIM KARABEKIR MAH.,403,356,353,221,132
ESENLER,KAZIM KARABEKIR MAH.,402,350,344,234,110
ESENLER,KAZIM KARABEKIR MAH.,402,365,363,238,125
ESENLER,KAZIM KARABEKIR MAH.,402,362,359,218,141
ESENLER,KAZIM KARABEKIR MAH.,402,363,355,213,142
ESENLER,KAZIM KARABEKIR MAH.,403,352,347,209,138
ESENLER,KAZIM KARABEKIR MAH.,402,340,333,230,103
ESENLER,KAZIM KARABEKIR MAH.,401,372,366,207,159
ESENLER,KAZIM KARABEKIR MAH.,402,362,359,232,127
ESENLER,KAZIM KARABEKIR MAH.,402,361,355,207,148
ESENLER,KAZIM KARABEKIR MAH.,401,346,340,209,131
ESENLER,KAZIM KARABEKIR MAH.,401,351,348,201,147
ESENLER,KAZIM KARABEKIR MAH.,401,357,355,214,141
ESENLER,KAZIM KARABEKIR MAH.,401,347,343,229,114
ESENLER,KAZIM KARABEKIR MAH.,401,360,358,224,134
ESENLER,KAZIM KARABEKIR MAH.,402,355,352,211,141
ESENLER,KAZIM KARABEKIR MAH.,401,376,370,227,143
ESENLER,KAZIM KARABEKIR MAH.,415,335,330,181,149
ESENLER,KAZIM KARABEKIR MAH.,415,352,350,216,134
ESENLER,KAZIM KARABEKIR MAH.,410,368,360,220,140
ESENLER,KAZIM KARABEKIR MAH.,410,353,349,214,135
ESENLER,KAZIM KARABEKIR MAH.,410,365,362,238,124
ESENLER,KAZIM KARABEKIR MAH.,410,368,363,216,147
ESENLER,KAZIM KARABEKIR MAH.,410,375,367,220,147
ESENLER,KAZIM KARABEKIR MAH.,409,364,356,222,134
ESENLER,KAZIM KARABEKIR MAH.,409,366,361,227,134
ESENLER,KAZIM KARABEKIR MAH.,409,373,367,241,126
ESENLER,KAZIM KARABEKIR MAH.,410,357,352,221,131
ESENLER,KAZIM KARABEKIR MAH.,409,372,366,236,130
ESENLER,KAZIM KARABEKIR MAH.,410,370,369,230,139
ESENLER,KAZIM KARABEKIR MAH.,409,384,376,248,128
ESENLER,KAZIM KARABEKIR MAH.,409,378,366,233,133
ESENLER,KAZIM KARABEKIR MAH.,408,376,371,223,148
ESENLER,KAZIM KARABEKIR MAH.,409,376,373,211,162
ESENLER,KEMER MAH.,399,336,320,210,110
ESENLER,KEMER MAH.,399,310,304,205,99
ESENLER,KEMER MAH.,400,366,359,229,130
ESENLER,KEMER MAH.,399,353,349,202,147
ESENLER,KEMER MAH.,399,353,345,216,129
ESENLER,KEMER MAH.,399,356,354,224,130
ESENLER,KEMER MAH.,399,370,366,256,110
ESENLER,KEMER MAH.,399,358,353,236,117
ESENLER,KEMER MAH.,399,361,356,215,141
ESENLER,KEMER MAH.,399,369,363,247,116
ESENLER,KEMER MAH.,399,353,350,244,106
ESENLER,KEMER MAH.,399,364,361,219,142
ESENLER,KEMER MAH.,400,361,356,220,136
ESENLER,KEMER MAH.,401,340,332,197,135
ESENLER,KEMER MAH.,399,370,365,226,139
ESENLER,KEMER MAH.,399,348,344,222,122
ESENLER,KEMER MAH.,399,369,369,236,133
ESENLER,KEMER MAH.,400,370,365,246,119
ESENLER,KEMER MAH.,399,360,354,234,120
ESENLER,KEMER MAH.,400,362,360,227,133
ESENLER,KEMER MAH.,399,358,351,207,144
ESENLER,KEMER MAH.,399,355,349,226,123
ESENLER,KEMER MAH.,400,362,358,216,142
ESENLER,KEMER MAH.,400,356,349,205,144
ESENLER,KEMER MAH.,398,333,323,211,112
ESENLER,KEMER MAH.,397,366,360,235,125
ESENLER,KEMER MAH.,398,361,356,222,134
ESENLER,KEMER MAH.,398,367,366,250,116
ESENLER,KEMER MAH.,398,357,352,240,112
ESENLER,KEMER MAH.,398,361,356,227,129
ESENLER,KEMER MAH.,398,359,355,236,119
ESENLER,KEMER MAH.,402,366,357,221,136
ESENLER,KEMER MAH.,397,350,346,223,123
ESENLER,KEMER MAH.,396,363,361,237,124
ESENLER,KEMER MAH.,398,356,350,253,97
ESENLER,KEMER MAH.,398,353,348,238,110
ESENLER,KEMER MAH.,397,361,353,247,106
ESENLER,KEMER MAH.,397,365,356,252,104
ESENLER,ORUCREIS MAH.,415,324,316,204,112
ESENLER,ORUCREIS MAH.,416,352,342,196,146
ESENLER,ORUCREIS MAH.,416,380,374,221,153
ESENLER,ORUCREIS MAH.,416,365,365,242,123
ESENLER,ORUCREIS MAH.,417,362,358,244,114
ESENLER,ORUCREIS MAH.,417,368,358,231,127
ESENLER,ORUCREIS MAH.,416,380,378,242,136
ESENLER,ORUCREIS MAH.,415,374,361,234,127
ESENLER,ORUCREIS MAH.,418,376,367,232,135
ESENLER,ORUCREIS MAH.,414,376,370,255,115
ESENLER,ORUCREIS MAH.,414,378,371,234,137
ESENLER,ORUCREIS MAH.,414,358,353,230,123
ESENLER,ORUCREIS MAH.,416,377,369,218,151
ESENLER,ORUCREIS MAH.,416,375,370,236,134
ESENLER,ORUCREIS MAH.,415,364,357,218,139
ESENLER,ORUCREIS MAH.,415,378,375,223,152
ESENLER,ORUCREIS MAH.,415,370,364,262,102
ESENLER,ORUCREIS MAH.,414,379,378,224,154
ESENLER,ORUCREIS MAH.,415,375,366,233,133
ESENLER,ORUCREIS MAH.,414,367,360,224,136
ESENLER,ORUCREIS MAH.,415,375,372,252,120
ESENLER,ORUCREIS MAH.,414,386,378,236,142
ESENLER,ORUCREIS MAH.,414,366,360,224,136
ESENLER,ORUCREIS MAH.,415,365,358,230,128
ESENLER,ORUCREIS MAH.,414,379,371,242,129
ESENLER,ORUCREIS MAH.,411,352,347,241,106
ESENLER,ORUCREIS MAH.,410,369,365,239,126
ESENLER,ORUCREIS MAH.,409,364,358,265,93
ESENLER,ORUCREIS MAH.,410,373,368,238,130
ESENLER,ORUCREIS MAH.,409,367,360,244,116
ESENLER,ORUCREIS MAH.,409,368,361,250,111
ESENLER,ORUCREIS MAH.,409,363,360,261,99
ESENLER,ORUCREIS MAH.,410,363,355,242,113
ESENLER,ORUCREIS MAH.,410,361,358,223,135
ESENLER,ORUCREIS MAH.,409,365,357,241,116
ESENLER,ORUCREIS MAH.,410,373,367,262,105
ESENLER,ORUCREIS MAH.,411,347,341,230,111
ESENLER,ORUCREIS MAH.,409,352,347,228,119
ESENLER,ORUCREIS MAH.,410,379,378,251,127
ESENLER,ORUCREIS MAH.,410,363,358,266,92
ESENLER,ORUCREIS MAH.,409,355,346,244,102
ESENLER,ORUCREIS MAH.,408,362,361,262,99
ESENLER,ORUCREIS MAH.,410,361,355,259,96
ESENLER,ORUCREIS MAH.,409,383,381,287,94
ESENLER,ORUCREIS MAH.,408,373,371,259,112
ESENLER,ORUCREIS MAH.,407,349,342,238,104
ESENLER,ORUCREIS MAH.,407,371,367,242,125
ESENLER,ORUCREIS MAH.,407,358,354,231,123
ESENLER,ORUCREIS MAH.,406,358,354,241,113
ESENLER,ORUCREIS MAH.,407,376,376,252,124
ESENLER,ORUCREIS MAH.,407,359,357,254,103
ESENLER,ORUCREIS MAH.,407,368,362,247,115
ESENLER,ORUCREIS MAH.,407,365,365,269,96
ESENLER,ORUCREIS MAH.,408,374,371,269,102
ESENLER,ORUCREIS MAH.,407,372,362,269,93
ESENLER,ORUCREIS MAH.,408,390,384,288,96
ESENLER,ORUCREIS MAH.,407,358,353,240,113
ESENLER,ORUCREIS MAH.,397,331,325,237,88
ESENLER,ORUCREIS MAH.,398,365,360,241,119
ESENLER,ORUCREIS MAH.,397,369,364,260,104
ESENLER,ORUCREIS MAH.,397,359,355,251,104
ESENLER,ORUCREIS MAH.,397,361,358,264,94
ESENLER,ORUCREIS MAH.,398,376,375,262,113
ESENLER,ORUCREIS MAH.,399,343,338,224,114
ESENLER,ORUCREIS MAH.,396,362,360,256,104
ESENLER,ORUCREIS MAH.,398,373,368,257,111
ESENLER,ORUCREIS MAH.,397,355,351,260,91
ESENLER,ORUCREIS MAH.,396,368,364,253,111
ESENLER,ORUCREIS MAH.,397,366,357,243,114
ESENLER,ORUCREIS MAH.,396,359,357,255,102
ESENLER,ORUCREIS MAH.,397,374,364,268,96
ESENLER,TUNA MAH.,415,331,325,207,118
ESENLER,TUNA MAH.,413,339,332,222,110
ESENLER,TUNA MAH.,415,369,363,236,127
ESENLER,TUNA MAH.,413,358,356,223,133
ESENLER,TUNA MAH.,413,349,342,222,120
ESENLER,TUNA MAH.,414,360,357,238,119
ESENLER,TUNA MAH.,414,346,340,206,134
ESENLER,TUNA MAH.,414,347,339,224,115
ESENLER,TUNA MAH.,413,368,364,229,135
ESENLER,TUNA MAH.,414,357,352,228,124
ESENLER,TUNA MAH.,414,376,366,241,125
ESENLER,TUNA MAH.,414,332,328,214,114
ESENLER,TUNA MAH.,414,369,355,229,126
ESENLER,TUNA MAH.,415,365,361,246,115
ESENLER,TUNA MAH.,415,346,345,235,110
ESENLER,TUNA MAH.,414,359,355,236,119
ESENLER,TUNA MAH.,398,317,314,199,115
ESENLER,TUNA MAH.,397,305,297,176,121
ESENLER,TUNA MAH.,397,337,330,236,94
ESENLER,TUNA MAH.,396,341,331,224,107
ESENLER,TUNA MAH.,397,349,344,251,93
ESENLER,TUNA MAH.,397,355,353,243,110
ESENLER,TUNA MAH.,397,323,322,206,116
ESENLER,TUNA MAH.,399,343,340,237,103
ESENLER,TUNA MAH.,396,354,352,229,123
ESENLER,TUNA MAH.,396,340,339,243,96
ESENLER,TUNA MAH.,396,340,334,237,97
ESENLER,TUNA MAH.,397,350,345,248,97
ESENLER,TUNA MAH.,397,353,348,224,124
ESENLER,TUNA MAH.,396,344,336,213,123
ESENLER,TUNA MAH.,399,344,337,236,101
ESENLER,TUNA MAH.,396,351,345,251,94
ESENLER,TUNA MAH.,398,351,346,249,97
ESENLER,TUNA MAH.,400,357,356,253,103
ESENLER,TUNA MAH.,396,341,337,234,103
ESENLER,TUNA MAH.,397,334,330,243,87
ESENLER,TUNA MAH.,396,351,347,223,124
ESENLER,TUNA MAH.,397,358,353,254,99
ESENLER,TUNA MAH.,415,366,360,191,169
ESENLER,TUNA MAH.,415,339,334,206,128
ESENLER,TUNA MAH.,415,367,362,198,164
ESENLER,TUNA MAH.,411,368,365,218,147
ESENLER,TUNA MAH.,412,371,368,212,156
ESENLER,TUNA MAH.,411,354,349,233,116
ESENLER,TUNA MAH.,412,358,346,228,118
ESENLER,TUNA MAH.,412,364,358,248,110
ESENLER,TUNA MAH.,412,365,357,234,123
ESENLER,TUNA MAH.,412,369,363,252,111
ESENLER,TUNA MAH.,411,357,352,210,142
ESENLER,TUNA MAH.,412,365,361,228,133
ESENLER,TUNA MAH.,411,380,373,231,142
ESENLER,TUNA MAH.,412,377,368,235,133
ESENLER,TUNA MAH.,411,359,355,219,136
ESENLER,TUNA MAH.,412,370,365,250,115
ESENLER,TUNA MAH.,412,352,344,231,113
ESENLER,TUNA MAH.,411,349,345,230,115
ESENLER,TUNA MAH.,411,366,364,208,156
ESENLER,TURGUT REIS MAH.,409,340,329,243,86
ESENLER,TURGUT REIS MAH.,410,346,342,227,115
ESENLER,TURGUT REIS MAH.,408,370,361,275,86
ESENLER,TURGUT REIS MAH.,409,372,366,269,97
ESENLER,TURGUT REIS MAH.,415,365,360,262,98
ESENLER,TURGUT REIS MAH.,415,377,373,267,106
ESENLER,TURGUT REIS MAH.,408,367,360,271,89
ESENLER,TURGUT REIS MAH.,409,386,379,271,108
ESENLER,TURGUT REIS MAH.,415,371,368,263,105
ESENLER,TURGUT REIS MAH.,408,370,362,263,99
ESENLER,TURGUT REIS MAH.,409,370,364,268,96
ESENLER,TURGUT REIS MAH.,408,361,352,269,83
ESENLER,TURGUT REIS MAH.,409,376,369,260,109
ESENLER,TURGUT REIS MAH.,409,359,354,259,95
ESENLER,TURGUT REIS MAH.,408,373,368,250,118
ESENLER,TURGUT REIS MAH.,409,364,353,264,89
ESENLER,TURGUT REIS MAH.,408,373,367,275,92
ESENLER,TURGUT REIS MAH.,408,365,363,279,84
ESENLER,TURGUT REIS MAH.,409,370,367,283,84
ESENLER,TURGUT REIS MAH.,408,354,349,260,89
ESENLER,TURGUT REIS MAH.,409,356,351,256,95
ESENLER,TURGUT REIS MAH.,408,342,338,251,87
ESENLER,TURGUT REIS MAH.,408,356,350,267,83
ESENLER,TURGUT REIS MAH.,409,360,355,274,81
ESENLER,TURGUT REIS MAH.,409,373,371,264,107
ESENLER,TURGUT REIS MAH.,409,366,361,254,107
ESENLER,TURGUT REIS MAH.,403,340,332,254,78
ESENLER,TURGUT REIS MAH.,403,358,354,256,98
ESENLER,TURGUT REIS MAH.,402,353,351,268,83
ESENLER,TURGUT REIS MAH.,402,357,351,263,88
ESENLER,TURGUT REIS MAH.,404,370,367,271,96
ESENLER,TURGUT REIS MAH.,402,370,363,274,89
ESENLER,TURGUT REIS MAH.,402,361,356,252,104
ESENLER,TURGUT REIS MAH.,402,366,360,277,83
ESENLER,TURGUT REIS MAH.,402,360,357,243,114
ESENLER,TURGUT REIS MAH.,403,361,356,249,107
ESENLER,TURGUT REIS MAH.,402,365,364,246,118
ESENLER,TURGUT REIS MAH.,401,368,364,248,116
ESENLER,TURGUT REIS MAH.,402,349,343,264,79
ESENLER,TURGUT REIS MAH.,402,341,335,268,67
ESENLER,TURGUT REIS MAH.,402,375,368,254,114
ESENLER,TURGUT REIS MAH.,401,348,345,255,90
ESENLER,TURGUT REIS MAH.,404,371,352,263,89
ESENLER,TURGUT REIS MAH.,402,364,360,287,73
ESENLER,TURGUT REIS MAH.,402,369,362,287,75
ESENLER,TURGUT REIS MAH.,401,363,362,274,88
ESENLER,TURGUT REIS MAH.,402,371,367,293,74
ESENLER,TURGUT REIS MAH.,392,312,309,241,68
ESENLER,TURGUT REIS MAH.,394,347,345,224,121
ESENLER,TURGUT REIS MAH.,392,353,348,240,108
ESENLER,TURGUT REIS MAH.,394,358,357,242,115
ESENLER,TURGUT REIS MAH.,393,340,336,244,92
ESENLER,TURGUT REIS MAH.,394,351,348,248,100
ESENLER,TURGUT REIS MAH.,392,348,344,242,102
ESENLER,TURGUT REIS MAH.,392,352,344,253,91
ESENLER,TURGUT REIS MAH.,391,348,340,249,91
ESENLER,TURGUT REIS MAH.,391,347,343,234,109
ESENLER,TURGUT REIS MAH.,392,357,355,264,91
ESENLER,TURGUT REIS MAH.,391,344,342,252,90
ESENLER,TURGUT REIS MAH.,393,342,338,241,97
ESENLER,TURGUT REIS MAH.,392,354,344,232,112
ESENLER,TURGUT REIS MAH.,391,350,347,236,111
ESENLER,TURGUT REIS MAH.,391,351,347,242,105
ESENLER,TURGUT REIS MAH.,398,340,336,249,87
ESENLER,TURGUT REIS MAH.,398,356,352,266,86
ESENLER,TURGUT REIS MAH.,398,363,356,263,93
ESENLER,TURGUT REIS MAH.,398,355,348,249,99
ESENLER,TURGUT REIS MAH.,397,359,356,263,93
ESENLER,TURGUT REIS MAH.,398,362,357,268,89
ESENLER,TURGUT REIS MAH.,398,355,350,259,91
ESENLER,TURGUT REIS MAH.,401,369,364,260,104
ESENLER,TURGUT REIS MAH.,397,353,346,263,83
ESENLER,TURGUT REIS MAH.,397,357,348,250,98
ESENLER,TURGUT REIS MAH.,397,355,351,244,107
ESENLER,TURGUT REIS MAH.,397,356,350,251,99
ESENLER,TURGUT REIS MAH.,398,356,354,287,67
ESENLER,TURGUT REIS MAH.,397,360,357,278,79
ESENLER,TURGUT REIS MAH.,399,366,359,240,119
ESENLER,TURGUT REIS MAH.,397,362,356,238,118
ESENLER,TURGUT REIS MAH.,397,368,360,246,114
ESENLER,TURGUT REIS MAH.,398,351,347,261,86
ESENLER,METRIS CEZA VE TUTUKEVI,303,296,295,158,137
ESENLER,METRIS CEZA VE TUTUKEVI,295,288,283,137,146
ESENLER,METRIS CEZA VE TUTUKEVI,306,293,288,134,154
ESENLER,METRIS CEZA VE TUTUKEVI,194,188,185,104,81
ESENLER,METRIS CEZA VE TUTUKEVI,265,265,265,164,101
FATIH,AKSEMSETTIN MAH.,392,280,277,142,135
FATIH,AKSEMSETTIN MAH.,391,284,280,138,142
FATIH,AKSEMSETTIN MAH.,392,289,288,123,165
FATIH,AKSEMSETTIN MAH.,391,340,337,188,149
FATIH,AKSEMSETTIN MAH.,391,331,328,188,140
FATIH,AKSEMSETTIN MAH.,392,353,348,180,168
FATIH,AKSEMSETTIN MAH.,392,333,332,154,178
FATIH,AKSEMSETTIN MAH.,391,335,332,159,173
FATIH,AKSEMSETTIN MAH.,391,339,337,195,142
FATIH,AKSEMSETTIN MAH.,392,336,335,214,121
FATIH,AKSEMSETTIN MAH.,392,332,327,150,177
FATIH,AKSEMSETTIN MAH.,392,342,340,174,166
FATIH,AKSEMSETTIN MAH.,392,344,338,187,151
FATIH,AKSEMSETTIN MAH.,392,336,329,201,128
FATIH,AKSEMSETTIN MAH.,392,352,346,196,150
FATIH,AKSEMSETTIN MAH.,400,316,314,146,168
FATIH,AKSEMSETTIN MAH.,400,329,322,134,188
FATIH,AKSEMSETTIN MAH.,401,312,307,140,167
FATIH,AKSEMSETTIN MAH.,400,310,303,166,137
FATIH,AKSEMSETTIN MAH.,399,344,339,194,145
FATIH,AKSEMSETTIN MAH.,400,357,353,180,173
FATIH,AKSEMSETTIN MAH.,400,342,338,180,158
FATIH,AKSEMSETTIN MAH.,400,344,338,169,169
FATIH,AKSEMSETTIN MAH.,400,365,359,187,172
FATIH,AKSEMSETTIN MAH.,401,350,347,191,156
FATIH,AKSEMSETTIN MAH.,401,364,361,178,183
FATIH,AKSEMSETTIN MAH.,400,347,340,169,171
FATIH,AKSEMSETTIN MAH.,401,353,347,188,159
FATIH,AKSEMSETTIN MAH.,399,341,336,167,169
FATIH,AKSEMSETTIN MAH.,399,341,337,158,179
FATIH,AKSEMSETTIN MAH.,400,354,347,192,155
FATIH,AKSEMSETTIN MAH.,400,352,346,212,134
FATIH,AKSEMSETTIN MAH.,399,354,350,192,158
FATIH,AKSEMSETTIN MAH.,399,351,349,201,148
FATIH,AKSEMSETTIN MAH.,400,336,332,183,149
FATIH,AKSEMSETTIN MAH.,400,353,350,168,182
FATIH,AKSEMSETTIN MAH.,399,353,345,210,135
FATIH,ALI KUSCU MAH.,415,352,343,219,124
FATIH,ALI KUSCU MAH.,409,346,341,227,114
FATIH,ALI KUSCU MAH.,410,329,323,238,85
FATIH,ALI KUSCU MAH.,410,370,364,268,96
FATIH,ALI KUSCU MAH.,409,374,369,276,93
FATIH,ALI KUSCU MAH.,410,373,363,277,86
FATIH,ALI KUSCU MAH.,410,371,364,245,119
FATIH,ALI KUSCU MAH.,411,376,372,275,97
FATIH,ALI KUSCU MAH.,408,368,358,278,80
FATIH,ALI KUSCU MAH.,408,371,367,288,79
FATIH,ALI KUSCU MAH.,410,364,356,278,78
FATIH,ALI KUSCU MAH.,409,360,353,255,98
FATIH,ALI KUSCU MAH.,410,372,362,277,85
FATIH,ALI KUSCU MAH.,409,366,363,283,80
FATIH,ALI KUSCU MAH.,409,358,352,246,106
FATIH,ALI KUSCU MAH.,410,350,344,252,92
FATIH,ALI KUSCU MAH.,409,361,352,249,103
FATIH,ALI KUSCU MAH.,410,378,368,268,100
FATIH,ALI KUSCU MAH.,409,359,355,249,106
FATIH,AYVANSARAY MAH.,415,313,302,203,99
FATIH,AYVANSARAY MAH.,410,296,291,188,103
FATIH,AYVANSARAY MAH.,410,326,320,216,104
FATIH,AYVANSARAY MAH.,410,320,316,208,108
FATIH,AYVANSARAY MAH.,410,341,339,214,125
FATIH,AYVANSARAY MAH.,410,357,352,229,123
FATIH,AYVANSARAY MAH.,410,341,332,232,100
FATIH,AYVANSARAY MAH.,409,357,352,273,79
FATIH,AYVANSARAY MAH.,410,341,337,228,109
FATIH,AYVANSARAY MAH.,411,356,356,229,127
FATIH,AYVANSARAY MAH.,409,331,329,202,127
FATIH,AYVANSARAY MAH.,410,355,345,227,118
FATIH,AYVANSARAY MAH.,410,345,334,229,105
FATIH,AYVANSARAY MAH.,409,349,348,241,107
FATIH,AYVANSARAY MAH.,409,354,343,236,107
FATIH,AYVANSARAY MAH.,410,344,335,224,111
FATIH,AYVANSARAY MAH.,409,336,332,231,101
FATIH,AYVANSARAY MAH.,410,342,335,214,121
FATIH,AYVANSARAY MAH.,409,354,351,239,112
FATIH,AYVANSARAY MAH.,410,324,317,218,99
FATIH,AYVANSARAY MAH.,408,343,335,220,115
FATIH,AYVANSARAY MAH.,408,340,333,235,98
FATIH,AYVANSARAY MAH.,415,301,294,156,138
FATIH,AYVANSARAY MAH.,411,345,338,204,134
FATIH,AYVANSARAY MAH.,411,337,334,212,122
FATIH,AYVANSARAY MAH.,411,343,337,188,149
FATIH,AYVANSARAY MAH.,410,352,346,225,121
FATIH,AYVANSARAY MAH.,410,358,354,228,126
FATIH,AYVANSARAY MAH.,411,347,339,209,130
FATIH,AYVANSARAY MAH.,410,353,348,207,141
FATIH,AYVANSARAY MAH.,410,353,350,215,135
FATIH,AYVANSARAY MAH.,411,342,340,183,157
FATIH,BALAT MAH.,403,328,320,243,77
FATIH,BALAT MAH.,402,350,347,255,92
FATIH,BALAT MAH.,402,353,347,279,68
FATIH,BALAT MAH.,401,357,348,261,87
FATIH,BALAT MAH.,402,353,346,283,63
FATIH,BALAT MAH.,402,349,346,267,79
FATIH,BALAT MAH.,402,356,351,264,87
FATIH,BALAT MAH.,404,369,356,259,97
FATIH,BALAT MAH.,402,361,356,288,68
FATIH,BALAT MAH.,401,358,352,256,96
FATIH,BALAT MAH.,383,299,295,193,102
FATIH,BALAT MAH.,384,327,323,217,106
FATIH,BALAT MAH.,383,329,327,212,115
FATIH,BALAT MAH.,383,320,313,215,98
FATIH,BALAT MAH.,383,339,332,240,92
FATIH,BALAT MAH.,383,342,338,220,118
FATIH,BALAT MAH.,409,345,332,254,78
FATIH,BALAT MAH.,415,357,354,279,75
FATIH,BALAT MAH.,410,376,370,305,65
FATIH,BALAT MAH.,409,361,354,270,84
FATIH,BALAT MAH.,410,376,371,297,74
FATIH,BALAT MAH.,410,365,363,291,72
FATIH,BALAT MAH.,410,373,369,298,71
FATIH,BALAT MAH.,409,378,371,303,68
FATIH,BALAT MAH.,410,389,375,304,71
FATIH,BINBIRDIREK MAH.,377,309,303,143,160
FATIH,BINBIRDIREK MAH.,378,308,305,94,211
FATIH,CIBALI MAH.,395,330,321,189,132
FATIH,CIBALI MAH.,396,348,342,237,105
FATIH,CIBALI MAH.,394,357,349,225,124
FATIH,CIBALI MAH.,396,338,336,234,102
FATIH,CIBALI MAH.,397,344,336,208,128
FATIH,CIBALI MAH.,375,313,301,204,97
FATIH,CIBALI MAH.,373,314,310,214,96
FATIH,CIBALI MAH.,374,312,307,208,99
FATIH,CIBALI MAH.,374,330,322,215,107
FATIH,CIBALI MAH.,374,332,328,214,114
FATIH,CIBALI MAH.,373,322,320,202,118
FATIH,CIBALI MAH.,374,322,316,218,98
FATIH,CIBALI MAH.,374,319,313,163,150
FATIH,CIBALI MAH.,374,311,308,210,98
FATIH,CIBALI MAH.,374,317,312,233,79
FATIH,EMIN SINAN MAH.,292,240,235,116,119
FATIH,EMIN SINAN MAH.,292,217,209,96,113
FATIH,EMIN SINAN MAH.,292,234,230,128,102
FATIH,ISKENDERPASA MAH.,407,302,297,145,152
FATIH,ISKENDERPASA MAH.,408,320,315,136,179
FATIH,ISKENDERPASA MAH.,408,335,331,165,166
FATIH,ISKENDERPASA MAH.,415,336,331,195,136
FATIH,ISKENDERPASA MAH.,408,304,299,177,122
FATIH,ISKENDERPASA MAH.,407,338,326,178,148
FATIH,ISKENDERPASA MAH.,407,336,332,183,149
FATIH,ISKENDERPASA MAH.,408,351,345,177,168
FATIH,ISKENDERPASA MAH.,408,347,340,197,143
FATIH,ISKENDERPASA MAH.,407,342,336,186,150
FATIH,ISKENDERPASA MAH.,407,351,346,196,150
FATIH,ISKENDERPASA MAH.,407,338,333,202,131
FATIH,ISKENDERPASA MAH.,408,325,318,201,117
FATIH,ISKENDERPASA MAH.,407,344,335,194,141
FATIH,ISKENDERPASA MAH.,385,303,296,135,161
FATIH,ISKENDERPASA MAH.,385,334,328,171,157
FATIH,ISKENDERPASA MAH.,386,340,335,195,140
FATIH,ISKENDERPASA MAH.,386,324,321,174,147
FATIH,ISKENDERPASA MAH.,385,343,339,191,148
FATIH,ISKENDERPASA MAH.,386,331,325,176,149
FATIH,ISKENDERPASA MAH.,386,340,338,143,195
FATIH,ISKENDERPASA MAH.,386,334,333,189,144
FATIH,ISKENDERPASA MAH.,386,344,339,194,145
FATIH,KATIP KASIM MAH.,372,274,262,97,165
FATIH,KATIP KASIM MAH.,373,251,246,79,167
FATIH,KATIP KASIM MAH.,370,253,249,103,146
FATIH,KUCUK AYASOFYA MAH.,388,319,309,139,170
FATIH,KUCUK AYASOFYA MAH.,389,325,322,157,165
FATIH,KUCUK AYASOFYA MAH.,387,320,315,166,149
FATIH,KUCUK AYASOFYA MAH.,388,318,312,135,177
FATIH,KUCUK AYASOFYA MAH.,389,333,330,159,171
FATIH,MESIHPASA MAH.,76,158,156,107,49
FATIH,MIMAR HAYRETTIN MAH.,210,160,159,75,84
FATIH,MIMAR HAYRETTIN MAH.,211,158,158,85,73
FATIH,MIMAR KEMALETTIN MAH.,137,184,182,116,66
FATIH,MUHSINE HATUN MAH.,355,275,268,113,155
FATIH,MUHSINE HATUN MAH.,355,281,275,89,186
FATIH,MUHSINE HATUN MAH.,355,270,263,113,150
FATIH,MUHSINE HATUN MAH.,355,277,273,97,176
FATIH,NISANCA MAH.,378,290,285,107,178
FATIH,NISANCA MAH.,378,307,306,127,179
FATIH,NISANCA MAH.,378,315,312,103,209
FATIH,NISANCA MAH.,378,314,310,140,170
FATIH,NISANCA MAH.,377,325,320,152,168
FATIH,NISANCA MAH.,377,318,308,121,187
FATIH,NISANCA MAH.,377,310,305,99,206
FATIH,NISANCA MAH.,378,293,285,85,200
FATIH,SARAC ISHAK MAH.,334,262,262,109,153
FATIH,SARAC ISHAK MAH.,333,273,268,132,136
FATIH,SEHSUVAR BEY MAH.,331,275,274,123,151
FATIH,SEHSUVAR BEY MAH.,331,246,241,105,136
FATIH,SEHSUVAR BEY MAH.,331,251,248,115,133
FATIH,SEHSUVAR BEY MAH.,331,264,262,100,162
FATIH,YAVUZ SULTAN SELIM MAH.,358,275,272,175,97
FATIH,YAVUZ SULTAN SELIM MAH.,360,309,304,213,91
FATIH,YAVUZ SULTAN SELIM MAH.,358,313,310,207,103
FATIH,YAVUZ SULTAN SELIM MAH.,358,304,304,191,113
FATIH,YAVUZ SULTAN SELIM MAH.,359,329,324,218,106
FATIH,YAVUZ SULTAN SELIM MAH.,393,316,309,192,117
FATIH,YAVUZ SULTAN SELIM MAH.,395,318,311,200,111
FATIH,YAVUZ SULTAN SELIM MAH.,393,347,340,214,126
FATIH,YAVUZ SULTAN SELIM MAH.,393,344,342,199,143
FATIH,YAVUZ SULTAN SELIM MAH.,393,366,363,230,133
FATIH,YAVUZ SULTAN SELIM MAH.,393,343,336,188,148
FATIH,YAVUZ SULTAN SELIM MAH.,393,351,347,223,124
FATIH,YAVUZ SULTAN SELIM MAH.,393,349,342,223,119
FATIH,YAVUZ SULTAN SELIM MAH.,393,352,345,231,114
FATIH,YAVUZ SULTAN SELIM MAH.,392,356,351,223,128
FATIH,YAVUZ SULTAN SELIM MAH.,395,351,345,243,102
FATIH,YAVUZ SULTAN SELIM MAH.,406,329,319,228,91
FATIH,YAVUZ SULTAN SELIM MAH.,408,319,313,219,94
FATIH,YAVUZ SULTAN SELIM MAH.,407,355,355,258,97
FATIH,YAVUZ SULTAN SELIM MAH.,410,366,359,256,103
FATIH,YAVUZ SULTAN SELIM MAH.,407,355,352,250,102
FATIH,YAVUZ SULTAN SELIM MAH.,408,356,350,261,89
FATIH,YAVUZ SULTAN SELIM MAH.,407,358,354,252,102
FATIH,YAVUZ SULTAN SELIM MAH.,408,377,374,282,92
FATIH,YAVUZ SULTAN SELIM MAH.,409,378,371,266,105
FATIH,YAVUZ SULTAN SELIM MAH.,406,350,346,252,94
FATIH,YAVUZ SULTAN SELIM MAH.,409,359,356,233,123
FATIH,YAVUZ SULTAN SELIM MAH.,407,367,352,245,107
FATIH,YAVUZ SULTAN SELIM MAH.,407,357,353,247,106
FATIH,YAVUZ SULTAN SELIM MAH.,406,336,332,235,97
FATIH,YAVUZ SULTAN SELIM MAH.,407,346,345,239,106
FATIH,YAVUZ SULTAN SELIM MAH.,407,368,363,239,124
FATIH,YAVUZ SULTAN SELIM MAH.,409,368,366,258,108
FATIH,YAVUZ SULTAN SELIM MAH.,406,363,361,248,113
FATIH,ZEYREK MAH.,391,308,304,221,83
FATIH,ZEYREK MAH.,390,314,301,217,84
FATIH,ZEYREK MAH.,391,353,344,223,121
FATIH,ZEYREK MAH.,393,356,349,225,124
FATIH,ZEYREK MAH.,390,348,343,235,108
FATIH,ZEYREK MAH.,389,355,348,251,97
FATIH,ZEYREK MAH.,390,343,329,240,89
FATIH,ZEYREK MAH.,390,349,345,221,124
FATIH,ZEYREK MAH.,391,353,348,252,96
FATIH,ZEYREK MAH.,389,324,321,216,105
FATIH,ZEYREK MAH.,391,350,344,256,88
FATIH,ZEYREK MAH.,389,347,345,227,118
FATIH,ZEYREK MAH.,390,342,336,246,90
FATIH,ZEYREK MAH.,390,340,336,247,89
FATIH,ZEYREK MAH.,390,357,349,222,127
FATIH,ZEYREK MAH.,398,319,311,208,103
FATIH,ZEYREK MAH.,398,323,317,183,134
FATIH,ZEYREK MAH.,401,354,348,229,119
FATIH,ZEYREK MAH.,398,337,330,199,131
FATIH,ZEYREK MAH.,399,346,341,193,148
FATIH,ZEYREK MAH.,397,338,332,178,154
FATIH,ZEYREK MAH.,399,349,343,221,122
FATIH,ZEYREK MAH.,399,350,344,205,139
FATIH,ZEYREK MAH.,399,349,344,197,147
FATIH,ZEYREK MAH.,399,329,321,187,134
FATIH,ZEYREK MAH.,398,325,322,177,145
FATIH,ALEMDAR MAH.,192,151,149,58,91
FATIH,ATIKALI MAH.,408,328,323,180,143
FATIH,ATIKALI MAH.,408,325,318,191,127
FATIH,ATIKALI MAH.,406,346,340,229,111
FATIH,ATIKALI MAH.,407,382,380,239,141
FATIH,ATIKALI MAH.,407,377,371,276,95
FATIH,ATIKALI MAH.,405,375,368,253,115
FATIH,ATIKALI MAH.,406,360,353,248,105
FATIH,ATIKALI MAH.,406,368,359,297,62
FATIH,ATIKALI MAH.,407,382,378,277,101
FATIH,ATIKALI MAH.,405,380,372,275,97
FATIH,ATIKALI MAH.,405,367,364,279,85
FATIH,ATIKALI MAH.,406,363,356,264,92
FATIH,ATIKALI MAH.,405,359,353,256,97
FATIH,ATIKALI MAH.,406,372,369,267,102
FATIH,ATIKALI MAH.,405,382,376,236,140
FATIH,ATIKALI MAH.,409,334,329,247,82
FATIH,ATIKALI MAH.,405,311,299,216,83
FATIH,ATIKALI MAH.,406,369,368,272,96
FATIH,ATIKALI MAH.,406,368,362,266,96
FATIH,ATIKALI MAH.,407,386,382,307,75
FATIH,ATIKALI MAH.,409,363,361,276,85
FATIH,ATIKALI MAH.,406,366,365,275,90
FATIH,ATIKALI MAH.,405,365,362,281,81
FATIH,ATIKALI MAH.,405,365,359,263,96
FATIH,ATIKALI MAH.,406,369,362,318,44
FATIH,ATIKALI MAH.,407,371,366,299,67
FATIH,BEYAZIT MAH.,58,65,64,37,27
FATIH,CANKURTARAN MAH.,281,251,246,94,152
FATIH,CANKURTARAN MAH.,282,258,255,140,115
FATIH,CANKURTARAN MAH.,281,261,256,117,139
FATIH,DERVIS ALI MAH.,403,321,316,170,146
FATIH,DERVIS ALI MAH.,403,308,300,144,156
FATIH,DERVIS ALI MAH.,402,353,349,201,148
FATIH,DERVIS ALI MAH.,402,333,328,224,104
FATIH,DERVIS ALI MAH.,403,367,359,221,138
FATIH,DERVIS ALI MAH.,402,364,357,178,179
FATIH,DERVIS ALI MAH.,403,360,351,208,143
FATIH,DERVIS ALI MAH.,402,361,351,226,125
FATIH,DERVIS ALI MAH.,403,350,343,216,127
FATIH,DERVIS ALI MAH.,403,362,359,209,150
FATIH,DERVIS ALI MAH.,402,359,354,206,148
FATIH,DERVIS ALI MAH.,403,354,352,214,138
FATIH,DERVIS ALI MAH.,403,376,366,215,151
FATIH,DERVIS ALI MAH.,401,370,365,203,162
FATIH,DERVIS ALI MAH.,406,329,323,220,103
FATIH,DERVIS ALI MAH.,406,309,299,186,113
FATIH,DERVIS ALI MAH.,408,352,347,245,102
FATIH,DERVIS ALI MAH.,405,360,355,235,120
FATIH,DERVIS ALI MAH.,406,358,352,259,93
FATIH,DERVIS ALI MAH.,406,367,362,250,112
FATIH,DERVIS ALI MAH.,407,360,357,253,104
FATIH,DERVIS ALI MAH.,405,371,364,216,148
FATIH,DERVIS ALI MAH.,405,369,363,251,112
FATIH,DERVIS ALI MAH.,405,373,367,271,96
FATIH,DERVIS ALI MAH.,406,353,343,251,92
FATIH,DERVIS ALI MAH.,406,367,360,280,80
FATIH,DERVIS ALI MAH.,406,364,360,272,88
FATIH,DERVIS ALI MAH.,406,353,343,243,100
FATIH,DERVIS ALI MAH.,405,371,366,271,95
FATIH,DERVIS ALI MAH.,408,372,365,254,111
FATIH,DERVIS ALI MAH.,407,369,364,251,113
FATIH,DERVIS ALI MAH.,408,351,347,228,119
FATIH,DERVIS ALI MAH.,406,374,370,264,106
FATIH,DERVIS ALI MAH.,408,365,362,248,114
FATIH,HIRKA-I SERIF MAH.,399,308,303,125,178
FATIH,HIRKA-I SERIF MAH.,398,307,305,147,158
FATIH,HIRKA-I SERIF MAH.,398,325,322,158,164
FATIH,HIRKA-I SERIF MAH.,398,342,338,190,148
FATIH,HIRKA-I SERIF MAH.,398,340,333,197,136
FATIH,HIRKA-I SERIF MAH.,398,342,339,195,144
FATIH,HIRKA-I SERIF MAH.,401,352,348,193,155
FATIH,HIRKA-I SERIF MAH.,397,339,336,181,155
FATIH,HIRKA-I SERIF MAH.,398,352,344,215,129
FATIH,HIRKA-I SERIF MAH.,399,363,359,203,156
FATIH,HIRKA-I SERIF MAH.,398,360,353,214,139
FATIH,HIRKA-I SERIF MAH.,398,358,348,185,163
FATIH,HIRKA-I SERIF MAH.,398,351,345,199,146
FATIH,HIRKA-I SERIF MAH.,401,342,339,200,139
FATIH,HIRKA-I SERIF MAH.,398,348,345,198,147
FATIH,HIRKA-I SERIF MAH.,399,333,330,196,134
FATIH,HIRKA-I SERIF MAH.,398,360,354,221,133
FATIH,HIRKA-I SERIF MAH.,398,357,350,197,153
FATIH,HIRKA-I SERIF MAH.,398,366,359,237,122
FATIH,HIRKA-I SERIF MAH.,399,358,354,213,141
FATIH,HIRKA-I SERIF MAH.,398,352,343,193,150
FATIH,HIRKA-I SERIF MAH.,399,359,353,229,124
FATIH,HIRKA-I SERIF MAH.,399,314,307,175,132
FATIH,HIRKA-I SERIF MAH.,398,313,301,166,135
FATIH,HIRKA-I SERIF MAH.,397,307,305,168,137
FATIH,HIRKA-I SERIF MAH.,396,344,342,210,132
FATIH,HIRKA-I SERIF MAH.,399,359,356,218,138
FATIH,HIRKA-I SERIF MAH.,398,334,332,207,125
FATIH,HIRKA-I SERIF MAH.,397,352,348,221,127
FATIH,HIRKA-I SERIF MAH.,397,361,355,220,135
FATIH,HIRKA-I SERIF MAH.,397,345,343,222,121
FATIH,HIRKA-I SERIF MAH.,398,356,353,202,151
FATIH,HIRKA-I SERIF MAH.,398,338,336,214,122
FATIH,HIRKA-I SERIF MAH.,398,336,330,197,133
FATIH,HIRKA-I SERIF MAH.,398,363,359,224,135
FATIH,HIRKA-I SERIF MAH.,398,352,344,214,130
FATIH,HIRKA-I SERIF MAH.,398,342,340,227,113
FATIH,HIRKA-I SERIF MAH.,398,350,345,205,140
FATIH,HIRKA-I SERIF MAH.,398,350,347,196,151
FATIH,HIRKA-I SERIF MAH.,397,355,348,227,121
FATIH,HIRKA-I SERIF MAH.,398,340,332,202,130
FATIH,HIRKA-I SERIF MAH.,396,345,339,223,116
FATIH,HIRKA-I SERIF MAH.,398,359,356,222,134
FATIH,HOBYAR MAH.,51,61,60,36,24
FATIH,HOCAPASA MAH.,112,107,106,48,58
FATIH,KARAGUMRUK MAH.,411,306,300,159,141
FATIH,KARAGUMRUK MAH.,415,313,305,154,151
FATIH,KARAGUMRUK MAH.,415,326,316,153,163
FATIH,KARAGUMRUK MAH.,415,343,338,232,106
FATIH,KARAGUMRUK MAH.,415,362,357,232,125
FATIH,KARAGUMRUK MAH.,412,351,346,206,140
FATIH,KARAGUMRUK MAH.,415,341,336,203,133
FATIH,KARAGUMRUK MAH.,410,351,349,204,145
FATIH,KARAGUMRUK MAH.,410,326,322,184,138
FATIH,KARAGUMRUK MAH.,412,344,343,221,122
FATIH,KARAGUMRUK MAH.,412,354,352,225,127
FATIH,KARAGUMRUK MAH.,412,347,341,206,135
FATIH,KARAGUMRUK MAH.,412,326,319,204,115
FATIH,KARAGUMRUK MAH.,412,341,333,211,122
FATIH,KARAGUMRUK MAH.,411,346,341,220,121
FATIH,KARAGUMRUK MAH.,412,346,345,195,150
FATIH,KARAGUMRUK MAH.,412,348,341,213,128
FATIH,KARAGUMRUK MAH.,410,344,338,222,116
FATIH,KARAGUMRUK MAH.,411,330,324,188,136
FATIH,MEVLANAKAPI MAH.,409,331,330,134,196
FATIH,MEVLANAKAPI MAH.,409,324,320,157,163
FATIH,MEVLANAKAPI MAH.,406,328,321,123,198
FATIH,MEVLANAKAPI MAH.,406,361,358,191,167
FATIH,MEVLANAKAPI MAH.,407,362,361,155,206
FATIH,MEVLANAKAPI MAH.,408,340,335,142,193
FATIH,MEVLANAKAPI MAH.,406,356,349,159,190
FATIH,MEVLANAKAPI MAH.,405,350,344,141,203
FATIH,MEVLANAKAPI MAH.,406,360,356,121,235
FATIH,MEVLANAKAPI MAH.,406,372,368,146,222
FATIH,MEVLANAKAPI MAH.,405,361,360,166,194
FATIH,MEVLANAKAPI MAH.,405,359,355,165,190
FATIH,MEVLANAKAPI MAH.,406,368,367,178,189
FATIH,MEVLANAKAPI MAH.,406,356,354,153,201
FATIH,MEVLANAKAPI MAH.,406,355,352,164,188
FATIH,MEVLANAKAPI MAH.,405,348,344,147,197
FATIH,MEVLANAKAPI MAH.,406,366,360,142,218
FATIH,MEVLANAKAPI MAH.,405,363,358,145,213
FATIH,MEVLANAKAPI MAH.,406,355,346,149,197
FATIH,MEVLANAKAPI MAH.,405,354,349,171,178
FATIH,MEVLANAKAPI MAH.,405,355,348,165,183
FATIH,MEVLANAKAPI MAH.,397,316,312,161,151
FATIH,MEVLANAKAPI MAH.,397,312,307,124,183
FATIH,MEVLANAKAPI MAH.,396,339,335,174,161
FATIH,MEVLANAKAPI MAH.,397,346,339,147,192
FATIH,MEVLANAKAPI MAH.,397,349,345,156,189
FATIH,MEVLANAKAPI MAH.,397,362,358,179,179
FATIH,MEVLANAKAPI MAH.,396,353,348,184,164
FATIH,MEVLANAKAPI MAH.,398,371,368,209,159
FATIH,MEVLANAKAPI MAH.,397,328,326,164,162
FATIH,MEVLANAKAPI MAH.,396,352,351,188,163
FATIH,MEVLANAKAPI MAH.,396,345,343,157,186
FATIH,MEVLANAKAPI MAH.,397,346,342,155,187
FATIH,MEVLANAKAPI MAH.,399,352,349,161,188
FATIH,MEVLANAKAPI MAH.,399,347,345,162,183
FATIH,MEVLANAKAPI MAH.,396,338,335,148,187
FATIH,MEVLANAKAPI MAH.,396,351,347,170,177
FATIH,MOLLA FENARI MAH.,58,59,58,43,15
FATIH,MOLLA GURANI MAH.,404,324,322,123,199
FATIH,MOLLA GURANI MAH.,404,321,316,83,233
FATIH,MOLLA GURANI MAH.,405,350,343,115,228
FATIH,MOLLA GURANI MAH.,407,360,354,115,239
FATIH,MOLLA GURANI MAH.,405,353,352,142,210
FATIH,MOLLA GURANI MAH.,404,354,353,118,235
FATIH,MOLLA GURANI MAH.,405,342,338,94,244
FATIH,MOLLA GURANI MAH.,404,361,360,125,235
FATIH,MOLLA GURANI MAH.,404,346,343,125,218
FATIH,MOLLA GURANI MAH.,415,321,313,112,201
FATIH,MOLLA GURANI MAH.,415,314,310,100,210
FATIH,MOLLA GURANI MAH.,415,324,309,107,202
FATIH,MOLLA GURANI MAH.,415,351,350,142,208
FATIH,MOLLA GURANI MAH.,412,329,324,125,199
FATIH,MOLLA GURANI MAH.,413,350,344,157,187
FATIH,MOLLA GURANI MAH.,415,343,340,156,184
FATIH,MOLLA GURANI MAH.,412,342,340,159,181
FATIH,MOLLA GURANI MAH.,415,340,339,129,210
FATIH,MOLLA GURANI MAH.,412,350,349,149,200
FATIH,MOLLA GURANI MAH.,415,350,346,127,219
FATIH,MOLLA GURANI MAH.,412,346,338,154,184
FATIH,MOLLA GURANI MAH.,412,347,345,144,201
FATIH,MOLLA GURANI MAH.,412,349,340,127,213
FATIH,MOLLA GURANI MAH.,412,343,340,142,198
FATIH,RUSTEMPASA MAH.,19,28,28,24,4
FATIH,SULTAN AHMET MAH.,289,259,257,129,128
FATIH,SULTAN AHMET MAH.,291,247,246,145,101
FATIH,SURURI MAH.,26,38,38,28,10
FATIH,SEHREMINI MAH.,401,320,305,105,200
FATIH,SEHREMINI MAH.,399,289,277,84,193
FATIH,SEHREMINI MAH.,401,309,296,101,195
FATIH,SEHREMINI MAH.,399,355,352,122,230
FATIH,SEHREMINI MAH.,399,363,357,127,230
FATIH,SEHREMINI MAH.,400,377,369,153,216
FATIH,SEHREMINI MAH.,401,337,330,121,209
FATIH,SEHREMINI MAH.,399,362,358,128,230
FATIH,SEHREMINI MAH.,398,333,326,112,214
FATIH,SEHREMINI MAH.,399,345,342,123,219
FATIH,SEHREMINI MAH.,399,358,355,104,251
FATIH,SEHREMINI MAH.,399,359,357,135,222
FATIH,SEHREMINI MAH.,399,349,343,148,195
FATIH,SEHREMINI MAH.,399,348,340,129,211
FATIH,SEHREMINI MAH.,398,345,343,122,221
FATIH,SEHREMINI MAH.,401,348,347,126,221
FATIH,SEHREMINI MAH.,399,323,319,117,202
FATIH,SEHREMINI MAH.,399,360,355,138,217
FATIH,SEHREMINI MAH.,415,333,328,117,211
FATIH,SEHREMINI MAH.,415,330,326,106,220
FATIH,SEHREMINI MAH.,415,312,304,87,217
FATIH,SEHREMINI MAH.,412,308,300,74,226
FATIH,SEHREMINI MAH.,412,356,355,100,255
FATIH,SEHREMINI MAH.,411,379,375,108,267
FATIH,SEHREMINI MAH.,412,381,381,123,258
FATIH,SEHREMINI MAH.,411,365,359,113,246
FATIH,SEHREMINI MAH.,412,361,358,110,248
FATIH,SEHREMINI MAH.,415,367,363,113,250
FATIH,SEHREMINI MAH.,413,356,354,125,229
FATIH,SEHREMINI MAH.,412,359,358,102,256
FATIH,SEHREMINI MAH.,412,360,354,113,241
FATIH,SEHREMINI MAH.,411,357,352,107,245
FATIH,SEHREMINI MAH.,411,375,374,137,237
FATIH,SEHREMINI MAH.,412,362,357,105,252
FATIH,SEHREMINI MAH.,412,370,368,120,248
FATIH,SEHREMINI MAH.,411,378,375,127,248
FATIH,SEHREMINI MAH.,411,361,358,129,229
FATIH,SEHREMINI MAH.,412,376,374,116,258
FATIH,SEHREMINI MAH.,411,359,354,102,252
FATIH,SEHREMINI MAH.,412,352,345,86,259
FATIH,SEHREMINI MAH.,412,369,364,101,263
FATIH,TAHTAKALE MAH.,18,30,28,21,7
FATIH,TAYA HATUN MAH.,88,67,67,34,33
FATIH,TOPKAPI MAH.,380,309,300,103,197
FATIH,TOPKAPI MAH.,381,323,318,108,210
FATIH,TOPKAPI MAH.,381,343,337,132,205
FATIH,TOPKAPI MAH.,383,326,321,113,208
FATIH,TOPKAPI MAH.,381,335,335,79,256
FATIH,TOPKAPI MAH.,380,334,333,102,231
FATIH,TOPKAPI MAH.,381,339,335,126,209
FATIH,TOPKAPI MAH.,380,342,332,119,213
FATIH,TOPKAPI MAH.,379,338,332,117,215
FATIH,TOPKAPI MAH.,381,346,343,143,200
FATIH,TOPKAPI MAH.,406,312,306,126,180
FATIH,TOPKAPI MAH.,405,335,332,130,202
FATIH,TOPKAPI MAH.,406,338,336,146,190
FATIH,TOPKAPI MAH.,405,344,341,148,193
FATIH,TOPKAPI MAH.,404,347,342,164,178
FATIH,TOPKAPI MAH.,404,339,331,163,168
FATIH,TOPKAPI MAH.,404,359,352,180,172
FATIH,TOPKAPI MAH.,405,332,328,143,185
FATIH,TOPKAPI MAH.,405,341,335,158,177
FATIH,AKSARAY MAH.,396,309,304,124,180
FATIH,AKSARAY MAH.,394,295,289,102,187
FATIH,AKSARAY MAH.,394,315,310,139,171
FATIH,AKSARAY MAH.,394,324,322,136,186
FATIH,AKSARAY MAH.,394,321,313,139,174
FATIH,AKSARAY MAH.,394,323,320,115,205
FATIH,AKSARAY MAH.,394,321,311,109,202
FATIH,AKSARAY MAH.,393,312,306,126,180
FATIH,AKSARAY MAH.,394,335,332,102,230
FATIH,AKSARAY MAH.,394,315,313,123,190
FATIH,AKSARAY MAH.,394,328,322,140,182
FATIH,AKSARAY MAH.,394,296,295,119,176
FATIH,AKSARAY MAH.,393,305,305,112,193
FATIH,AKSARAY MAH.,394,323,320,130,190
FATIH,AKSARAY MAH.,395,326,319,124,195
FATIH,AKSARAY MAH.,394,321,315,112,203
FATIH,AKSARAY MAH.,394,336,328,133,195
FATIH,BALABANAGA MAH.,68,125,121,63,58
FATIH,CERRAHPASA MAH.,373,287,280,102,178
FATIH,CERRAHPASA MAH.,374,306,301,102,199
FATIH,CERRAHPASA MAH.,373,322,319,109,210
FATIH,CERRAHPASA MAH.,374,345,341,123,218
FATIH,CERRAHPASA MAH.,373,316,311,82,229
FATIH,CERRAHPASA MAH.,373,299,297,110,187
FATIH,CERRAHPASA MAH.,375,319,312,102,210
FATIH,CERRAHPASA MAH.,403,325,316,131,185
FATIH,CERRAHPASA MAH.,399,319,312,124,188
FATIH,CERRAHPASA MAH.,399,344,339,137,202
FATIH,CERRAHPASA MAH.,401,356,348,141,207
FATIH,CERRAHPASA MAH.,401,356,349,140,209
FATIH,CERRAHPASA MAH.,401,353,347,123,224
FATIH,CERRAHPASA MAH.,401,342,339,122,217
FATIH,CERRAHPASA MAH.,401,342,338,115,223
FATIH,CERRAHPASA MAH.,401,348,346,127,219
FATIH,CERRAHPASA MAH.,400,342,334,125,209
FATIH,DEMIRTAS MAH.,173,162,159,98,61
FATIH,HACI KADIN MAH.,283,232,225,137,88
FATIH,HASEKI SULTAN MAH.,405,311,303,104,199
FATIH,HASEKI SULTAN MAH.,404,322,313,99,214
FATIH,HASEKI SULTAN MAH.,404,343,333,132,201
FATIH,HASEKI SULTAN MAH.,404,350,344,129,215
FATIH,HASEKI SULTAN MAH.,405,331,329,118,211
FATIH,HASEKI SULTAN MAH.,405,351,347,125,222
FATIH,HASEKI SULTAN MAH.,403,346,345,149,196
FATIH,HASEKI SULTAN MAH.,405,355,346,152,194
FATIH,HASEKI SULTAN MAH.,406,364,357,160,197
FATIH,HASEKI SULTAN MAH.,396,319,317,95,222
FATIH,HASEKI SULTAN MAH.,395,306,301,120,181
FATIH,HASEKI SULTAN MAH.,394,344,339,118,221
FATIH,HASEKI SULTAN MAH.,395,328,325,116,209
FATIH,HASEKI SULTAN MAH.,393,328,325,106,219
FATIH,HASEKI SULTAN MAH.,395,349,347,101,246
FATIH,HASEKI SULTAN MAH.,394,328,327,105,222
FATIH,HASEKI SULTAN MAH.,395,334,332,114,218
FATIH,HASEKI SULTAN MAH.,394,349,343,103,240
FATIH,HOCA GIYASETTIN MAH.,265,214,208,99,109
FATIH,HOCA GIYASETTIN MAH.,265,209,208,102,106
FATIH,KALENDERHANE MAH.,368,326,321,94,227
FATIH,KEMALPASA MAH.,231,221,220,118,102
FATIH,KOCA MUSTAFAPASA MAH.,415,296,291,96,195
FATIH,KOCA MUSTAFAPASA MAH.,415,297,281,111,170
FATIH,KOCA MUSTAFAPASA MAH.,415,287,285,83,202
FATIH,KOCA MUSTAFAPASA MAH.,415,295,291,75,216
FATIH,KOCA MUSTAFAPASA MAH.,412,349,345,124,221
FATIH,KOCA MUSTAFAPASA MAH.,415,341,337,89,248
FATIH,KOCA MUSTAFAPASA MAH.,412,349,342,122,220
FATIH,KOCA MUSTAFAPASA MAH.,412,369,366,115,251
FATIH,KOCA MUSTAFAPASA MAH.,412,351,348,107,241
FATIH,KOCA MUSTAFAPASA MAH.,415,350,344,105,239
FATIH,KOCA MUSTAFAPASA MAH.,415,360,354,128,226
FATIH,KOCA MUSTAFAPASA MAH.,415,354,351,113,238
FATIH,KOCA MUSTAFAPASA MAH.,415,362,353,112,241
FATIH,KOCA MUSTAFAPASA MAH.,412,351,347,122,225
FATIH,KOCA MUSTAFAPASA MAH.,415,352,346,128,218
FATIH,KOCA MUSTAFAPASA MAH.,412,362,357,104,253
FATIH,KOCA MUSTAFAPASA MAH.,415,380,375,110,265
FATIH,KOCA MUSTAFAPASA MAH.,415,365,361,104,257
FATIH,KOCA MUSTAFAPASA MAH.,415,350,342,99,243
FATIH,KOCA MUSTAFAPASA MAH.,415,359,354,127,227
FATIH,KOCA MUSTAFAPASA MAH.,412,345,339,132,207
FATIH,KOCA MUSTAFAPASA MAH.,412,357,356,107,249
FATIH,KOCA MUSTAFAPASA MAH.,414,358,353,112,241
FATIH,KOCA MUSTAFAPASA MAH.,414,341,337,106,231
FATIH,KOCA MUSTAFAPASA MAH.,411,370,365,125,240
FATIH,KOCA MUSTAFAPASA MAH.,410,319,313,112,201
FATIH,KOCA MUSTAFAPASA MAH.,411,296,284,108,176
FATIH,KOCA MUSTAFAPASA MAH.,411,332,323,109,214
FATIH,KOCA MUSTAFAPASA MAH.,410,355,348,132,216
FATIH,KOCA MUSTAFAPASA MAH.,411,354,352,148,204
FATIH,KOCA MUSTAFAPASA MAH.,410,359,351,145,206
FATIH,KOCA MUSTAFAPASA MAH.,410,346,341,132,209
FATIH,KOCA MUSTAFAPASA MAH.,411,353,347,126,221
FATIH,KOCA MUSTAFAPASA MAH.,411,345,336,144,192
FATIH,KOCA MUSTAFAPASA MAH.,411,329,325,117,208
FATIH,KOCA MUSTAFAPASA MAH.,410,350,346,133,213
FATIH,KOCA MUSTAFAPASA MAH.,410,345,342,120,222
FATIH,KOCA MUSTAFAPASA MAH.,411,363,356,139,217
FATIH,KOCA MUSTAFAPASA MAH.,412,354,346,170,176
FATIH,MERCAN MAH.,38,57,57,42,15
FATIH,MOLLA HUSREV MAH.,329,281,276,201,75
FATIH,MOLLA HUSREV MAH.,329,274,268,145,123
FATIH,SARIDEMIR MAH.,12,200,190,149,41
FATIH,SEYYID OMER MAH.,401,314,303,127,176
FATIH,SEYYID OMER MAH.,405,318,312,128,184
FATIH,SEYYID OMER MAH.,401,331,325,137,188
FATIH,SEYYID OMER MAH.,402,343,338,130,208
FATIH,SEYYID OMER MAH.,401,353,348,148,200
FATIH,SEYYID OMER MAH.,401,348,345,136,209
FATIH,SEYYID OMER MAH.,401,350,348,157,191
FATIH,SEYYID OMER MAH.,401,353,349,150,199
FATIH,SEYYID OMER MAH.,402,357,348,137,211
FATIH,SEYYID OMER MAH.,400,343,335,153,182
FATIH,SEYYID OMER MAH.,403,358,354,149,205
FATIH,SEYYID OMER MAH.,401,355,353,150,203
FATIH,SEYYID OMER MAH.,401,350,344,148,196
FATIH,SEYYID OMER MAH.,401,345,340,171,169
FATIH,SEYYID OMER MAH.,402,353,347,132,215
FATIH,SEYYID OMER MAH.,401,347,345,130,215
FATIH,SEYYID OMER MAH.,400,357,356,144,212
FATIH,SEYYID OMER MAH.,404,339,330,135,195
FATIH,SEYYID OMER MAH.,408,324,319,117,202
FATIH,SEYYID OMER MAH.,408,338,334,136,198
FATIH,SEYYID OMER MAH.,408,325,318,102,216
FATIH,SEYYID OMER MAH.,408,309,304,130,174
FATIH,SEYYID OMER MAH.,407,310,307,131,176
FATIH,SEYYID OMER MAH.,410,369,364,131,233
FATIH,SEYYID OMER MAH.,408,359,357,120,237
FATIH,SEYYID OMER MAH.,409,359,353,132,221
FATIH,SEYYID OMER MAH.,408,377,371,146,225
FATIH,SEYYID OMER MAH.,407,362,356,127,229
FATIH,SEYYID OMER MAH.,410,364,359,146,213
FATIH,SEYYID OMER MAH.,408,363,356,171,185
FATIH,SEYYID OMER MAH.,408,359,355,141,214
FATIH,SEYYID OMER MAH.,408,355,350,131,219
FATIH,SEYYID OMER MAH.,411,372,368,139,229
FATIH,SEYYID OMER MAH.,408,364,363,130,233
FATIH,SEYYID OMER MAH.,408,357,355,147,208
FATIH,SEYYID OMER MAH.,408,371,362,144,218
FATIH,SEYYID OMER MAH.,408,369,361,139,222
FATIH,SEYYID OMER MAH.,408,354,349,131,218
FATIH,SEYYID OMER MAH.,408,373,368,123,245
FATIH,SEYYID OMER MAH.,409,359,353,161,192
FATIH,SEYYID OMER MAH.,409,362,359,145,214
FATIH,SEYYID OMER MAH.,408,365,359,146,213
FATIH,SEYYID OMER MAH.,408,367,367,122,245
FATIH,SEYYID OMER MAH.,408,365,360,126,234
FATIH,SEYYID OMER MAH.,407,360,356,116,240
FATIH,SEYYID OMER MAH.,408,361,355,122,233
FATIH,SEYYID OMER MAH.,408,371,362,125,237
FATIH,SEYYID OMER MAH.,408,371,364,138,226
FATIH,SILIVRIKAPI MAH.,411,313,307,118,189
FATIH,SILIVRIKAPI MAH.,409,307,297,123,174
FATIH,SILIVRIKAPI MAH.,409,335,325,137,188
FATIH,SILIVRIKAPI MAH.,409,343,336,117,219
FATIH,SILIVRIKAPI MAH.,409,368,364,111,253
FATIH,SILIVRIKAPI MAH.,409,354,348,107,241
FATIH,SILIVRIKAPI MAH.,409,363,357,127,230
FATIH,SILIVRIKAPI MAH.,409,341,336,131,205
FATIH,SILIVRIKAPI MAH.,410,373,370,128,242
FATIH,SILIVRIKAPI MAH.,410,373,369,141,228
FATIH,SILIVRIKAPI MAH.,411,358,354,138,216
FATIH,SILIVRIKAPI MAH.,409,355,351,119,232
FATIH,SILIVRIKAPI MAH.,409,378,369,164,205
FATIH,SILIVRIKAPI MAH.,408,357,354,113,241
FATIH,SILIVRIKAPI MAH.,408,340,337,127,210
FATIH,SILIVRIKAPI MAH.,408,373,365,111,254
FATIH,SILIVRIKAPI MAH.,408,367,362,132,230
FATIH,SILIVRIKAPI MAH.,409,342,337,146,191
FATIH,SILIVRIKAPI MAH.,398,303,293,125,168
FATIH,SILIVRIKAPI MAH.,398,322,312,147,165
FATIH,SILIVRIKAPI MAH.,399,357,353,156,197
FATIH,SILIVRIKAPI MAH.,400,344,340,171,169
FATIH,SILIVRIKAPI MAH.,398,361,354,143,211
FATIH,SILIVRIKAPI MAH.,399,339,337,159,178
FATIH,SILIVRIKAPI MAH.,399,361,356,149,207
FATIH,SILIVRIKAPI MAH.,399,353,348,137,211
FATIH,SILIVRIKAPI MAH.,398,335,330,146,184
FATIH,SILIVRIKAPI MAH.,398,364,355,137,218
FATIH,SILIVRIKAPI MAH.,398,357,356,145,211
FATIH,SILIVRIKAPI MAH.,399,350,348,163,185
FATIH,SILIVRIKAPI MAH.,399,363,359,159,200
FATIH,SILIVRIKAPI MAH.,399,348,345,175,170
FATIH,SULEYMANIYE MAH.,371,320,317,190,127
FATIH,SUMBUL EFENDI MAH.,398,303,294,138,156
FATIH,SUMBUL EFENDI MAH.,398,348,339,153,186
FATIH,SUMBUL EFENDI MAH.,398,357,356,162,194
FATIH,SUMBUL EFENDI MAH.,399,362,361,190,171
FATIH,SUMBUL EFENDI MAH.,398,362,359,155,204
FATIH,SUMBUL EFENDI MAH.,401,369,355,155,200
FATIH,SUMBUL EFENDI MAH.,398,344,344,149,195
FATIH,SUMBUL EFENDI MAH.,398,352,345,146,199
FATIH,SUMBUL EFENDI MAH.,398,344,341,161,180
FATIH,SUMBUL EFENDI MAH.,397,354,351,164,187
FATIH,SUMBUL EFENDI MAH.,398,369,365,163,202
FATIH,SUMBUL EFENDI MAH.,397,366,362,180,182
FATIH,SUMBUL EFENDI MAH.,397,338,334,161,173
FATIH,SUMBUL EFENDI MAH.,398,367,362,152,210
FATIH,SUMBUL EFENDI MAH.,405,323,311,147,164
FATIH,SUMBUL EFENDI MAH.,405,305,298,139,159
FATIH,SUMBUL EFENDI MAH.,405,341,332,159,173
FATIH,SUMBUL EFENDI MAH.,406,364,357,210,147
FATIH,SUMBUL EFENDI MAH.,405,344,340,173,167
FATIH,SUMBUL EFENDI MAH.,405,341,337,192,145
FATIH,SUMBUL EFENDI MAH.,405,349,345,174,171
FATIH,SUMBUL EFENDI MAH.,405,356,352,166,186
FATIH,SUMBUL EFENDI MAH.,407,350,345,166,179
FATIH,SUMBUL EFENDI MAH.,405,345,342,175,167
FATIH,SUMBUL EFENDI MAH.,404,340,331,176,155
FATIH,SUMBUL EFENDI MAH.,405,353,347,154,193
FATIH,SUMBUL EFENDI MAH.,404,336,330,173,157
FATIH,SUMBUL EFENDI MAH.,405,330,327,160,167
FATIH,SUMBUL EFENDI MAH.,407,344,340,183,157
FATIH,SUMBUL EFENDI MAH.,404,358,353,186,167
FATIH,SUMBUL EFENDI MAH.,404,350,346,185,161
FATIH,SUMBUL EFENDI MAH.,404,362,352,188,164
FATIH,YAVUZ SINAN MAH.,217,175,174,112,62
FATIH,YEDIKULE MAH.,383,303,299,117,182
FATIH,YEDIKULE MAH.,385,316,301,135,166
FATIH,YEDIKULE MAH.,384,330,321,139,182
FATIH,YEDIKULE MAH.,384,313,309,118,191
FATIH,YEDIKULE MAH.,383,317,311,113,198
FATIH,YEDIKULE MAH.,384,335,329,131,198
FATIH,YEDIKULE MAH.,383,322,320,140,180
FATIH,YEDIKULE MAH.,383,313,309,136,173
FATIH,YEDIKULE MAH.,384,321,317,115,202
FATIH,YEDIKULE MAH.,383,322,315,153,162
FATIH,YEDIKULE MAH.,385,314,304,159,145
FATIH,YEDIKULE MAH.,387,338,335,147,188
FATIH,YEDIKULE MAH.,395,308,298,136,162
FATIH,YEDIKULE MAH.,396,311,306,104,202
FATIH,YEDIKULE MAH.,395,316,307,114,193
FATIH,YEDIKULE MAH.,398,355,350,155,195
FATIH,YEDIKULE MAH.,396,340,336,142,194
FATIH,YEDIKULE MAH.,396,353,347,169,178
FATIH,YEDIKULE MAH.,395,358,346,151,195
FATIH,YEDIKULE MAH.,395,352,344,170,174
FATIH,YEDIKULE MAH.,394,350,342,165,177
FATIH,YEDIKULE MAH.,394,349,348,170,178
FATIH,YEDIKULE MAH.,395,352,340,170,170
FATIH,YEDIKULE MAH.,395,346,338,173,165
FATIH,YEDIKULE MAH.,394,335,330,177,153
FATIH,YEDIKULE MAH.,394,350,346,138,208
FATIH,YEDIKULE MAH.,394,347,339,151,188
FATIH,YEDIKULE MAH.,394,339,331,156,175
FATIH,YEDIKULE MAH.,394,350,346,168,178
FATIH,YEDIKULE MAH.,395,358,354,189,165
FATIH,YEDIKULE MAH.,395,349,341,148,193
FATIH,YEDIKULE MAH.,394,350,344,162,182
ADALAR,BURGAZADA MAH.,316,240,235,25,210
ADALAR,BURGAZADA MAH.,314,267,263,49,214
ADALAR,BURGAZADA MAH.,313,271,267,50,217
ADALAR,BURGAZADA MAH.,314,277,271,50,221
ADALAR,HEYBELIADA MAH.,317,266,262,71,191
ADALAR,HEYBELIADA MAH.,317,289,283,69,214
ADALAR,HEYBELIADA MAH.,317,285,281,71,210
ADALAR,HEYBELIADA MAH.,315,288,284,78,206
ADALAR,HEYBELIADA MAH.,339,269,264,52,212
ADALAR,HEYBELIADA MAH.,339,301,298,99,199
ADALAR,HEYBELIADA MAH.,339,299,297,92,205
ADALAR,HEYBELIADA MAH.,338,281,271,85,186
ADALAR,HEYBELIADA MAH.,339,312,307,76,231
ADALAR,KINALIADA MAH.,388,278,271,83,188
ADALAR,KINALIADA MAH.,389,319,316,80,236
ADALAR,KINALIADA MAH.,387,327,324,86,238
ADALAR,KINALIADA MAH.,241,187,187,35,152
ADALAR,KINALIADA MAH.,243,219,217,63,154
ADALAR,MADEN MAH.,330,280,276,87,189
ADALAR,MADEN MAH.,330,277,276,80,196
ADALAR,MADEN MAH.,330,298,293,113,180
ADALAR,MADEN MAH.,368,309,309,59,250
ADALAR,MADEN MAH.,368,329,328,90,238
ADALAR,MADEN MAH.,367,322,316,81,235
ADALAR,MADEN MAH.,307,269,266,60,206
ADALAR,MADEN MAH.,310,273,272,83,189
ADALAR,MADEN MAH.,405,357,354,101,253
ADALAR,MADEN MAH.,407,365,360,111,249
ADALAR,NIZAM MAH.,359,301,300,74,226
ADALAR,NIZAM MAH.,359,288,287,83,204
ADALAR,NIZAM MAH.,359,310,307,90,217
ADALAR,NIZAM MAH.,358,310,307,90,217
ADALAR,NIZAM MAH.,358,300,297,81,216
ADALAR,NIZAM MAH.,358,304,299,84,215
ADALAR,NIZAM MAH.,358,310,303,65,238
BEYKOZ,ACARLAR MAH.,389,349,343,44,299
BEYKOZ,ACARLAR MAH.,390,352,350,58,292
BEYKOZ,ACARLAR MAH.,391,352,346,40,306
BEYKOZ,ACARLAR MAH.,390,360,357,45,312
BEYKOZ,ACARLAR MAH.,390,367,359,56,303
BEYKOZ,ACARLAR MAH.,389,360,358,43,315
BEYKOZ,ACARLAR MAH.,390,351,348,54,294
BEYKOZ,ACARLAR MAH.,389,360,359,38,321
BEYKOZ,ACARLAR MAH.,389,367,365,44,321
BEYKOZ,ACARLAR MAH.,390,357,357,44,313
BEYKOZ,ACARLAR MAH.,390,362,360,45,315
BEYKOZ,ACARLAR MAH.,391,359,357,39,318
BEYKOZ,ACARLAR MAH.,389,344,341,35,306
BEYKOZ,AKBABA MAH.,409,362,356,184,172
BEYKOZ,AKBABA MAH.,408,384,381,224,157
BEYKOZ,AKBABA MAH.,407,365,359,205,154
BEYKOZ,AKBABA MAH.,408,382,378,222,156
BEYKOZ,AKBABA MAH.,410,379,374,218,156
BEYKOZ,ALIBAHADIR MAH.,285,264,259,171,88
BEYKOZ,ALIBAHADIR MAH.,284,258,253,158,95
BEYKOZ,ANADOLU HISARI MAH.,402,334,327,84,243
BEYKOZ,ANADOLU HISARI MAH.,403,373,371,72,299
BEYKOZ,ANADOLU HISARI MAH.,402,372,371,111,260
BEYKOZ,ANADOLU HISARI MAH.,402,353,347,116,231
BEYKOZ,ANADOLU HISARI MAH.,402,364,363,95,268
BEYKOZ,ANADOLU KAVAGI MAH.,326,272,271,100,171
BEYKOZ,ANADOLU KAVAGI MAH.,321,294,291,114,177
BEYKOZ,ANADOLU KAVAGI MAH.,321,293,286,114,172
BEYKOZ,ANADOLUFENERI MAH.,267,240,234,151,83
BEYKOZ,ANADOLUFENERI MAH.,267,245,241,142,99
BEYKOZ,BAKLACI MAH.,352,306,300,230,70
BEYKOZ,BAKLACI MAH.,350,312,310,252,58
BEYKOZ,BAKLACI MAH.,350,326,322,246,76
BEYKOZ,BAKLACI MAH.,352,317,312,243,69
BEYKOZ,BAKLACI MAH.,351,311,304,237,67
BEYKOZ,BAKLACI MAH.,349,322,316,247,69
BEYKOZ,BOZHANE MAH.,383,357,353,190,163
BEYKOZ,CUMHURIYET MAH.,335,287,283,182,101
BEYKOZ,CUMHURIYET MAH.,337,312,305,229,76
BEYKOZ,CUMHURIYET MAH.,335,295,288,222,66
BEYKOZ,CUMHURIYET MAH.,335,315,310,232,78
BEYKOZ,CAMLIBAHCE MAH.,406,346,341,162,179
BEYKOZ,CAMLIBAHCE MAH.,405,350,344,153,191
BEYKOZ,CAMLIBAHCE MAH.,406,358,354,191,163
BEYKOZ,CAMLIBAHCE MAH.,406,382,379,204,175
BEYKOZ,CAMLIBAHCE MAH.,405,360,352,188,164
BEYKOZ,CAMLIBAHCE MAH.,405,370,362,194,168
BEYKOZ,CAMLIBAHCE MAH.,405,363,360,195,165
BEYKOZ,CAMLIBAHCE MAH.,406,360,350,183,167
BEYKOZ,CAMLIBAHCE MAH.,406,361,357,177,180
BEYKOZ,CAMLIBAHCE MAH.,405,380,377,183,194
BEYKOZ,CAMLIBAHCE MAH.,406,355,348,171,177
BEYKOZ,CAMLIBAHCE MAH.,405,365,360,191,169
BEYKOZ,CENGELDERE MAH.,395,364,357,267,90
BEYKOZ,CENGELDERE MAH.,395,366,362,284,78
BEYKOZ,CENGELDERE MAH.,395,367,365,289,76
BEYKOZ,CENGELDERE MAH.,395,362,358,268,90
BEYKOZ,CENGELDERE MAH.,397,366,365,270,95
BEYKOZ,CENGELDERE MAH.,395,359,357,279,78
BEYKOZ,CENGELDERE MAH.,395,360,356,283,73
BEYKOZ,CENGELDERE MAH.,397,364,353,264,89
BEYKOZ,CENGELDERE MAH.,395,361,359,267,92
BEYKOZ,CIFTLIK MAH.,377,333,325,264,61
BEYKOZ,CIFTLIK MAH.,375,346,343,284,59
BEYKOZ,CIFTLIK MAH.,376,357,353,289,64
BEYKOZ,CIFTLIK MAH.,375,350,345,259,86
BEYKOZ,CIFTLIK MAH.,375,347,343,273,70
BEYKOZ,CIFTLIK MAH.,376,338,336,267,69
BEYKOZ,CIFTLIK MAH.,376,333,331,266,65
BEYKOZ,CIFTLIK MAH.,376,345,338,270,68
BEYKOZ,CIFTLIK MAH.,375,347,341,274,67
BEYKOZ,CIFTLIK MAH.,376,345,335,265,70
BEYKOZ,CIGDEM MAH.,399,341,332,159,173
BEYKOZ,CIGDEM MAH.,398,328,321,180,141
BEYKOZ,CIGDEM MAH.,399,316,304,143,161
BEYKOZ,CIGDEM MAH.,398,364,357,196,161
BEYKOZ,CIGDEM MAH.,398,353,346,167,179
BEYKOZ,CIGDEM MAH.,399,358,350,171,179
BEYKOZ,CIGDEM MAH.,397,362,360,205,155
BEYKOZ,CIGDEM MAH.,398,355,347,173,174
BEYKOZ,CIGDEM MAH.,398,358,352,190,162
BEYKOZ,CIGDEM MAH.,401,357,350,174,176
BEYKOZ,CIGDEM MAH.,397,369,362,170,192
BEYKOZ,CIGDEM MAH.,398,348,345,182,163
BEYKOZ,CIGDEM MAH.,397,363,361,172,189
BEYKOZ,CIGDEM MAH.,397,355,349,161,188
BEYKOZ,CIGDEM MAH.,398,347,336,153,183
BEYKOZ,CIGDEM MAH.,397,363,358,174,184
BEYKOZ,CIGDEM MAH.,400,371,364,171,193
BEYKOZ,CIGDEM MAH.,397,364,359,169,190
BEYKOZ,CIGDEM MAH.,398,354,348,155,193
BEYKOZ,CIGDEM MAH.,398,354,353,185,168
BEYKOZ,CIGDEM MAH.,397,348,346,160,186
BEYKOZ,CIGDEM MAH.,398,358,354,178,176
BEYKOZ,CIGDEM MAH.,397,361,355,182,173
BEYKOZ,CUBUKLU MAH.,415,352,344,210,134
BEYKOZ,CUBUKLU MAH.,415,343,336,209,127
BEYKOZ,CUBUKLU MAH.,415,355,349,213,136
BEYKOZ,CUBUKLU MAH.,414,373,367,197,170
BEYKOZ,CUBUKLU MAH.,415,377,375,213,162
BEYKOZ,CUBUKLU MAH.,415,377,373,213,160
BEYKOZ,CUBUKLU MAH.,414,363,357,199,158
BEYKOZ,CUBUKLU MAH.,414,372,368,215,153
BEYKOZ,CUBUKLU MAH.,414,372,371,213,158
BEYKOZ,CUBUKLU MAH.,415,377,373,178,195
BEYKOZ,CUBUKLU MAH.,415,380,373,172,201
BEYKOZ,CUBUKLU MAH.,414,375,368,212,156
BEYKOZ,CUBUKLU MAH.,415,368,359,218,141
BEYKOZ,CUBUKLU MAH.,415,385,379,246,133
BEYKOZ,CUBUKLU MAH.,415,363,357,188,169
BEYKOZ,CUBUKLU MAH.,414,368,364,208,156
BEYKOZ,CUBUKLU MAH.,414,375,371,212,159
BEYKOZ,CUBUKLU MAH.,415,376,369,207,162
BEYKOZ,CUBUKLU MAH.,414,382,372,213,159
BEYKOZ,CUBUKLU MAH.,414,384,378,189,189
BEYKOZ,CUBUKLU MAH.,411,368,366,183,183
BEYKOZ,CUBUKLU MAH.,414,383,374,191,183
BEYKOZ,CUBUKLU MAH.,414,374,368,182,186
BEYKOZ,CUBUKLU MAH.,414,374,366,225,141
BEYKOZ,CUBUKLU MAH.,414,369,359,201,158
BEYKOZ,CUBUKLU MAH.,406,336,323,189,134
BEYKOZ,CUBUKLU MAH.,406,352,340,206,134
BEYKOZ,CUBUKLU MAH.,407,361,355,171,184
BEYKOZ,CUBUKLU MAH.,409,369,365,186,179
BEYKOZ,CUBUKLU MAH.,406,376,372,204,168
BEYKOZ,CUBUKLU MAH.,407,374,369,235,134
BEYKOZ,CUBUKLU MAH.,406,367,361,211,150
BEYKOZ,CUBUKLU MAH.,406,363,359,224,135
BEYKOZ,CUBUKLU MAH.,405,365,360,227,133
BEYKOZ,CUBUKLU MAH.,407,376,369,217,152
BEYKOZ,CUBUKLU MAH.,407,365,365,213,152
BEYKOZ,CUBUKLU MAH.,407,362,354,213,141
BEYKOZ,CUBUKLU MAH.,407,379,368,221,147
BEYKOZ,CUBUKLU MAH.,406,372,367,213,154
BEYKOZ,DERESEKI MAH.,389,347,344,200,144
BEYKOZ,DERESEKI MAH.,390,355,350,218,132
BEYKOZ,DERESEKI MAH.,388,359,351,211,140
BEYKOZ,ELMALI MAH.,372,340,335,240,95
BEYKOZ,ELMALI MAH.,369,325,320,230,90
BEYKOZ,ELMALI MAH.,370,337,332,225,107
BEYKOZ,ELMALI MAH.,368,337,336,239,97
BEYKOZ,ELMALI MAH.,370,330,327,210,117
BEYKOZ,ELMALI MAH.,368,334,331,244,87
BEYKOZ,FATIH MAH.,400,351,346,241,105
BEYKOZ,FATIH MAH.,399,363,359,236,123
BEYKOZ,FATIH MAH.,399,352,346,214,132
BEYKOZ,FATIH MAH.,400,350,345,214,131
BEYKOZ,FATIH MAH.,399,368,363,245,118
BEYKOZ,FATIH MAH.,401,349,342,220,122
BEYKOZ,FATIH MAH.,400,353,350,245,105
BEYKOZ,FATIH MAH.,398,367,364,258,106
BEYKOZ,GOKSU MAH.,402,355,349,127,222
BEYKOZ,GOKSU MAH.,402,368,363,141,222
BEYKOZ,GOKSU MAH.,402,375,368,177,191
BEYKOZ,GOKSU MAH.,402,357,356,159,197
BEYKOZ,GOKSU MAH.,402,360,357,161,196
BEYKOZ,GOLLU MAH.,207,196,192,91,101
BEYKOZ,GORELE MAH.,361,322,319,161,158
BEYKOZ,GORELE MAH.,360,328,325,150,175
BEYKOZ,GORELE MAH.,360,341,339,149,190
BEYKOZ,GORELE MAH.,362,344,342,125,217
BEYKOZ,GOZTEPE MAH.,415,370,364,193,171
BEYKOZ,GOZTEPE MAH.,409,361,359,145,214
BEYKOZ,GOZTEPE MAH.,410,362,362,154,208
BEYKOZ,GOZTEPE MAH.,408,364,360,133,227
BEYKOZ,GOZTEPE MAH.,409,361,355,177,178
BEYKOZ,GOZTEPE MAH.,410,372,367,189,178
BEYKOZ,GOZTEPE MAH.,404,348,347,45,302
BEYKOZ,GOZTEPE MAH.,404,371,371,51,320
BEYKOZ,GOZTEPE MAH.,405,385,385,45,340
BEYKOZ,GOZTEPE MAH.,404,379,378,41,337
BEYKOZ,GOZTEPE MAH.,404,377,370,28,342
BEYKOZ,GOZTEPE MAH.,404,374,371,26,345
BEYKOZ,GOZTEPE MAH.,404,375,370,64,306
BEYKOZ,GOZTEPE MAH.,406,381,380,47,333
BEYKOZ,GOZTEPE MAH.,405,370,369,54,315
BEYKOZ,GUMUSSUYU MAH.,412,332,330,177,153
BEYKOZ,GUMUSSUYU MAH.,415,335,328,198,130
BEYKOZ,GUMUSSUYU MAH.,411,380,371,214,157
BEYKOZ,GUMUSSUYU MAH.,412,367,360,182,178
BEYKOZ,GUMUSSUYU MAH.,411,362,358,208,150
BEYKOZ,GUMUSSUYU MAH.,411,354,345,192,153
BEYKOZ,GUMUSSUYU MAH.,412,370,366,203,163
BEYKOZ,GUMUSSUYU MAH.,411,363,355,197,158
BEYKOZ,GUMUSSUYU MAH.,409,356,354,202,152
BEYKOZ,GUMUSSUYU MAH.,412,357,354,191,163
BEYKOZ,GUMUSSUYU MAH.,412,384,378,236,142
BEYKOZ,GUMUSSUYU MAH.,410,356,353,179,174
BEYKOZ,GUMUSSUYU MAH.,388,323,312,150,162
BEYKOZ,GUMUSSUYU MAH.,388,338,332,193,139
BEYKOZ,GUMUSSUYU MAH.,388,353,346,210,136
BEYKOZ,GUMUSSUYU MAH.,389,346,345,185,160
BEYKOZ,GUMUSSUYU MAH.,387,342,340,203,137
BEYKOZ,GUMUSSUYU MAH.,387,342,339,206,133
BEYKOZ,GUMUSSUYU MAH.,388,338,334,208,126
BEYKOZ,GUMUSSUYU MAH.,387,362,351,198,153
BEYKOZ,GUMUSSUYU MAH.,388,353,344,198,146
BEYKOZ,GUMUSSUYU MAH.,388,348,343,190,153
BEYKOZ,GUMUSSUYU MAH.,388,343,339,200,139
BEYKOZ,GUMUSSUYU MAH.,386,344,335,201,134
BEYKOZ,GUMUSSUYU MAH.,384,345,340,240,100
BEYKOZ,GUMUSSUYU MAH.,385,358,353,239,114
BEYKOZ,GUMUSSUYU MAH.,385,354,350,250,100
BEYKOZ,GUMUSSUYU MAH.,381,343,339,242,97
BEYKOZ,INCIRKOY MAH.,403,343,338,155,183
BEYKOZ,INCIRKOY MAH.,403,314,305,155,150
BEYKOZ,INCIRKOY MAH.,404,345,339,172,167
BEYKOZ,INCIRKOY MAH.,404,344,338,203,135
BEYKOZ,INCIRKOY MAH.,404,365,359,204,155
BEYKOZ,INCIRKOY MAH.,404,348,345,178,167
BEYKOZ,INCIRKOY MAH.,405,341,335,170,165
BEYKOZ,INCIRKOY MAH.,404,356,349,180,169
BEYKOZ,INCIRKOY MAH.,404,347,341,197,144
BEYKOZ,INCIRKOY MAH.,404,351,344,138,206
BEYKOZ,INCIRKOY MAH.,404,350,345,190,155
BEYKOZ,INCIRKOY MAH.,402,353,349,195,154
BEYKOZ,INCIRKOY MAH.,404,362,361,217,144
BEYKOZ,INCIRKOY MAH.,403,369,365,184,181
BEYKOZ,INCIRKOY MAH.,405,355,350,233,117
BEYKOZ,INCIRKOY MAH.,403,367,361,198,163
BEYKOZ,INCIRKOY MAH.,404,366,363,194,169
BEYKOZ,INCIRKOY MAH.,403,360,351,173,178
BEYKOZ,INCIRKOY MAH.,407,332,323,172,151
BEYKOZ,INCIRKOY MAH.,410,361,354,171,183
BEYKOZ,INCIRKOY MAH.,406,357,352,179,173
BEYKOZ,INCIRKOY MAH.,410,373,367,172,195
BEYKOZ,INCIRKOY MAH.,406,362,360,170,190
BEYKOZ,INCIRKOY MAH.,407,381,375,175,200
BEYKOZ,INCIRKOY MAH.,406,363,360,164,196
BEYKOZ,INCIRKOY MAH.,407,356,349,168,181
BEYKOZ,INCIRKOY MAH.,407,355,353,176,177
BEYKOZ,INCIRKOY MAH.,406,352,349,175,174
BEYKOZ,INCIRKOY MAH.,389,322,315,165,150
BEYKOZ,INCIRKOY MAH.,389,348,345,163,182
BEYKOZ,INCIRKOY MAH.,389,338,331,155,176
BEYKOZ,INCIRKOY MAH.,388,339,333,179,154
BEYKOZ,INCIRKOY MAH.,388,347,342,203,139
BEYKOZ,INCIRKOY MAH.,388,347,345,192,153
BEYKOZ,INCIRKOY MAH.,390,351,348,197,151
BEYKOZ,ISHAKLI MAH.,292,262,256,190,66
BEYKOZ,ISHAKLI MAH.,293,275,269,219,50
BEYKOZ,ISHAKLI MAH.,293,263,251,190,61
BEYKOZ,KANLICA MAH.,372,297,294,59,235
BEYKOZ,KANLICA MAH.,372,300,294,84,210
BEYKOZ,KANLICA MAH.,373,336,330,71,259
BEYKOZ,KANLICA MAH.,371,339,328,88,240
BEYKOZ,KANLICA MAH.,372,342,338,94,244
BEYKOZ,KANLICA MAH.,372,333,328,100,228
BEYKOZ,KANLICA MAH.,375,336,332,89,243
BEYKOZ,KANLICA MAH.,371,337,335,91,244
BEYKOZ,KANLICA MAH.,372,350,346,79,267
BEYKOZ,KAVACIK MAH.,415,345,339,187,152
BEYKOZ,KAVACIK MAH.,415,344,333,164,169
BEYKOZ,KAVACIK MAH.,410,324,318,151,167
BEYKOZ,KAVACIK MAH.,415,342,338,168,170
BEYKOZ,KAVACIK MAH.,415,371,366,181,185
BEYKOZ,KAVACIK MAH.,415,375,366,184,182
BEYKOZ,KAVACIK MAH.,415,368,363,180,183
BEYKOZ,KAVACIK MAH.,411,389,382,219,163
BEYKOZ,KAVACIK MAH.,412,378,374,186,188
BEYKOZ,KAVACIK MAH.,412,374,370,167,203
BEYKOZ,KAVACIK MAH.,415,377,376,159,217
BEYKOZ,KAVACIK MAH.,413,387,381,184,197
BEYKOZ,KAVACIK MAH.,412,383,378,191,187
BEYKOZ,KAVACIK MAH.,411,372,367,171,196
BEYKOZ,KAVACIK MAH.,411,383,383,169,214
BEYKOZ,KAVACIK MAH.,411,375,370,148,222
BEYKOZ,KAVACIK MAH.,413,372,363,153,210
BEYKOZ,KAVACIK MAH.,413,383,375,170,205
BEYKOZ,KAVACIK MAH.,412,377,370,167,203
BEYKOZ,KAVACIK MAH.,413,366,364,173,191
BEYKOZ,KAVACIK MAH.,412,366,364,172,192
BEYKOZ,KAVACIK MAH.,412,391,388,187,201
BEYKOZ,KAVACIK MAH.,412,372,366,174,192
BEYKOZ,KAVACIK MAH.,412,379,377,172,205
BEYKOZ,KAVACIK MAH.,410,372,369,168,201
BEYKOZ,KAVACIK MAH.,413,370,366,182,184
BEYKOZ,KAVACIK MAH.,413,371,368,181,187
BEYKOZ,KAVACIK MAH.,412,378,374,167,207
BEYKOZ,KAVACIK MAH.,412,379,370,188,182
BEYKOZ,KAVACIK MAH.,411,369,367,162,205
BEYKOZ,KAVACIK MAH.,412,369,365,181,184
BEYKOZ,KAVACIK MAH.,413,371,370,184,186
BEYKOZ,KAVACIK MAH.,412,370,366,201,165
BEYKOZ,KAVACIK MAH.,411,368,365,155,210
BEYKOZ,KAVACIK MAH.,412,381,378,173,205
BEYKOZ,KAVACIK MAH.,413,368,364,157,207
BEYKOZ,KAVACIK MAH.,413,382,382,161,221
BEYKOZ,KAVACIK MAH.,413,369,366,139,227
BEYKOZ,KAVACIK MAH.,413,364,363,149,214
BEYKOZ,KAVACIK MAH.,413,374,365,168,197
BEYKOZ,KAYNARCA MAH.,223,206,202,161,41
BEYKOZ,KAYNARCA MAH.,223,213,208,158,50
BEYKOZ,KILICLI MAH.,211,194,188,140,48
BEYKOZ,KILICLI MAH.,210,201,195,119,76
BEYKOZ,MAHMUTSEVKETPASA MAH.,349,301,292,158,134
BEYKOZ,MAHMUTSEVKETPASA MAH.,349,322,314,176,138
BEYKOZ,MAHMUTSEVKETPASA MAH.,349,319,317,199,118
BEYKOZ,MAHMUTSEVKETPASA MAH.,350,314,308,187,121
BEYKOZ,MERKEZ MAH.,394,319,309,145,164
BEYKOZ,MERKEZ MAH.,391,311,302,126,176
BEYKOZ,MERKEZ MAH.,393,347,342,141,201
BEYKOZ,MERKEZ MAH.,391,348,346,142,204
BEYKOZ,MERKEZ MAH.,392,332,327,148,179
BEYKOZ,MERKEZ MAH.,390,354,348,122,226
BEYKOZ,MERKEZ MAH.,391,350,346,154,192
BEYKOZ,MERKEZ MAH.,391,346,341,153,188
BEYKOZ,MERKEZ MAH.,390,351,349,135,214
BEYKOZ,MERKEZ MAH.,391,347,341,163,178
BEYKOZ,MERKEZ MAH.,391,346,338,140,198
BEYKOZ,MERKEZ MAH.,391,331,324,159,165
BEYKOZ,ORTACESME MAH.,415,355,350,172,178
BEYKOZ,ORTACESME MAH.,411,325,315,172,143
BEYKOZ,ORTACESME MAH.,410,372,367,197,170
BEYKOZ,ORTACESME MAH.,411,373,372,209,163
BEYKOZ,ORTACESME MAH.,411,368,364,211,153
BEYKOZ,ORTACESME MAH.,415,372,362,198,164
BEYKOZ,ORTACESME MAH.,410,378,370,219,151
BEYKOZ,ORTACESME MAH.,412,360,356,194,162
BEYKOZ,ORTACESME MAH.,412,364,358,198,160
BEYKOZ,ORTACESME MAH.,410,370,358,234,124
BEYKOZ,ORTACESME MAH.,410,372,369,199,170
BEYKOZ,ORTACESME MAH.,410,359,355,227,128
BEYKOZ,ORTACESME MAH.,415,360,353,180,173
BEYKOZ,ORTACESME MAH.,412,354,345,208,137
BEYKOZ,ORTACESME MAH.,409,356,353,207,146
BEYKOZ,OGUMCE MAH.,386,351,347,112,235
BEYKOZ,ORNEKKOY MAH.,307,287,284,201,83
BEYKOZ,ORNEKKOY MAH.,308,279,277,199,78
BEYKOZ,ORNEKKOY MAH.,307,294,289,217,72
BEYKOZ,ORNEKKOY MAH.,385,338,331,247,84
BEYKOZ,ORNEKKOY MAH.,385,356,352,237,115
BEYKOZ,ORNEKKOY MAH.,384,358,349,227,122
BEYKOZ,ORNEKKOY MAH.,385,352,349,219,130
BEYKOZ,ORNEKKOY MAH.,384,349,348,240,108
BEYKOZ,PASABAHCE MAH.,402,332,322,113,209
BEYKOZ,PASABAHCE MAH.,401,343,339,100,239
BEYKOZ,PASABAHCE MAH.,401,356,352,128,224
BEYKOZ,PASABAHCE MAH.,402,357,349,123,226
BEYKOZ,PASABAHCE MAH.,407,360,353,104,249
BEYKOZ,PASABAHCE MAH.,403,366,366,130,236
BEYKOZ,PASABAHCE MAH.,401,368,365,121,244
BEYKOZ,PASABAHCE MAH.,402,359,352,89,263
BEYKOZ,PASAMANDIRA MAH.,398,361,355,249,106
BEYKOZ,PASAMANDIRA MAH.,382,358,350,298,52
BEYKOZ,POLONEZKOY MAH.,288,253,250,78,172
BEYKOZ,POYRAZKOY MAH.,372,304,303,245,58
BEYKOZ,POYRAZKOY MAH.,370,325,325,252,73
BEYKOZ,RIVA MAH.,404,356,351,180,171
BEYKOZ,RIVA MAH.,403,370,368,186,182
BEYKOZ,RIVA MAH.,404,359,354,173,181
BEYKOZ,RIVA MAH.,403,364,359,180,179
BEYKOZ,RUZGARLIBAHCE MAH.,415,353,345,205,140
BEYKOZ,RUZGARLIBAHCE MAH.,409,357,342,215,127
BEYKOZ,RUZGARLIBAHCE MAH.,415,372,368,239,129
BEYKOZ,RUZGARLIBAHCE MAH.,415,375,368,251,117
BEYKOZ,RUZGARLIBAHCE MAH.,409,377,371,231,140
BEYKOZ,RUZGARLIBAHCE MAH.,410,370,367,218,149
BEYKOZ,RUZGARLIBAHCE MAH.,410,369,363,254,109
BEYKOZ,RUZGARLIBAHCE MAH.,415,367,360,238,122
BEYKOZ,RUZGARLIBAHCE MAH.,415,377,371,218,153
BEYKOZ,RUZGARLIBAHCE MAH.,410,366,361,221,140
BEYKOZ,RUZGARLIBAHCE MAH.,411,389,383,233,150
BEYKOZ,RUZGARLIBAHCE MAH.,415,383,371,237,134
BEYKOZ,RUZGARLIBAHCE MAH.,411,374,368,210,158
BEYKOZ,RUZGARLIBAHCE MAH.,410,365,360,206,154
BEYKOZ,SOGUKSU MAH.,415,349,337,155,182
BEYKOZ,SOGUKSU MAH.,411,344,338,195,143
BEYKOZ,SOGUKSU MAH.,415,371,367,194,173
BEYKOZ,SOGUKSU MAH.,412,373,364,187,177
BEYKOZ,SOGUKSU MAH.,412,373,371,169,202
BEYKOZ,SOGUKSU MAH.,411,381,373,152,221
BEYKOZ,SOGUKSU MAH.,415,373,361,167,194
BEYKOZ,SOGUKSU MAH.,412,374,369,156,213
BEYKOZ,SOGUKSU MAH.,411,383,377,164,213
BEYKOZ,SOGUKSU MAH.,415,381,371,171,200
BEYKOZ,SOGUKSU MAH.,411,363,355,180,175
BEYKOZ,SOGUKSU MAH.,415,364,359,158,201
BEYKOZ,SOGUKSU MAH.,412,374,370,159,211
BEYKOZ,SOGUKSU MAH.,412,370,366,183,183
BEYKOZ,SOGUKSU MAH.,411,368,358,172,186
BEYKOZ,SOGUKSU MAH.,411,371,365,143,222
BEYKOZ,SOGUKSU MAH.,411,372,367,175,192
BEYKOZ,SOGUKSU MAH.,412,375,367,140,227
BEYKOZ,SOGUKSU MAH.,411,362,360,151,209
BEYKOZ,SOGUKSU MAH.,412,357,352,145,207
BEYKOZ,TOKATKOY MAH.,387,339,331,225,106
BEYKOZ,TOKATKOY MAH.,389,354,349,204,145
BEYKOZ,TOKATKOY MAH.,387,350,337,207,130
BEYKOZ,TOKATKOY MAH.,387,346,341,205,136
BEYKOZ,TOKATKOY MAH.,388,344,339,211,128
BEYKOZ,TOKATKOY MAH.,388,336,329,196,133
BEYKOZ,TOKATKOY MAH.,388,348,335,202,133
BEYKOZ,TOKATKOY MAH.,388,340,334,210,124
BEYKOZ,TOKATKOY MAH.,388,352,348,200,148
BEYKOZ,TOKATKOY MAH.,387,350,345,221,124
BEYKOZ,TOKATKOY MAH.,388,345,337,191,146
BEYKOZ,TOKATKOY MAH.,396,315,301,181,120
BEYKOZ,TOKATKOY MAH.,395,332,327,221,106
BEYKOZ,TOKATKOY MAH.,395,356,350,236,114
BEYKOZ,TOKATKOY MAH.,399,372,361,241,120
BEYKOZ,TOKATKOY MAH.,395,336,331,196,135
BEYKOZ,TOKATKOY MAH.,396,349,346,197,149
BEYKOZ,TOKATKOY MAH.,396,345,338,209,129
BEYKOZ,TOKATKOY MAH.,397,358,354,207,147
BEYKOZ,TOKATKOY MAH.,396,356,355,207,148
BEYKOZ,TOKATKOY MAH.,397,365,359,214,145
BEYKOZ,TOKATKOY MAH.,395,350,343,243,100
BEYKOZ,TOKATKOY MAH.,396,356,351,214,137
BEYKOZ,TOKATKOY MAH.,395,354,347,213,134
BEYKOZ,TOKATKOY MAH.,396,356,353,236,117
BEYKOZ,TOKATKOY MAH.,396,351,346,217,129
BEYKOZ,TOKATKOY MAH.,395,357,351,216,135
BEYKOZ,TOKATKOY MAH.,395,369,368,244,124
BEYKOZ,TOKATKOY MAH.,396,360,353,203,150
BEYKOZ,YALIKOY MAH.,382,310,310,98,212
BEYKOZ,YALIKOY MAH.,382,318,312,134,178
BEYKOZ,YALIKOY MAH.,383,334,327,151,176
BEYKOZ,YALIKOY MAH.,382,343,336,145,191
BEYKOZ,YALIKOY MAH.,382,334,329,136,193
BEYKOZ,YALIKOY MAH.,382,338,337,135,202
BEYKOZ,YALIKOY MAH.,384,344,338,117,221
BEYKOZ,YALIKOY MAH.,382,347,341,151,190
BEYKOZ,YALIKOY MAH.,382,342,335,155,180
BEYKOZ,YALIKOY MAH.,383,332,327,147,180
BEYKOZ,YALIKOY MAH.,382,335,333,129,204
BEYKOZ,YAVUZ SELIM MAH.,391,336,327,239,88
BEYKOZ,YAVUZ SELIM MAH.,393,358,350,261,89
BEYKOZ,YAVUZ SELIM MAH.,390,375,363,258,105
BEYKOZ,YAVUZ SELIM MAH.,391,352,348,238,110
BEYKOZ,YAVUZ SELIM MAH.,389,350,337,248,89
BEYKOZ,YAVUZ SELIM MAH.,391,346,340,231,109
BEYKOZ,YAVUZ SELIM MAH.,390,351,348,241,107
BEYKOZ,YAVUZ SELIM MAH.,391,355,353,240,113
BEYKOZ,YAVUZ SELIM MAH.,391,360,350,253,97
BEYKOZ,YENI MAHALLE MAH.,407,332,319,195,124
BEYKOZ,YENI MAHALLE MAH.,410,346,343,213,130
BEYKOZ,YENI MAHALLE MAH.,408,338,331,195,136
BEYKOZ,YENI MAHALLE MAH.,407,330,323,210,113
BEYKOZ,YENI MAHALLE MAH.,407,352,347,213,134
BEYKOZ,YENI MAHALLE MAH.,410,349,342,200,142
BEYKOZ,YENI MAHALLE MAH.,406,351,344,192,152
BEYKOZ,YENI MAHALLE MAH.,407,365,360,209,151
BEYKOZ,YENI MAHALLE MAH.,407,349,345,220,125
BEYKOZ,YENI MAHALLE MAH.,407,368,362,240,122
BEYKOZ,YENI MAHALLE MAH.,406,348,344,208,136
BEYKOZ,YENI MAHALLE MAH.,408,362,356,201,155
BEYKOZ,YENI MAHALLE MAH.,408,356,349,217,132
BEYKOZ,YENI MAHALLE MAH.,407,352,344,204,140
BEYKOZ,YENI MAHALLE MAH.,407,370,369,225,144
BEYKOZ,YENI MAHALLE MAH.,407,351,343,205,138
BEYKOZ,YENI MAHALLE MAH.,407,365,356,229,127
BEYKOZ,YENI MAHALLE MAH.,407,361,357,238,119
BEYKOZ,YENI MAHALLE MAH.,408,347,340,212,128
BEYKOZ,YENI MAHALLE MAH.,407,350,348,205,143
BEYKOZ,YENI MAHALLE MAH.,406,369,362,211,151
BEYKOZ,YENI MAHALLE MAH.,406,351,344,226,118
BEYKOZ,YENI MAHALLE MAH.,407,367,365,210,155
BEYKOZ,YENI MAHALLE MAH.,407,350,345,222,123
BEYKOZ,YENI MAHALLE MAH.,407,368,363,235,128
BEYKOZ,YENI MAHALLE MAH.,407,358,350,198,152
BEYKOZ,YENI MAHALLE MAH.,406,355,345,228,117
BEYKOZ,YENI MAHALLE MAH.,407,377,374,196,178
BEYKOZ,YENI MAHALLE MAH.,407,348,346,179,167
BEYKOZ,YENI MAHALLE MAH.,408,374,369,202,167
BEYKOZ,YENI MAHALLE MAH.,406,344,338,179,159
BEYKOZ,YENI MAHALLE MAH.,406,358,357,201,156
BEYKOZ,YENI MAHALLE MAH.,407,341,335,179,156
BEYKOZ,YENI MAHALLE MAH.,409,367,362,212,150
BEYKOZ,YENI MAHALLE MAH.,406,358,343,194,149
BEYKOZ,ZERZAVATCI MAH.,341,322,318,234,84
BEYKOZ,ZERZAVATCI MAH.,340,312,307,212,95
ESENYURT,AKSEMSEDDIN MAH.,379,321,316,168,148
ESENYURT,AKSEMSEDDIN MAH.,379,339,333,129,204
ESENYURT,AKSEMSEDDIN MAH.,379,340,338,149,189
ESENYURT,AKSEMSEDDIN MAH.,378,334,330,151,179
ESENYURT,AKSEMSEDDIN MAH.,379,340,336,137,199
ESENYURT,AKSEMSEDDIN MAH.,379,337,332,159,173
ESENYURT,AKSEMSEDDIN MAH.,379,336,333,171,162
ESENYURT,AKSEMSEDDIN MAH.,379,337,334,184,150
ESENYURT,AKSEMSEDDIN MAH.,378,325,319,139,180
ESENYURT,AKSEMSEDDIN MAH.,378,339,337,148,189
ESENYURT,AKSEMSEDDIN MAH.,378,329,324,147,177
ESENYURT,ARDICLI MAH.,408,345,343,111,232
ESENYURT,ARDICLI MAH.,407,357,352,139,213
ESENYURT,ARDICLI MAH.,407,361,353,117,236
ESENYURT,ARDICLI MAH.,406,345,339,118,221
ESENYURT,ARDICLI MAH.,406,359,353,137,216
ESENYURT,ARDICLI MAH.,406,374,372,156,216
ESENYURT,ARDICLI MAH.,406,352,347,162,185
ESENYURT,ARDICLI MAH.,407,360,354,124,230
ESENYURT,ARDICLI MAH.,406,372,362,125,237
ESENYURT,ARDICLI MAH.,407,359,355,135,220
ESENYURT,ARDICLI MAH.,407,374,373,147,226
ESENYURT,ASIK VEYSEL MAH.,402,355,346,59,287
ESENYURT,ASIK VEYSEL MAH.,402,336,331,55,276
ESENYURT,ASIK VEYSEL MAH.,402,374,372,93,279
ESENYURT,ASIK VEYSEL MAH.,402,362,360,79,281
ESENYURT,ASIK VEYSEL MAH.,403,367,364,86,278
ESENYURT,ASIK VEYSEL MAH.,403,369,367,93,274
ESENYURT,ASIK VEYSEL MAH.,403,358,355,82,273
ESENYURT,ASIK VEYSEL MAH.,402,372,368,89,279
ESENYURT,ASIK VEYSEL MAH.,402,359,353,93,260
ESENYURT,ASIK VEYSEL MAH.,402,359,353,88,265
ESENYURT,ASIK VEYSEL MAH.,403,349,345,91,254
ESENYURT,ASIK VEYSEL MAH.,402,366,361,83,278
ESENYURT,ASIK VEYSEL MAH.,402,355,349,75,274
ESENYURT,ASIK VEYSEL MAH.,402,372,366,93,273
ESENYURT,ASIK VEYSEL MAH.,404,364,362,91,271
ESENYURT,ASIK VEYSEL MAH.,402,373,372,89,283
ESENYURT,ASIK VEYSEL MAH.,406,359,353,64,289
ESENYURT,ASIK VEYSEL MAH.,397,334,331,70,261
ESENYURT,ASIK VEYSEL MAH.,396,357,355,102,253
ESENYURT,ASIK VEYSEL MAH.,396,365,361,60,301
ESENYURT,ASIK VEYSEL MAH.,397,367,365,77,288
ESENYURT,ASIK VEYSEL MAH.,397,346,342,77,265
ESENYURT,ASIK VEYSEL MAH.,396,366,365,78,287
ESENYURT,ASIK VEYSEL MAH.,397,355,354,83,271
ESENYURT,ASIK VEYSEL MAH.,397,352,346,76,270
ESENYURT,ASIK VEYSEL MAH.,397,369,364,59,305
ESENYURT,ASIK VEYSEL MAH.,395,361,354,68,286
ESENYURT,ASIK VEYSEL MAH.,397,367,365,89,276
ESENYURT,ASIK VEYSEL MAH.,397,356,354,77,277
ESENYURT,BAGLARCESME MAH.,402,329,321,163,158
ESENYURT,BAGLARCESME MAH.,404,324,315,174,141
ESENYURT,BAGLARCESME MAH.,407,343,335,180,155
ESENYURT,BAGLARCESME MAH.,403,338,335,197,138
ESENYURT,BAGLARCESME MAH.,402,347,336,200,136
ESENYURT,BAGLARCESME MAH.,402,361,352,194,158
ESENYURT,BAGLARCESME MAH.,402,344,338,188,150
ESENYURT,BAGLARCESME MAH.,403,343,335,174,161
ESENYURT,BAGLARCESME MAH.,406,355,349,187,162
ESENYURT,BAGLARCESME MAH.,402,349,345,192,153
ESENYURT,BAGLARCESME MAH.,402,347,339,146,193
ESENYURT,BAGLARCESME MAH.,403,342,336,178,158
ESENYURT,BAGLARCESME MAH.,402,346,340,183,157
ESENYURT,BAGLARCESME MAH.,402,346,342,206,136
ESENYURT,BAGLARCESME MAH.,403,350,334,186,148
ESENYURT,BAGLARCESME MAH.,408,346,341,184,157
ESENYURT,BAGLARCESME MAH.,402,342,334,162,172
ESENYURT,BAGLARCESME MAH.,402,335,328,157,171
ESENYURT,BAGLARCESME MAH.,402,342,336,197,139
ESENYURT,BAGLARCESME MAH.,402,349,346,148,198
ESENYURT,BAGLARCESME MAH.,402,359,355,188,167
ESENYURT,BAGLARCESME MAH.,403,347,343,164,179
ESENYURT,BAGLARCESME MAH.,403,338,331,178,153
ESENYURT,BAGLARCESME MAH.,403,337,334,172,162
ESENYURT,BAGLARCESME MAH.,407,329,317,146,171
ESENYURT,BAGLARCESME MAH.,415,330,322,174,148
ESENYURT,BAGLARCESME MAH.,407,350,346,190,156
ESENYURT,BAGLARCESME MAH.,410,332,330,148,182
ESENYURT,BAGLARCESME MAH.,407,353,348,163,185
ESENYURT,BAGLARCESME MAH.,408,338,335,148,187
ESENYURT,BAGLARCESME MAH.,407,356,351,166,185
ESENYURT,BAGLARCESME MAH.,406,356,346,152,194
ESENYURT,BAGLARCESME MAH.,407,352,350,155,195
ESENYURT,BAGLARCESME MAH.,407,346,344,152,192
ESENYURT,BAGLARCESME MAH.,407,360,357,194,163
ESENYURT,BAGLARCESME MAH.,408,351,346,156,190
ESENYURT,BAGLARCESME MAH.,407,347,342,175,167
ESENYURT,BAGLARCESME MAH.,406,361,358,181,177
ESENYURT,BAGLARCESME MAH.,408,347,344,175,169
ESENYURT,BAGLARCESME MAH.,406,347,340,151,189
ESENYURT,BAGLARCESME MAH.,408,354,348,167,181
ESENYURT,BAGLARCESME MAH.,406,339,335,158,177
ESENYURT,BAGLARCESME MAH.,407,356,354,157,197
ESENYURT,BAGLARCESME MAH.,408,356,353,190,163
ESENYURT,BALIKYOLU MAH.,408,333,326,184,142
ESENYURT,BALIKYOLU MAH.,406,350,348,213,135
ESENYURT,BALIKYOLU MAH.,406,358,351,225,126
ESENYURT,BALIKYOLU MAH.,406,352,347,200,147
ESENYURT,BALIKYOLU MAH.,407,351,345,229,116
ESENYURT,BALIKYOLU MAH.,406,361,358,228,130
ESENYURT,BALIKYOLU MAH.,406,358,351,231,120
ESENYURT,BALIKYOLU MAH.,407,347,341,176,165
ESENYURT,BALIKYOLU MAH.,407,345,341,196,145
ESENYURT,BALIKYOLU MAH.,415,365,358,227,131
ESENYURT,BALIKYOLU MAH.,406,347,340,192,148
ESENYURT,BALIKYOLU MAH.,406,351,346,235,111
ESENYURT,BALIKYOLU MAH.,407,349,344,191,153
ESENYURT,BALIKYOLU MAH.,407,354,346,210,136
ESENYURT,BALIKYOLU MAH.,406,320,313,183,130
ESENYURT,BALIKYOLU MAH.,407,346,342,249,93
ESENYURT,BALIKYOLU MAH.,407,357,354,199,155
ESENYURT,BALIKYOLU MAH.,410,358,346,228,118
ESENYURT,BALIKYOLU MAH.,407,361,357,222,135
ESENYURT,BALIKYOLU MAH.,407,344,333,181,152
ESENYURT,BALIKYOLU MAH.,402,348,335,143,192
ESENYURT,BALIKYOLU MAH.,402,347,343,142,201
ESENYURT,BALIKYOLU MAH.,402,341,334,159,175
ESENYURT,BALIKYOLU MAH.,404,361,356,138,218
ESENYURT,BALIKYOLU MAH.,401,348,338,172,166
ESENYURT,BALIKYOLU MAH.,401,355,350,176,174
ESENYURT,BALIKYOLU MAH.,402,354,347,157,190
ESENYURT,BALIKYOLU MAH.,401,349,345,187,158
ESENYURT,BALIKYOLU MAH.,402,345,341,164,177
ESENYURT,BALIKYOLU MAH.,401,338,329,173,156
ESENYURT,BALIKYOLU MAH.,402,340,333,164,169
ESENYURT,BALIKYOLU MAH.,401,335,332,160,172
ESENYURT,BALIKYOLU MAH.,402,342,337,149,188
ESENYURT,BALIKYOLU MAH.,403,349,341,197,144
ESENYURT,BALIKYOLU MAH.,401,355,350,182,168
ESENYURT,BALIKYOLU MAH.,401,352,340,155,185
ESENYURT,BALIKYOLU MAH.,402,357,352,181,171
ESENYURT,BALIKYOLU MAH.,402,355,350,172,178
ESENYURT,BALIKYOLU MAH.,402,353,347,162,185
ESENYURT,CINAR MAH.,394,330,321,123,198
ESENYURT,CINAR MAH.,400,346,342,167,175
ESENYURT,CINAR MAH.,394,331,324,155,169
ESENYURT,CINAR MAH.,394,347,339,153,186
ESENYURT,CINAR MAH.,393,338,334,153,181
ESENYURT,CINAR MAH.,394,340,331,167,164
ESENYURT,CINAR MAH.,393,329,321,125,196
ESENYURT,CINAR MAH.,393,346,342,157,185
ESENYURT,CINAR MAH.,393,339,335,160,175
ESENYURT,CINAR MAH.,403,326,322,164,158
ESENYURT,CINAR MAH.,401,335,325,152,173
ESENYURT,CINAR MAH.,402,331,319,157,162
ESENYURT,CINAR MAH.,401,362,355,174,181
ESENYURT,CINAR MAH.,401,346,339,163,176
ESENYURT,CINAR MAH.,401,344,338,177,161
ESENYURT,CINAR MAH.,402,342,336,173,163
ESENYURT,CINAR MAH.,402,354,349,167,182
ESENYURT,CINAR MAH.,401,341,334,141,193
ESENYURT,CINAR MAH.,402,346,338,143,195
ESENYURT,CINAR MAH.,401,335,328,155,173
ESENYURT,CINAR MAH.,405,358,356,160,196
ESENYURT,CINAR MAH.,401,344,341,174,167
ESENYURT,CINAR MAH.,402,332,329,166,163
ESENYURT,CINAR MAH.,402,352,346,154,192
ESENYURT,CINAR MAH.,401,336,326,138,188
ESENYURT,CINAR MAH.,402,338,333,183,150
ESENYURT,CINAR MAH.,407,341,336,205,131
ESENYURT,CINAR MAH.,399,327,320,151,169
ESENYURT,CINAR MAH.,400,344,340,167,173
ESENYURT,CINAR MAH.,400,341,337,146,191
ESENYURT,CINAR MAH.,400,340,332,141,191
ESENYURT,CINAR MAH.,400,360,357,140,217
ESENYURT,CINAR MAH.,400,357,353,142,211
ESENYURT,CINAR MAH.,399,349,348,148,200
ESENYURT,CINAR MAH.,399,350,344,149,195
ESENYURT,CINAR MAH.,400,345,343,167,176
ESENYURT,CINAR MAH.,405,368,359,152,207
ESENYURT,CINAR MAH.,401,352,342,158,184
ESENYURT,CINAR MAH.,398,344,335,158,177
ESENYURT,CINAR MAH.,399,346,337,167,170
ESENYURT,CINAR MAH.,400,342,339,152,187
ESENYURT,CINAR MAH.,399,360,357,166,191
ESENYURT,ESENKENT  MAH.,396,340,338,79,259
ESENYURT,ESENKENT  MAH.,394,352,351,89,262
ESENYURT,ESENKENT  MAH.,395,359,355,73,282
ESENYURT,ESENKENT  MAH.,394,367,367,67,300
ESENYURT,ESENKENT  MAH.,394,356,354,85,269
ESENYURT,ESENKENT  MAH.,394,362,358,74,284
ESENYURT,ESENKENT  MAH.,395,367,366,58,308
ESENYURT,ESENKENT  MAH.,396,357,353,90,263
ESENYURT,ESENKENT  MAH.,395,364,359,73,286
ESENYURT,ESENKENT  MAH.,394,360,358,64,294
ESENYURT,ESENKENT  MAH.,395,360,355,71,284
ESENYURT,ESENKENT  MAH.,395,364,358,92,266
ESENYURT,ESENKENT  MAH.,395,362,359,83,276
ESENYURT,ESENKENT  MAH.,395,365,365,89,276
ESENYURT,ESENKENT  MAH.,395,366,365,91,274
ESENYURT,ESENKENT  MAH.,395,374,371,108,263
ESENYURT,ESENKENT  MAH.,395,362,357,75,282
ESENYURT,ESENKENT  MAH.,395,368,363,74,289
ESENYURT,FATIH MAH.,406,325,321,161,160
ESENYURT,FATIH MAH.,399,332,323,156,167
ESENYURT,FATIH MAH.,403,345,341,201,140
ESENYURT,FATIH MAH.,399,350,342,151,191
ESENYURT,FATIH MAH.,398,350,339,171,168
ESENYURT,FATIH MAH.,399,354,349,175,174
ESENYURT,FATIH MAH.,402,357,352,156,196
ESENYURT,FATIH MAH.,398,355,346,152,194
ESENYURT,FATIH MAH.,399,350,345,162,183
ESENYURT,FATIH MAH.,399,349,344,177,167
ESENYURT,FATIH MAH.,398,345,339,198,141
ESENYURT,FATIH MAH.,399,344,339,188,151
ESENYURT,FATIH MAH.,399,347,338,187,151
ESENYURT,FATIH MAH.,399,354,349,161,188
ESENYURT,FATIH MAH.,399,351,340,173,167
ESENYURT,FATIH MAH.,399,351,345,189,156
ESENYURT,FATIH MAH.,399,331,319,187,132
ESENYURT,FATIH MAH.,398,351,346,159,187
ESENYURT,FATIH MAH.,398,346,343,170,173
ESENYURT,FATIH MAH.,399,347,338,193,145
ESENYURT,FATIH MAH.,398,347,345,198,147
ESENYURT,FATIH MAH.,399,341,338,189,149
ESENYURT,FATIH MAH.,410,308,296,193,103
ESENYURT,FATIH MAH.,410,354,348,196,152
ESENYURT,FATIH MAH.,415,344,338,152,186
ESENYURT,FATIH MAH.,411,339,335,143,192
ESENYURT,FATIH MAH.,409,337,330,161,169
ESENYURT,FATIH MAH.,411,340,333,147,186
ESENYURT,FATIH MAH.,409,345,339,165,174
ESENYURT,FATIH MAH.,410,351,343,174,169
ESENYURT,FATIH MAH.,410,338,331,168,163
ESENYURT,FATIH MAH.,410,357,350,192,158
ESENYURT,FATIH MAH.,410,346,339,194,145
ESENYURT,FATIH MAH.,409,354,350,186,164
ESENYURT,FATIH MAH.,409,357,352,191,161
ESENYURT,FATIH MAH.,409,347,343,178,165
ESENYURT,FATIH MAH.,409,345,336,165,171
ESENYURT,FATIH MAH.,408,334,330,156,174
ESENYURT,FATIH MAH.,408,348,337,185,152
ESENYURT,INCIRTEPE MAH.,404,330,324,139,185
ESENYURT,INCIRTEPE MAH.,405,329,327,159,168
ESENYURT,INCIRTEPE MAH.,406,351,346,171,175
ESENYURT,INCIRTEPE MAH.,406,358,352,171,181
ESENYURT,INCIRTEPE MAH.,404,352,348,171,177
ESENYURT,INCIRTEPE MAH.,403,334,329,145,184
ESENYURT,INCIRTEPE MAH.,405,342,335,144,191
ESENYURT,INCIRTEPE MAH.,404,331,324,129,195
ESENYURT,INCIRTEPE MAH.,403,353,351,135,216
ESENYURT,INCIRTEPE MAH.,404,344,338,154,184
ESENYURT,INCIRTEPE MAH.,404,341,339,156,183
ESENYURT,INCIRTEPE MAH.,403,338,338,149,189
ESENYURT,INCIRTEPE MAH.,403,350,348,140,208
ESENYURT,INCIRTEPE MAH.,404,353,350,150,200
ESENYURT,INCIRTEPE MAH.,404,361,356,176,180
ESENYURT,INCIRTEPE MAH.,403,355,350,178,172
ESENYURT,INCIRTEPE MAH.,402,346,334,146,188
ESENYURT,INCIRTEPE MAH.,403,343,338,160,178
ESENYURT,INCIRTEPE MAH.,402,353,345,133,212
ESENYURT,INCIRTEPE MAH.,403,342,336,143,193
ESENYURT,INCIRTEPE MAH.,403,328,325,155,170
ESENYURT,INCIRTEPE MAH.,407,343,335,160,175
ESENYURT,INCIRTEPE MAH.,406,357,349,143,206
ESENYURT,INCIRTEPE MAH.,405,354,348,182,166
ESENYURT,INCIRTEPE MAH.,404,351,349,192,157
ESENYURT,INCIRTEPE MAH.,405,366,363,153,210
ESENYURT,INCIRTEPE MAH.,395,320,311,153,158
ESENYURT,INCIRTEPE MAH.,395,337,332,158,174
ESENYURT,INCIRTEPE MAH.,395,360,357,191,166
ESENYURT,INCIRTEPE MAH.,395,351,347,147,200
ESENYURT,INCIRTEPE MAH.,396,343,339,166,173
ESENYURT,INCIRTEPE MAH.,396,339,332,188,144
ESENYURT,INCIRTEPE MAH.,396,358,356,175,181
ESENYURT,INCIRTEPE MAH.,395,336,328,142,186
ESENYURT,INCIRTEPE MAH.,396,349,346,178,168
ESENYURT,INCIRTEPE MAH.,396,355,350,199,151
ESENYURT,INCIRTEPE MAH.,398,342,336,170,166
ESENYURT,INCIRTEPE MAH.,395,328,320,152,168
ESENYURT,INCIRTEPE MAH.,396,350,346,168,178
ESENYURT,INCIRTEPE MAH.,395,348,344,197,147
ESENYURT,INONU MAH.,399,324,312,141,171
ESENYURT,INONU MAH.,402,341,338,169,169
ESENYURT,INONU MAH.,399,349,345,185,160
ESENYURT,INONU MAH.,398,341,334,160,174
ESENYURT,INONU MAH.,399,341,336,189,147
ESENYURT,INONU MAH.,403,347,342,181,161
ESENYURT,INONU MAH.,400,345,339,161,178
ESENYURT,INONU MAH.,398,327,323,177,146
ESENYURT,INONU MAH.,398,343,335,182,153
ESENYURT,INONU MAH.,398,348,344,191,153
ESENYURT,INONU MAH.,399,349,344,165,179
ESENYURT,INONU MAH.,399,358,350,181,169
ESENYURT,INONU MAH.,403,320,308,178,130
ESENYURT,INONU MAH.,403,337,324,158,166
ESENYURT,INONU MAH.,406,346,342,172,170
ESENYURT,INONU MAH.,403,340,333,167,166
ESENYURT,INONU MAH.,404,336,331,176,155
ESENYURT,INONU MAH.,404,372,367,203,164
ESENYURT,INONU MAH.,403,360,354,182,172
ESENYURT,INONU MAH.,402,334,326,131,195
ESENYURT,INONU MAH.,403,349,342,186,156
ESENYURT,INONU MAH.,403,343,336,204,132
ESENYURT,INONU MAH.,402,358,355,170,185
ESENYURT,INONU MAH.,403,346,342,199,143
ESENYURT,INONU MAH.,402,335,332,191,141
ESENYURT,INONU MAH.,403,349,345,181,164
ESENYURT,INONU MAH.,403,362,354,187,167
ESENYURT,INONU MAH.,403,344,340,169,171
ESENYURT,INONU MAH.,402,348,345,159,186
ESENYURT,INONU MAH.,403,347,339,171,168
ESENYURT,INONU MAH.,402,354,353,198,155
ESENYURT,INONU MAH.,403,345,343,184,159
ESENYURT,INONU MAH.,403,344,338,152,186
ESENYURT,INONU MAH.,403,336,327,168,159
ESENYURT,INONU MAH.,404,355,344,165,179
ESENYURT,INONU MAH.,403,350,346,177,169
ESENYURT,INONU MAH.,403,356,348,204,144
ESENYURT,INONU MAH.,404,353,349,183,166
ESENYURT,KOZA MAH.,402,335,332,69,263
ESENYURT,KOZA MAH.,399,343,337,77,260
ESENYURT,KOZA MAH.,399,338,335,66,269
ESENYURT,KOZA MAH.,399,331,328,59,269
ESENYURT,KOZA MAH.,399,342,342,71,271
ESENYURT,KOZA MAH.,399,317,313,88,225
ESENYURT,KOZA MAH.,399,331,325,67,258
ESENYURT,NAMIK KEMAL MAH.,388,321,317,154,163
ESENYURT,NAMIK KEMAL MAH.,389,325,323,178,145
ESENYURT,NAMIK KEMAL MAH.,387,341,338,165,173
ESENYURT,NAMIK KEMAL MAH.,387,325,317,142,175
ESENYURT,NAMIK KEMAL MAH.,389,335,331,161,170
ESENYURT,NAMIK KEMAL MAH.,387,328,321,152,169
ESENYURT,NAMIK KEMAL MAH.,388,344,342,191,151
ESENYURT,NAMIK KEMAL MAH.,387,326,322,154,168
ESENYURT,NAMIK KEMAL MAH.,388,337,332,178,154
ESENYURT,NAMIK KEMAL MAH.,387,346,343,172,171
ESENYURT,NAMIK KEMAL MAH.,386,338,331,166,165
ESENYURT,NAMIK KEMAL MAH.,409,353,344,147,197
ESENYURT,NAMIK KEMAL MAH.,415,345,340,149,191
ESENYURT,NAMIK KEMAL MAH.,415,353,350,169,181
ESENYURT,NAMIK KEMAL MAH.,415,377,372,170,202
ESENYURT,NAMIK KEMAL MAH.,415,380,376,181,195
ESENYURT,NAMIK KEMAL MAH.,415,362,359,190,169
ESENYURT,NAMIK KEMAL MAH.,412,376,366,168,198
ESENYURT,NAMIK KEMAL MAH.,412,363,357,175,182
ESENYURT,NAMIK KEMAL MAH.,415,368,362,174,188
ESENYURT,NAMIK KEMAL MAH.,412,371,366,178,188
ESENYURT,NAMIK KEMAL MAH.,415,370,366,173,193
ESENYURT,NAMIK KEMAL MAH.,412,373,364,144,220
ESENYURT,NAMIK KEMAL MAH.,415,359,349,187,162
ESENYURT,NAMIK KEMAL MAH.,412,361,356,145,211
ESENYURT,NAMIK KEMAL MAH.,415,370,368,190,178
ESENYURT,NAMIK KEMAL MAH.,412,354,351,160,191
ESENYURT,NAMIK KEMAL MAH.,415,366,359,152,207
ESENYURT,NAMIK KEMAL MAH.,413,353,351,135,216
ESENYURT,NAMIK KEMAL MAH.,413,368,365,167,198
ESENYURT,NAMIK KEMAL MAH.,410,361,356,182,174
ESENYURT,NAMIK KEMAL MAH.,412,358,356,169,187
ESENYURT,NAMIK KEMAL MAH.,412,363,359,179,180
ESENYURT,NAMIK KEMAL MAH.,415,360,357,170,187
ESENYURT,NAMIK KEMAL MAH.,412,347,338,156,182
ESENYURT,NAMIK KEMAL MAH.,411,360,353,158,195
ESENYURT,ORHAN GAZI MAH.,415,358,348,206,142
ESENYURT,ORHAN GAZI MAH.,415,365,362,207,155
ESENYURT,ORHAN GAZI MAH.,412,365,360,181,179
ESENYURT,ORHAN GAZI MAH.,415,360,357,192,165
ESENYURT,ORHAN GAZI MAH.,411,351,343,171,172
ESENYURT,ORHAN GAZI MAH.,411,360,357,233,124
ESENYURT,ORHAN GAZI MAH.,412,368,362,187,175
ESENYURT,ORHAN GAZI MAH.,410,368,357,180,177
ESENYURT,ORHAN GAZI MAH.,412,356,354,164,190
ESENYURT,ORHAN GAZI MAH.,410,368,359,193,166
ESENYURT,ORHAN GAZI MAH.,412,353,345,201,144
ESENYURT,ORHAN GAZI MAH.,412,367,363,206,157
ESENYURT,ORHAN GAZI MAH.,411,377,369,201,168
ESENYURT,ORHAN GAZI MAH.,410,347,344,205,139
ESENYURT,ORHAN GAZI MAH.,412,362,357,184,173
ESENYURT,ORNEK MAH.,404,319,305,144,161
ESENYURT,ORNEK MAH.,405,337,335,135,200
ESENYURT,ORNEK MAH.,402,348,340,156,184
ESENYURT,ORNEK MAH.,403,358,353,164,189
ESENYURT,ORNEK MAH.,403,346,338,149,189
ESENYURT,ORNEK MAH.,403,352,348,159,189
ESENYURT,ORNEK MAH.,404,357,347,158,189
ESENYURT,ORNEK MAH.,405,355,351,173,178
ESENYURT,ORNEK MAH.,402,349,345,138,207
ESENYURT,ORNEK MAH.,403,344,342,163,179
ESENYURT,ORNEK MAH.,403,358,352,158,194
ESENYURT,ORNEK MAH.,402,355,346,140,206
ESENYURT,ORNEK MAH.,403,351,344,162,182
ESENYURT,ORNEK MAH.,403,349,343,160,183
ESENYURT,ORNEK MAH.,403,343,338,154,184
ESENYURT,ORNEK MAH.,403,360,353,178,175
ESENYURT,ORNEK MAH.,402,350,343,165,178
ESENYURT,ORNEK MAH.,403,361,358,139,219
ESENYURT,ORNEK MAH.,402,357,353,152,201
ESENYURT,ORNEK MAH.,405,351,346,137,209
ESENYURT,ORNEK MAH.,411,341,336,150,186
ESENYURT,ORNEK MAH.,415,353,341,196,145
ESENYURT,ORNEK MAH.,415,373,367,170,197
ESENYURT,ORNEK MAH.,415,362,356,175,181
ESENYURT,ORNEK MAH.,415,350,339,165,174
ESENYURT,ORNEK MAH.,412,363,353,194,159
ESENYURT,ORNEK MAH.,413,343,339,163,176
ESENYURT,ORNEK MAH.,413,367,362,161,201
ESENYURT,ORNEK MAH.,413,363,354,156,198
ESENYURT,ORNEK MAH.,415,367,356,187,169
ESENYURT,SAADETDERE MAH.,415,329,316,153,163
ESENYURT,SAADETDERE MAH.,410,323,314,153,161
ESENYURT,SAADETDERE MAH.,411,350,342,168,174
ESENYURT,SAADETDERE MAH.,411,374,371,216,155
ESENYURT,SAADETDERE MAH.,410,356,353,182,171
ESENYURT,SAADETDERE MAH.,411,362,352,179,173
ESENYURT,SAADETDERE MAH.,411,365,363,200,163
ESENYURT,SAADETDERE MAH.,411,353,349,158,191
ESENYURT,SAADETDERE MAH.,409,361,360,169,191
ESENYURT,SAADETDERE MAH.,410,366,363,194,169
ESENYURT,SAADETDERE MAH.,410,362,357,176,181
ESENYURT,SAADETDERE MAH.,410,369,365,209,156
ESENYURT,SAADETDERE MAH.,410,353,351,180,171
ESENYURT,SAADETDERE MAH.,410,357,354,168,186
ESENYURT,SAADETDERE MAH.,410,353,350,185,165
ESENYURT,SAADETDERE MAH.,409,380,371,179,192
ESENYURT,SAADETDERE MAH.,409,357,351,180,171
ESENYURT,SAADETDERE MAH.,410,349,344,180,164
ESENYURT,SAADETDERE MAH.,410,335,329,151,178
ESENYURT,SAADETDERE MAH.,410,371,368,194,174
ESENYURT,SAADETDERE MAH.,409,366,359,173,186
ESENYURT,SAADETDERE MAH.,410,366,363,200,163
ESENYURT,SAADETDERE MAH.,410,340,334,172,162
ESENYURT,SAADETDERE MAH.,409,359,352,158,194
ESENYURT,SAADETDERE MAH.,409,363,355,183,172
ESENYURT,SAADETDERE MAH.,415,356,349,189,160
ESENYURT,SAADETDERE MAH.,409,350,341,170,171
ESENYURT,SAADETDERE MAH.,410,361,356,205,151
ESENYURT,SAADETDERE MAH.,409,369,365,215,150
ESENYURT,SAADETDERE MAH.,409,365,361,183,178
ESENYURT,SAADETDERE MAH.,409,372,363,167,196
ESENYURT,SAADETDERE MAH.,410,345,345,196,149
ESENYURT,SAADETDERE MAH.,410,357,354,180,174
ESENYURT,SAADETDERE MAH.,409,376,367,189,178
ESENYURT,SAADETDERE MAH.,409,359,356,178,178
ESENYURT,SAADETDERE MAH.,409,358,356,189,167
ESENYURT,SELAHADDIN EYYUBI MAH.,403,303,297,126,171
ESENYURT,SELAHADDIN EYYUBI MAH.,401,330,325,141,184
ESENYURT,SELAHADDIN EYYUBI MAH.,403,344,337,171,166
ESENYURT,SELAHADDIN EYYUBI MAH.,402,331,326,146,180
ESENYURT,SELAHADDIN EYYUBI MAH.,408,339,333,139,194
ESENYURT,SELAHADDIN EYYUBI MAH.,403,336,334,158,176
ESENYURT,SELAHADDIN EYYUBI MAH.,401,331,320,144,176
ESENYURT,SELAHADDIN EYYUBI MAH.,403,334,325,133,192
ESENYURT,SELAHADDIN EYYUBI MAH.,404,357,351,157,194
ESENYURT,SELAHADDIN EYYUBI MAH.,404,353,343,154,189
ESENYURT,SELAHADDIN EYYUBI MAH.,404,342,331,140,191
ESENYURT,SELAHADDIN EYYUBI MAH.,402,339,335,151,184
ESENYURT,SELAHADDIN EYYUBI MAH.,403,338,329,131,198
ESENYURT,SELAHADDIN EYYUBI MAH.,402,341,335,151,184
ESENYURT,SELAHADDIN EYYUBI MAH.,401,327,320,140,180
ESENYURT,SELAHADDIN EYYUBI MAH.,402,333,331,177,154
ESENYURT,SELAHADDIN EYYUBI MAH.,401,366,364,165,199
ESENYURT,SELAHADDIN EYYUBI MAH.,402,348,340,145,195
ESENYURT,SELAHADDIN EYYUBI MAH.,401,355,336,164,172
ESENYURT,SELAHADDIN EYYUBI MAH.,402,344,338,148,190
ESENYURT,SELAHADDIN EYYUBI MAH.,403,350,344,154,190
ESENYURT,SELAHADDIN EYYUBI MAH.,401,345,336,147,189
ESENYURT,SELAHADDIN EYYUBI MAH.,401,322,311,146,165
ESENYURT,SELAHADDIN EYYUBI MAH.,401,339,333,142,191
ESENYURT,SELAHADDIN EYYUBI MAH.,406,348,343,133,210
ESENYURT,SELAHADDIN EYYUBI MAH.,401,327,324,134,190
ESENYURT,SELAHADDIN EYYUBI MAH.,402,359,354,150,204
ESENYURT,SELAHADDIN EYYUBI MAH.,398,336,329,166,163
ESENYURT,SELAHADDIN EYYUBI MAH.,398,323,317,156,161
ESENYURT,SELAHADDIN EYYUBI MAH.,399,332,329,170,159
ESENYURT,SELAHADDIN EYYUBI MAH.,402,331,327,136,191
ESENYURT,SULTANIYE MAH.,401,302,297,146,151
ESENYURT,SULTANIYE MAH.,399,333,320,166,154
ESENYURT,SULTANIYE MAH.,401,334,328,182,146
ESENYURT,SULTANIYE MAH.,401,332,328,156,172
ESENYURT,SULTANIYE MAH.,401,340,335,161,174
ESENYURT,SULTANIYE MAH.,401,339,336,175,161
ESENYURT,SULTANIYE MAH.,401,347,338,197,141
ESENYURT,SULTANIYE MAH.,401,350,347,184,163
ESENYURT,SULTANIYE MAH.,399,322,319,171,148
ESENYURT,SULTANIYE MAH.,401,349,344,220,124
ESENYURT,SULTANIYE MAH.,399,347,344,185,159
ESENYURT,SULTANIYE MAH.,401,333,329,161,168
ESENYURT,SULTANIYE MAH.,404,328,327,183,144
ESENYURT,SULTANIYE MAH.,392,333,326,187,139
ESENYURT,SULTANIYE MAH.,391,352,348,175,173
ESENYURT,SULTANIYE MAH.,392,339,332,161,171
ESENYURT,SULTANIYE MAH.,393,325,324,149,175
ESENYURT,SULTANIYE MAH.,393,327,314,166,148
ESENYURT,SULTANIYE MAH.,392,321,318,177,141
ESENYURT,SULTANIYE MAH.,392,330,329,176,153
ESENYURT,SULTANIYE MAH.,391,336,330,193,137
ESENYURT,SULTANIYE MAH.,391,333,329,194,135
ESENYURT,SULTANIYE MAH.,391,334,330,168,162
ESENYURT,SULTANIYE MAH.,391,346,342,171,171
ESENYURT,SULTANIYE MAH.,392,342,337,190,147
ESENYURT,SULTANIYE MAH.,391,343,340,195,145
ESENYURT,SULEYMANIYE MAH.,397,327,320,160,160
ESENYURT,SULEYMANIYE MAH.,396,331,323,154,169
ESENYURT,SULEYMANIYE MAH.,395,328,323,119,204
ESENYURT,SULEYMANIYE MAH.,395,327,322,166,156
ESENYURT,SULEYMANIYE MAH.,399,349,343,169,174
ESENYURT,SULEYMANIYE MAH.,396,343,341,153,188
ESENYURT,SULEYMANIYE MAH.,397,362,355,171,184
ESENYURT,SULEYMANIYE MAH.,396,352,349,201,148
ESENYURT,SULEYMANIYE MAH.,396,332,328,169,159
ESENYURT,SULEYMANIYE MAH.,397,353,342,186,156
ESENYURT,SULEYMANIYE MAH.,396,361,358,185,173
ESENYURT,SULEYMANIYE MAH.,397,362,357,149,208
ESENYURT,SULEYMANIYE MAH.,395,342,339,162,177
ESENYURT,SULEYMANIYE MAH.,397,350,349,189,160
ESENYURT,SULEYMANIYE MAH.,396,338,334,157,177
ESENYURT,SULEYMANIYE MAH.,397,339,332,166,166
ESENYURT,SULEYMANIYE MAH.,397,347,345,156,189
ESENYURT,SULEYMANIYE MAH.,397,335,330,159,171
ESENYURT,SULEYMANIYE MAH.,398,346,338,199,139
ESENYURT,SULEYMANIYE MAH.,409,320,317,147,170
ESENYURT,SULEYMANIYE MAH.,410,351,341,194,147
ESENYURT,SULEYMANIYE MAH.,410,363,361,176,185
ESENYURT,SULEYMANIYE MAH.,409,363,359,172,187
ESENYURT,SULEYMANIYE MAH.,409,359,353,181,172
ESENYURT,SULEYMANIYE MAH.,409,333,330,160,170
ESENYURT,SULEYMANIYE MAH.,409,359,344,176,168
ESENYURT,SULEYMANIYE MAH.,415,349,346,164,182
ESENYURT,SULEYMANIYE MAH.,409,353,350,182,168
ESENYURT,SULEYMANIYE MAH.,410,369,362,181,181
ESENYURT,SULEYMANIYE MAH.,409,365,355,170,185
ESENYURT,SULEYMANIYE MAH.,409,359,350,198,152
ESENYURT,SULEYMANIYE MAH.,409,351,347,161,186
ESENYURT,SULEYMANIYE MAH.,409,353,350,171,179
ESENYURT,SULEYMANIYE MAH.,409,334,329,169,160
ESENYURT,SULEYMANIYE MAH.,410,372,368,178,190
ESENYURT,SULEYMANIYE MAH.,410,357,353,158,195
ESENYURT,SULEYMANIYE MAH.,408,353,350,183,167
ESENYURT,SULEYMANIYE MAH.,408,369,362,171,191
ESENYURT,SULEYMANIYE MAH.,409,358,353,176,177
ESENYURT,SULEYMANIYE MAH.,409,355,344,167,177
ESENYURT,SULEYMANIYE MAH.,410,350,345,189,156
ESENYURT,SULEYMANIYE MAH.,409,359,353,177,176
ESENYURT,SULEYMANIYE MAH.,409,365,353,195,158
ESENYURT,TURGUT OZAL MAH.,407,345,337,170,167
ESENYURT,TURGUT OZAL MAH.,406,347,341,182,159
ESENYURT,TURGUT OZAL MAH.,411,363,355,169,186
ESENYURT,TURGUT OZAL MAH.,406,354,350,192,158
ESENYURT,TURGUT OZAL MAH.,406,345,343,190,153
ESENYURT,TURGUT OZAL MAH.,407,345,343,185,158
ESENYURT,TURGUT OZAL MAH.,406,344,339,187,152
ESENYURT,TURGUT OZAL MAH.,407,362,356,180,176
ESENYURT,TURGUT OZAL MAH.,406,357,352,214,138
ESENYURT,TURGUT OZAL MAH.,406,351,344,167,177
ESENYURT,TURGUT OZAL MAH.,407,358,352,182,170
ESENYURT,TURGUT OZAL MAH.,407,358,353,174,179
ESENYURT,TURGUT OZAL MAH.,407,361,357,195,162
ESENYURT,TURGUT OZAL MAH.,407,362,357,206,151
ESENYURT,TURGUT OZAL MAH.,406,360,353,180,173
ESENYURT,TURGUT OZAL MAH.,406,352,344,196,148
ESENYURT,TURGUT OZAL MAH.,407,358,351,179,172
ESENYURT,TURGUT OZAL MAH.,406,346,339,181,158
ESENYURT,TURGUT OZAL MAH.,406,368,363,218,145
ESENYURT,TURGUT OZAL MAH.,406,363,356,217,139
ESENYURT,TURGUT OZAL MAH.,407,354,347,193,154
ESENYURT,TURGUT OZAL MAH.,407,352,346,159,187
ESENYURT,TURGUT OZAL MAH.,407,359,354,190,164
ESENYURT,TURGUT OZAL MAH.,407,353,345,180,165
ESENYURT,TURGUT OZAL MAH.,391,332,327,134,193
ESENYURT,TURGUT OZAL MAH.,392,339,330,139,191
ESENYURT,TURGUT OZAL MAH.,393,342,338,141,197
ESENYURT,TURGUT OZAL MAH.,394,346,340,156,184
ESENYURT,TURGUT OZAL MAH.,390,337,330,165,165
ESENYURT,TURGUT OZAL MAH.,390,335,333,162,171
ESENYURT,TURGUT OZAL MAH.,391,353,346,158,188
ESENYURT,TURGUT OZAL MAH.,390,349,349,180,169
ESENYURT,TURGUT OZAL MAH.,390,349,344,172,172
ESENYURT,TURGUT OZAL MAH.,390,358,350,156,194
ESENYURT,TURGUT OZAL MAH.,391,336,333,162,171
ESENYURT,TURGUT OZAL MAH.,391,341,337,179,158
ESENYURT,TURGUT OZAL MAH.,390,348,347,171,176
ESENYURT,TURGUT OZAL MAH.,390,343,337,158,179
ESENYURT,TURGUT OZAL MAH.,391,348,343,176,167
ESENYURT,TURGUT OZAL MAH.,391,345,339,147,192
ESENYURT,UCEVLER MAH.,403,326,323,164,159
ESENYURT,UCEVLER MAH.,402,344,339,164,175
ESENYURT,UCEVLER MAH.,405,354,344,180,164
ESENYURT,UCEVLER MAH.,402,344,337,143,194
ESENYURT,UCEVLER MAH.,403,358,355,175,180
ESENYURT,UCEVLER MAH.,402,345,339,169,170
ESENYURT,UCEVLER MAH.,403,341,333,143,190
ESENYURT,UCEVLER MAH.,403,353,349,184,165
ESENYURT,UCEVLER MAH.,403,354,348,156,192
ESENYURT,UCEVLER MAH.,402,347,339,170,169
ESENYURT,UCEVLER MAH.,403,353,348,149,199
ESENYURT,UCEVLER MAH.,403,344,337,188,149
ESENYURT,UCEVLER MAH.,403,354,351,204,147
ESENYURT,UCEVLER MAH.,402,346,342,144,198
ESENYURT,UCEVLER MAH.,402,343,338,169,169
ESENYURT,UCEVLER MAH.,402,342,333,157,176
ESENYURT,UCEVLER MAH.,402,326,321,161,160
ESENYURT,UCEVLER MAH.,402,349,347,163,184
ESENYURT,UCEVLER MAH.,403,349,342,179,163
ESENYURT,UCEVLER MAH.,402,333,325,141,184
ESENYURT,UCEVLER MAH.,403,362,361,186,175
ESENYURT,UCEVLER MAH.,402,340,334,150,184
ESENYURT,UCEVLER MAH.,402,328,323,164,159
ESENYURT,UCEVLER MAH.,402,348,341,176,165
ESENYURT,UCEVLER MAH.,397,325,314,168,146
ESENYURT,UCEVLER MAH.,396,325,315,158,157
ESENYURT,UCEVLER MAH.,400,351,347,175,172
ESENYURT,UCEVLER MAH.,398,345,341,166,175
ESENYURT,UCEVLER MAH.,397,338,327,178,149
ESENYURT,UCEVLER MAH.,396,332,332,152,180
ESENYURT,UCEVLER MAH.,398,342,336,154,182
ESENYURT,UCEVLER MAH.,398,335,331,163,168
ESENYURT,UCEVLER MAH.,398,327,317,163,154
ESENYURT,UCEVLER MAH.,398,365,358,165,193
ESENYURT,UCEVLER MAH.,397,319,311,154,157
ESENYURT,UCEVLER MAH.,398,332,327,171,156
ESENYURT,UCEVLER MAH.,397,351,343,175,168
ESENYURT,UCEVLER MAH.,398,337,329,147,182
ESENYURT,UCEVLER MAH.,398,334,332,179,153
ESENYURT,YENIKENT MAH.,396,341,336,139,197
ESENYURT,YENIKENT MAH.,398,345,338,125,213
ESENYURT,YENIKENT MAH.,398,334,330,152,178
ESENYURT,YENIKENT MAH.,397,330,324,153,171
ESENYURT,YENIKENT MAH.,397,346,344,147,197
ESENYURT,YENIKENT MAH.,398,352,346,164,182
ESENYURT,YENIKENT MAH.,398,357,356,146,210
ESENYURT,YENIKENT MAH.,397,352,347,159,188
ESENYURT,YENIKENT MAH.,397,344,337,189,148
ESENYURT,YENIKENT MAH.,397,333,332,156,176
ESENYURT,YENIKENT MAH.,398,338,335,155,180
ESENYURT,YENIKENT MAH.,415,332,326,119,207
ESENYURT,YENIKENT MAH.,411,338,336,141,195
ESENYURT,YENIKENT MAH.,415,377,371,154,217
ESENYURT,YENIKENT MAH.,412,344,340,142,198
ESENYURT,YENIKENT MAH.,415,357,347,141,206
ESENYURT,YENIKENT MAH.,415,352,345,147,198
ESENYURT,YENIKENT MAH.,412,360,356,169,187
ESENYURT,YENIKENT MAH.,410,334,328,150,178
ESENYURT,YENIKENT MAH.,411,361,356,164,192
ESENYURT,YENIKENT MAH.,411,362,359,177,182
ESENYURT,YENIKENT MAH.,411,350,342,157,185
ESENYURT,YENIKENT MAH.,411,357,349,143,206
ESENYURT,YENIKENT MAH.,410,348,343,150,193
ESENYURT,YENIKENT MAH.,411,360,355,149,206
ESENYURT,YENIKENT MAH.,410,328,323,136,187
ESENYURT,YENIKENT MAH.,410,353,350,162,188
ESENYURT,YENIKENT MAH.,410,366,362,174,188
ESENYURT,YENIKENT MAH.,411,369,366,155,211
ESENYURT,YENIKENT MAH.,410,362,355,188,167
ESENYURT,YENIKENT MAH.,412,357,351,177,174
ESENYURT,YENIKENT MAH.,411,357,347,162,185
ESENYURT,YUNUS EMRE MAH.,367,314,306,161,145
ESENYURT,YUNUS EMRE MAH.,367,320,317,159,158
ESENYURT,YUNUS EMRE MAH.,367,324,317,198,119
ESENYURT,YUNUS EMRE MAH.,367,328,322,181,141
ESENYURT,YUNUS EMRE MAH.,367,337,333,156,177
ESENYURT,YUNUS EMRE MAH.,415,326,315,113,202
ESENYURT,YUNUS EMRE MAH.,415,323,308,136,172
ESENYURT,YUNUS EMRE MAH.,414,357,347,148,199
ESENYURT,YUNUS EMRE MAH.,415,347,339,173,166
ESENYURT,YUNUS EMRE MAH.,414,376,363,184,179
ESENYURT,YUNUS EMRE MAH.,414,367,358,158,200
ESENYURT,YUNUS EMRE MAH.,414,352,342,168,174
ESENYURT,YUNUS EMRE MAH.,415,348,347,181,166
ESENYURT,YUNUS EMRE MAH.,414,368,357,187,170
ESENYURT,YUNUS EMRE MAH.,414,370,356,156,200
ESENYURT,YUNUS EMRE MAH.,414,365,351,181,170
ESENYURT,YUNUS EMRE MAH.,415,368,364,172,192
ESENYURT,YUNUS EMRE MAH.,415,354,349,174,175
ESENYURT,YUNUS EMRE MAH.,415,351,340,162,178
ESENYURT,YUNUS EMRE MAH.,414,347,335,180,155
ESENYURT,YUNUS EMRE MAH.,414,349,341,173,168
ESENYURT,YUNUS EMRE MAH.,413,367,363,177,186
ESENYURT,YUNUS EMRE MAH.,413,351,342,170,172
ESENYURT,YUNUS EMRE MAH.,415,346,339,153,186
ESENYURT,YUNUS EMRE MAH.,412,349,346,166,180
ESENYURT,YUNUS EMRE MAH.,411,352,348,194,154
ESENYURT,YUNUS EMRE MAH.,413,336,325,177,148
ESENYURT,YUNUS EMRE MAH.,413,358,354,177,177
ESENYURT,YUNUS EMRE MAH.,412,359,353,165,188
ESENYURT,ZAFER MAH.,402,333,327,131,196
ESENYURT,ZAFER MAH.,402,352,348,155,193
ESENYURT,ZAFER MAH.,402,334,330,134,196
ESENYURT,ZAFER MAH.,401,343,339,150,189
ESENYURT,ZAFER MAH.,402,332,331,135,196
ESENYURT,ZAFER MAH.,402,358,350,148,202
ESENYURT,ZAFER MAH.,401,338,338,144,194
ESENYURT,ZAFER MAH.,402,347,337,136,201
ESENYURT,ZAFER MAH.,401,336,330,105,225
ESENYURT,ZAFER MAH.,401,353,349,147,202
ESENYURT,ZAFER MAH.,401,353,347,149,198
ESENYURT,ZAFER MAH.,402,358,352,132,220
ESENYURT,ZAFER MAH.,401,348,340,139,201
ESENYURT,ZAFER MAH.,401,338,337,152,185
ESENYURT,AKCABURGAZ MAH.,406,363,360,241,119
ESENYURT,AKCABURGAZ MAH.,415,353,345,240,105
ESENYURT,AKCABURGAZ MAH.,406,351,347,240,107
ESENYURT,AKCABURGAZ MAH.,408,369,356,238,118
ESENYURT,AKCABURGAZ MAH.,407,345,341,225,116
ESENYURT,AKCABURGAZ MAH.,407,376,366,265,101
ESENYURT,AKCABURGAZ MAH.,406,363,360,253,107
ESENYURT,AKCABURGAZ MAH.,405,352,345,236,109
ESENYURT,AKCABURGAZ MAH.,406,350,348,244,104
ESENYURT,AKCABURGAZ MAH.,406,352,345,232,113
ESENYURT,AKCABURGAZ MAH.,409,342,340,255,85
ESENYURT,AKCABURGAZ MAH.,407,359,352,246,106
ESENYURT,AKCABURGAZ MAH.,406,362,356,240,116
ESENYURT,AKCABURGAZ MAH.,408,359,356,254,102
ESENYURT,AKCABURGAZ MAH.,407,363,355,243,112
ESENYURT,AKCABURGAZ MAH.,406,346,341,236,105
ESENYURT,AKCABURGAZ MAH.,407,353,347,245,102
ESENYURT,AKCABURGAZ MAH.,407,367,363,247,116
ESENYURT,AKCABURGAZ MAH.,407,365,359,238,121
ESENYURT,AKCABURGAZ MAH.,407,355,349,257,92
ESENYURT,AKCABURGAZ MAH.,406,355,352,236,116
ESENYURT,AKCABURGAZ MAH.,405,356,351,237,114
ESENYURT,AKCABURGAZ MAH.,407,363,360,267,93
ESENYURT,AKCABURGAZ MAH.,406,347,342,254,88
ESENYURT,AKCABURGAZ MAH.,406,352,335,228,107
ESENYURT,AKCABURGAZ MAH.,407,368,349,225,124
ESENYURT,AKCABURGAZ MAH.,405,352,347,236,111
ESENYURT,AKEVLER MAH.,407,336,330,157,173
ESENYURT,AKEVLER MAH.,408,331,329,119,210
ESENYURT,AKEVLER MAH.,407,338,336,132,204
ESENYURT,AKEVLER MAH.,407,339,332,123,209
ESENYURT,AKEVLER MAH.,407,328,325,110,215
ESENYURT,AKEVLER MAH.,407,332,329,112,217
ESENYURT,AKEVLER MAH.,407,327,326,108,218
ESENYURT,AKEVLER MAH.,407,352,348,110,238
ESENYURT,AKEVLER MAH.,407,340,333,126,207
ESENYURT,AKEVLER MAH.,408,335,331,135,196
ESENYURT,AKEVLER MAH.,407,333,329,102,227
ESENYURT,AKEVLER MAH.,407,343,338,127,211
ESENYURT,AKEVLER MAH.,407,340,336,101,235
ESENYURT,AKEVLER MAH.,407,339,336,126,210
ESENYURT,AKEVLER MAH.,408,329,328,118,210
ESENYURT,ATATURK MAH.,404,355,344,79,265
ESENYURT,ATATURK MAH.,402,348,338,133,205
ESENYURT,ATATURK MAH.,399,348,346,128,218
ESENYURT,ATATURK MAH.,400,347,337,135,202
ESENYURT,ATATURK MAH.,399,363,357,124,233
ESENYURT,ATATURK MAH.,399,353,345,131,214
ESENYURT,ATATURK MAH.,399,353,344,107,237
ESENYURT,ATATURK MAH.,399,354,347,110,237
ESENYURT,ATATURK MAH.,399,343,337,119,218
ESENYURT,ATATURK MAH.,400,355,348,128,220
ESENYURT,ATATURK MAH.,400,354,349,101,248
ESENYURT,ATATURK MAH.,399,351,344,136,208
ESENYURT,ATATURK MAH.,400,343,337,158,179
ESENYURT,ATATURK MAH.,400,348,344,148,196
ESENYURT,ATATURK MAH.,400,336,331,119,212
ESENYURT,ATATURK MAH.,399,363,357,144,213
ESENYURT,ATATURK MAH.,400,370,362,129,233
ESENYURT,ATATURK MAH.,399,350,349,117,232
ESENYURT,ATATURK MAH.,400,356,348,134,214
ESENYURT,BARBAROS HAYRETTIN PASA MAH.,411,326,323,93,230
ESENYURT,BARBAROS HAYRETTIN PASA MAH.,411,355,353,100,253
ESENYURT,BARBAROS HAYRETTIN PASA MAH.,411,343,339,111,228
ESENYURT,BARBAROS HAYRETTIN PASA MAH.,410,351,350,118,232
ESENYURT,BARBAROS HAYRETTIN PASA MAH.,410,367,364,99,265
ESENYURT,BARBAROS HAYRETTIN PASA MAH.,410,357,352,93,259
ESENYURT,BARBAROS HAYRETTIN PASA MAH.,411,365,362,98,264
ESENYURT,BARBAROS HAYRETTIN PASA MAH.,410,354,353,103,250
ESENYURT,BARBAROS HAYRETTIN PASA MAH.,410,370,365,98,267
ESENYURT,BARBAROS HAYRETTIN PASA MAH.,411,380,378,98,280
ESENYURT,BARBAROS HAYRETTIN PASA MAH.,410,361,360,107,253
ESENYURT,BARBAROS HAYRETTIN PASA MAH.,411,358,355,89,266
ESENYURT,BARBAROS HAYRETTIN PASA MAH.,410,369,367,126,241
ESENYURT,BARBAROS HAYRETTIN PASA MAH.,409,357,354,95,259
ESENYURT,BARBAROS HAYRETTIN PASA MAH.,410,370,367,119,248
ESENYURT,BARBAROS HAYRETTIN PASA MAH.,410,369,369,90,279
ESENYURT,BARBAROS HAYRETTIN PASA MAH.,410,367,364,102,262
ESENYURT,BARBAROS HAYRETTIN PASA MAH.,410,355,351,103,248
ESENYURT,BARBAROS HAYRETTIN PASA MAH.,410,380,376,113,263
ESENYURT,BARBAROS HAYRETTIN PASA MAH.,410,370,363,93,270
ESENYURT,BARBAROS HAYRETTIN PASA MAH.,410,359,358,113,245
ESENYURT,BARBAROS HAYRETTIN PASA MAH.,410,360,357,116,241
ESENYURT,BARBAROS HAYRETTIN PASA MAH.,404,337,329,114,215
ESENYURT,BARBAROS HAYRETTIN PASA MAH.,404,340,336,108,228
ESENYURT,BARBAROS HAYRETTIN PASA MAH.,407,367,362,110,252
ESENYURT,BARBAROS HAYRETTIN PASA MAH.,405,357,350,119,231
ESENYURT,BARBAROS HAYRETTIN PASA MAH.,405,359,354,118,236
ESENYURT,BARBAROS HAYRETTIN PASA MAH.,405,367,362,128,234
ESENYURT,BARBAROS HAYRETTIN PASA MAH.,405,362,356,128,228
ESENYURT,BARBAROS HAYRETTIN PASA MAH.,404,371,367,129,238
ESENYURT,BARBAROS HAYRETTIN PASA MAH.,404,345,340,110,230
ESENYURT,BARBAROS HAYRETTIN PASA MAH.,404,351,348,101,247
ESENYURT,BARBAROS HAYRETTIN PASA MAH.,404,366,362,117,245
ESENYURT,BATTALGAZI MAH.,415,344,337,164,173
ESENYURT,BATTALGAZI MAH.,415,353,351,174,177
ESENYURT,BATTALGAZI MAH.,411,359,356,204,152
ESENYURT,BATTALGAZI MAH.,410,357,352,212,140
ESENYURT,BATTALGAZI MAH.,411,351,346,178,168
ESENYURT,BATTALGAZI MAH.,411,350,338,159,179
ESENYURT,BATTALGAZI MAH.,409,346,344,196,148
ESENYURT,BATTALGAZI MAH.,409,363,357,190,167
ESENYURT,BATTALGAZI MAH.,410,336,328,175,153
ESENYURT,BATTALGAZI MAH.,411,346,340,176,164
ESENYURT,BATTALGAZI MAH.,411,352,349,148,201
ESENYURT,BATTALGAZI MAH.,410,361,355,151,204
ESENYURT,BATTALGAZI MAH.,410,348,342,160,182
ESENYURT,BATTALGAZI MAH.,411,365,355,188,167
ESENYURT,BATTALGAZI MAH.,411,357,345,191,154
ESENYURT,BATTALGAZI MAH.,411,363,356,184,172
ESENYURT,BATTALGAZI MAH.,411,352,346,185,161
ESENYURT,BATTALGAZI MAH.,409,352,341,173,168
ESENYURT,BATTALGAZI MAH.,410,343,334,183,151
ESENYURT,BATTALGAZI MAH.,410,341,331,179,152
ESENYURT,BATTALGAZI MAH.,409,358,353,204,149
ESENYURT,BATTALGAZI MAH.,411,343,333,191,142
ESENYURT,BATTALGAZI MAH.,410,354,351,204,147
ESENYURT,CUMHURIYET MAH.,413,343,339,96,243
ESENYURT,CUMHURIYET MAH.,412,373,369,132,237
ESENYURT,CUMHURIYET MAH.,412,372,364,112,252
ESENYURT,CUMHURIYET MAH.,415,373,369,111,258
ESENYURT,CUMHURIYET MAH.,412,366,363,127,236
ESENYURT,CUMHURIYET MAH.,411,361,355,99,256
ESENYURT,CUMHURIYET MAH.,412,367,363,136,227
ESENYURT,CUMHURIYET MAH.,412,368,365,119,246
ESENYURT,CUMHURIYET MAH.,412,375,371,116,255
ESENYURT,CUMHURIYET MAH.,412,375,374,114,260
ESENYURT,CUMHURIYET MAH.,412,355,349,118,231
ESENYURT,CUMHURIYET MAH.,412,367,365,100,265
ESENYURT,CUMHURIYET MAH.,412,375,371,115,256
ESENYURT,CUMHURIYET MAH.,412,385,383,114,269
ESENYURT,CUMHURIYET MAH.,411,372,370,130,240
ESENYURT,CUMHURIYET MAH.,412,377,369,129,240
ESENYURT,CUMHURIYET MAH.,411,378,375,115,260
ESENYURT,CUMHURIYET MAH.,412,376,374,134,240
ESENYURT,CUMHURIYET MAH.,411,375,371,126,245
ESENYURT,CUMHURIYET MAH.,411,353,345,114,231
ESENYURT,CUMHURIYET MAH.,411,353,342,119,223
ESENYURT,CUMHURIYET MAH.,411,361,356,110,246
ESENYURT,CUMHURIYET MAH.,411,360,356,102,254
ESENYURT,GOKEVLER MAH.,387,309,304,134,170
ESENYURT,GOKEVLER MAH.,387,329,327,143,184
ESENYURT,GOKEVLER MAH.,388,323,318,131,187
ESENYURT,GOKEVLER MAH.,388,335,332,156,176
ESENYURT,GOKEVLER MAH.,388,355,353,147,206
ESENYURT,GOKEVLER MAH.,387,330,323,124,199
ESENYURT,GOKEVLER MAH.,387,334,334,135,199
ESENYURT,GOKEVLER MAH.,386,333,325,131,194
ESENYURT,GOKEVLER MAH.,387,353,351,160,191
ESENYURT,GOKEVLER MAH.,387,335,331,153,178
ESENYURT,GOKEVLER MAH.,387,334,334,138,196
ESENYURT,GOKEVLER MAH.,387,346,336,146,190
ESENYURT,GUZELYURT MAH.,393,341,336,158,178
ESENYURT,GUZELYURT MAH.,393,351,348,190,158
ESENYURT,GUZELYURT MAH.,394,342,338,208,130
ESENYURT,GUZELYURT MAH.,393,331,329,186,143
ESENYURT,GUZELYURT MAH.,393,334,328,157,171
ESENYURT,GUZELYURT MAH.,395,344,339,178,161
ESENYURT,GUZELYURT MAH.,394,350,348,173,175
ESENYURT,GUZELYURT MAH.,392,334,330,182,148
ESENYURT,GUZELYURT MAH.,392,341,334,187,147
ESENYURT,GUZELYURT MAH.,393,324,316,162,154
ESENYURT,GUZELYURT MAH.,394,324,320,189,131
ESENYURT,GUZELYURT MAH.,393,351,345,200,145
ESENYURT,GUZELYURT MAH.,392,333,328,191,137
ESENYURT,GUZELYURT MAH.,392,325,319,152,167
ESENYURT,GUZELYURT MAH.,393,335,327,160,167
ESENYURT,GUZELYURT MAH.,393,348,345,194,151
ESENYURT,GUZELYURT MAH.,393,328,327,179,148
ESENYURT,GUZELYURT MAH.,392,330,323,174,149
ESENYURT,GUZELYURT MAH.,393,347,344,183,161
ESENYURT,GUZELYURT MAH.,393,334,329,196,133
ESENYURT,GUZELYURT MAH.,393,328,324,191,133
ESENYURT,GUZELYURT MAH.,392,346,342,179,163
ESENYURT,GUZELYURT MAH.,393,337,333,176,157
ESENYURT,HURRIYET MAH.,388,321,317,129,188
ESENYURT,HURRIYET MAH.,388,341,335,177,158
ESENYURT,HURRIYET MAH.,388,333,326,176,150
ESENYURT,HURRIYET MAH.,390,345,342,209,133
ESENYURT,HURRIYET MAH.,387,333,328,169,159
ESENYURT,HURRIYET MAH.,388,338,328,156,172
ESENYURT,HURRIYET MAH.,388,337,331,185,146
ESENYURT,HURRIYET MAH.,387,334,330,178,152
ESENYURT,HURRIYET MAH.,391,341,334,176,158
ESENYURT,HURRIYET MAH.,388,341,330,164,166
ESENYURT,HURRIYET MAH.,388,332,322,173,149
ESENYURT,HURRIYET MAH.,389,310,307,145,162
ESENYURT,HURRIYET MAH.,388,344,338,169,169
ESENYURT,HURRIYET MAH.,389,325,323,194,129
ESENYURT,HURRIYET MAH.,412,340,328,161,167
ESENYURT,HURRIYET MAH.,415,355,347,168,179
ESENYURT,HURRIYET MAH.,411,351,346,167,179
ESENYURT,HURRIYET MAH.,415,359,349,176,173
ESENYURT,HURRIYET MAH.,415,368,362,186,176
ESENYURT,HURRIYET MAH.,411,349,347,182,165
ESENYURT,HURRIYET MAH.,415,359,345,202,143
ESENYURT,HURRIYET MAH.,415,365,360,203,157
ESENYURT,HURRIYET MAH.,415,358,354,203,151
ESENYURT,HURRIYET MAH.,413,344,341,202,139
ESENYURT,HURRIYET MAH.,415,347,339,192,147
ESENYURT,HURRIYET MAH.,415,340,335,209,126
ESENYURT,HURRIYET MAH.,415,351,334,192,142
ESENYURT,HURRIYET MAH.,415,356,351,175,176
ESENYURT,HURRIYET MAH.,415,349,345,201,144
ESENYURT,HURRIYET MAH.,415,375,371,188,183
ESENYURT,HURRIYET MAH.,411,347,346,181,165
ESENYURT,HURRIYET MAH.,415,356,351,217,134
ESENYURT,HURRIYET MAH.,415,371,363,212,151
ESENYURT,HURRIYET MAH.,415,375,363,186,177
ESENYURT,HURRIYET MAH.,412,362,350,174,176
ESENYURT,HURRIYET MAH.,412,357,346,186,160
ESENYURT,ISTIKLAL MAH.,403,346,334,154,180
ESENYURT,ISTIKLAL MAH.,403,329,325,194,131
ESENYURT,ISTIKLAL MAH.,403,346,339,188,151
ESENYURT,ISTIKLAL MAH.,404,359,355,193,162
ESENYURT,ISTIKLAL MAH.,402,352,347,225,122
ESENYURT,ISTIKLAL MAH.,403,341,335,204,131
ESENYURT,ISTIKLAL MAH.,403,357,354,202,152
ESENYURT,ISTIKLAL MAH.,404,360,356,199,157
ESENYURT,ISTIKLAL MAH.,403,363,356,200,156
ESENYURT,ISTIKLAL MAH.,403,344,339,209,130
ESENYURT,ISTIKLAL MAH.,404,356,351,212,139
ESENYURT,ISTIKLAL MAH.,404,353,343,200,143
ESENYURT,ISTIKLAL MAH.,404,361,349,211,138
ESENYURT,ISTIKLAL MAH.,404,356,350,220,130
ESENYURT,ISTIKLAL MAH.,404,349,348,249,99
ESENYURT,ISTIKLAL MAH.,404,347,343,230,113
ESENYURT,ISTIKLAL MAH.,404,356,351,191,160
ESENYURT,ISTIKLAL MAH.,404,361,356,207,149
ESENYURT,ISTIKLAL MAH.,405,368,365,216,149
ESENYURT,ISTIKLAL MAH.,404,370,362,235,127
ESENYURT,ISTIKLAL MAH.,404,367,356,223,133
ESENYURT,ISTIKLAL MAH.,403,356,354,207,147
ESENYURT,ISTIKLAL MAH.,404,344,341,220,121
ESENYURT,ISTIKLAL MAH.,404,348,345,224,121
ESENYURT,ISTIKLAL MAH.,404,356,346,193,153
ESENYURT,ISTIKLAL MAH.,404,348,344,203,141
ESENYURT,ISTIKLAL MAH.,405,357,354,222,132
ESENYURT,ISTIKLAL MAH.,403,340,333,186,147
ESENYURT,MEHMET AKIF ERSOY MAH.,397,337,332,166,166
ESENYURT,MEHMET AKIF ERSOY MAH.,395,338,332,164,168
ESENYURT,MEHMET AKIF ERSOY MAH.,395,331,327,164,163
ESENYURT,MEHMET AKIF ERSOY MAH.,396,340,333,192,141
ESENYURT,MEHMET AKIF ERSOY MAH.,397,314,312,158,154
ESENYURT,MEHMET AKIF ERSOY MAH.,395,341,334,202,132
ESENYURT,MEHMET AKIF ERSOY MAH.,395,346,341,177,164
ESENYURT,MEHMET AKIF ERSOY MAH.,395,329,325,163,162
ESENYURT,MEHMET AKIF ERSOY MAH.,395,347,342,176,166
ESENYURT,MEHMET AKIF ERSOY MAH.,395,342,338,196,142
ESENYURT,MEHMET AKIF ERSOY MAH.,395,331,328,176,152
ESENYURT,MEHMET AKIF ERSOY MAH.,415,337,330,174,156
ESENYURT,MEHMET AKIF ERSOY MAH.,415,336,330,190,140
ESENYURT,MEHMET AKIF ERSOY MAH.,417,366,362,215,147
ESENYURT,MEHMET AKIF ERSOY MAH.,415,355,349,188,161
ESENYURT,MEHMET AKIF ERSOY MAH.,417,340,333,188,145
ESENYURT,MEHMET AKIF ERSOY MAH.,415,355,352,206,146
ESENYURT,MEHMET AKIF ERSOY MAH.,415,343,336,159,177
ESENYURT,MEHMET AKIF ERSOY MAH.,415,350,344,191,153
ESENYURT,MEHMET AKIF ERSOY MAH.,412,344,339,210,129
ESENYURT,MEHMET AKIF ERSOY MAH.,412,349,342,205,137
ESENYURT,MEHMET AKIF ERSOY MAH.,412,360,356,218,138
ESENYURT,MEHMET AKIF ERSOY MAH.,415,341,337,206,131
ESENYURT,MEHMET AKIF ERSOY MAH.,413,361,358,186,172
ESENYURT,MEHMET AKIF ERSOY MAH.,413,347,344,189,155
ESENYURT,MEHMET AKIF ERSOY MAH.,417,351,347,188,159
ESENYURT,MEHMET AKIF ERSOY MAH.,413,348,342,175,167
ESENYURT,MEHMET AKIF ERSOY MAH.,417,349,345,205,140
ESENYURT,MEHMET AKIF ERSOY MAH.,416,369,365,183,182
ESENYURT,MEHMET AKIF ERSOY MAH.,413,360,356,202,154
ESENYURT,MEHMET AKIF ERSOY MAH.,413,329,327,179,148
ESENYURT,MEHMET AKIF ERSOY MAH.,413,348,345,179,166
ESENYURT,MEHMET AKIF ERSOY MAH.,415,339,337,195,142
ESENYURT,MEHMET AKIF ERSOY MAH.,414,338,337,184,153
ESENYURT,MEHMET AKIF ERSOY MAH.,414,368,366,213,153
ESENYURT,MEHTERCESME MAH.,400,313,308,135,173
ESENYURT,MEHTERCESME MAH.,399,336,333,182,151
ESENYURT,MEHTERCESME MAH.,399,346,343,187,156
ESENYURT,MEHTERCESME MAH.,400,334,330,145,185
ESENYURT,MEHTERCESME MAH.,398,346,337,168,169
ESENYURT,MEHTERCESME MAH.,400,328,323,163,160
ESENYURT,MEHTERCESME MAH.,399,340,336,137,199
ESENYURT,MEHTERCESME MAH.,400,354,349,151,198
ESENYURT,MEHTERCESME MAH.,398,329,328,154,174
ESENYURT,MEHTERCESME MAH.,400,352,348,151,197
ESENYURT,MEHTERCESME MAH.,400,338,337,148,189
ESENYURT,MEHTERCESME MAH.,400,348,346,151,195
ESENYURT,MEHTERCESME MAH.,400,335,325,135,190
ESENYURT,MEHTERCESME MAH.,400,340,335,197,138
ESENYURT,MEHTERCESME MAH.,398,357,353,179,174
ESENYURT,MEHTERCESME MAH.,400,348,343,154,189
ESENYURT,MEHTERCESME MAH.,400,346,339,176,163
ESENYURT,MEHTERCESME MAH.,399,358,354,180,174
ESENYURT,MEHTERCESME MAH.,400,350,348,165,183
ESENYURT,MEHTERCESME MAH.,400,345,344,140,204
ESENYURT,MEHTERCESME MAH.,400,345,338,181,157
ESENYURT,MEHTERCESME MAH.,399,344,340,150,190
ESENYURT,MEHTERCESME MAH.,400,344,335,152,183
ESENYURT,MEHTERCESME MAH.,400,353,342,189,153
ESENYURT,MEHTERCESME MAH.,400,338,333,151,182
ESENYURT,MEHTERCESME MAH.,406,333,323,152,171
ESENYURT,MEHTERCESME MAH.,405,337,329,161,168
ESENYURT,MEHTERCESME MAH.,407,354,351,190,161
ESENYURT,MEHTERCESME MAH.,405,350,345,179,166
ESENYURT,MEHTERCESME MAH.,405,349,344,190,154
ESENYURT,MEHTERCESME MAH.,405,364,357,188,169
ESENYURT,MEHTERCESME MAH.,405,345,337,165,172
ESENYURT,MEHTERCESME MAH.,406,350,345,164,181
ESENYURT,MEHTERCESME MAH.,406,354,349,194,155
ESENYURT,MEHTERCESME MAH.,405,335,334,168,166
ESENYURT,MEHTERCESME MAH.,405,343,339,175,164
ESENYURT,MEHTERCESME MAH.,405,340,336,165,171
ESENYURT,MEHTERCESME MAH.,404,357,349,173,176
ESENYURT,MEHTERCESME MAH.,404,352,349,166,183
ESENYURT,MEHTERCESME MAH.,405,352,348,169,179
ESENYURT,MEHTERCESME MAH.,405,360,353,169,184
ESENYURT,MEHTERCESME MAH.,405,363,357,189,168
ESENYURT,MEHTERCESME MAH.,404,350,348,201,147
ESENYURT,MEHTERCESME MAH.,405,346,342,173,169
ESENYURT,MEHTERCESME MAH.,404,348,339,173,166
ESENYURT,MEHTERCESME MAH.,406,352,349,179,170
ESENYURT,MEHTERCESME MAH.,405,357,351,147,204
ESENYURT,MEHTERCESME MAH.,404,348,342,193,149
ESENYURT,MEHTERCESME MAH.,406,347,344,177,167
ESENYURT,MEHTERCESME MAH.,404,358,354,197,157
ESENYURT,MEHTERCESME MAH.,405,359,355,177,178
ESENYURT,MEHTERCESME MAH.,404,353,352,189,163
ESENYURT,MEHTERCESME MAH.,406,334,325,169,156
ESENYURT,MEHTERCESME MAH.,404,348,345,187,158
ESENYURT,MEHTERCESME MAH.,405,335,328,173,155
ESENYURT,MEHTERCESME MAH.,405,339,333,156,177
ESENYURT,MEHTERCESME MAH.,405,350,346,152,194
ESENYURT,MEVLANA MAH.,404,325,323,73,250
ESENYURT,MEVLANA MAH.,403,341,335,71,264
ESENYURT,MEVLANA MAH.,402,352,349,114,235
ESENYURT,MEVLANA MAH.,403,353,350,103,247
ESENYURT,MEVLANA MAH.,403,362,354,102,252
ESENYURT,MEVLANA MAH.,403,374,366,100,266
ESENYURT,MEVLANA MAH.,402,357,353,106,247
ESENYURT,MEVLANA MAH.,403,368,364,112,252
ESENYURT,MEVLANA MAH.,402,352,352,91,261
ESENYURT,MEVLANA MAH.,403,354,351,120,231
ESENYURT,MEVLANA MAH.,402,363,359,75,284
ESENYURT,MEVLANA MAH.,403,363,362,133,229
ESENYURT,MEVLANA MAH.,403,370,366,140,226
ESENYURT,MEVLANA MAH.,402,368,363,109,254
ESENYURT,MEVLANA MAH.,402,365,364,117,247
ESENYURT,MEVLANA MAH.,403,369,367,116,251
ESENYURT,MEVLANA MAH.,402,367,365,133,232
ESENYURT,MEVLANA MAH.,403,359,358,102,256
ESENYURT,MEVLANA MAH.,403,372,370,90,280
ESENYURT,MEVLANA MAH.,403,351,347,117,230
ESENYURT,MEVLANA MAH.,403,360,353,96,257
ESENYURT,MEVLANA MAH.,402,360,357,119,238
ESENYURT,MEVLANA MAH.,402,363,358,118,240
ESENYURT,MEVLANA MAH.,402,371,366,96,270
ESENYURT,MEVLANA MAH.,404,358,357,100,257
ESENYURT,NECIP FAZIL KISAKUREK MAH.,415,328,322,174,148
ESENYURT,NECIP FAZIL KISAKUREK MAH.,415,360,355,177,178
ESENYURT,NECIP FAZIL KISAKUREK MAH.,411,358,350,212,138
ESENYURT,NECIP FAZIL KISAKUREK MAH.,415,352,348,208,140
ESENYURT,NECIP FAZIL KISAKUREK MAH.,415,339,328,182,146
ESENYURT,NECIP FAZIL KISAKUREK MAH.,415,367,361,219,142
ESENYURT,NECIP FAZIL KISAKUREK MAH.,415,368,364,208,156
ESENYURT,NECIP FAZIL KISAKUREK MAH.,411,346,344,172,172
ESENYURT,NECIP FAZIL KISAKUREK MAH.,411,344,337,192,145
ESENYURT,NECIP FAZIL KISAKUREK MAH.,410,343,334,163,171
ESENYURT,NECIP FAZIL KISAKUREK MAH.,410,358,346,187,159
ESENYURT,NECIP FAZIL KISAKUREK MAH.,410,346,340,206,134
ESENYURT,NECIP FAZIL KISAKUREK MAH.,411,333,329,186,143
ESENYURT,NECIP FAZIL KISAKUREK MAH.,410,359,352,189,163
ESENYURT,NECIP FAZIL KISAKUREK MAH.,409,358,357,196,161
ESENYURT,NECIP FAZIL KISAKUREK MAH.,409,353,350,198,152
ESENYURT,NECIP FAZIL KISAKUREK MAH.,410,354,346,164,182
ESENYURT,NECIP FAZIL KISAKUREK MAH.,409,333,325,198,127
ESENYURT,NECIP FAZIL KISAKUREK MAH.,410,345,339,169,170
ESENYURT,NECIP FAZIL KISAKUREK MAH.,410,364,351,191,160
ESENYURT,NECIP FAZIL KISAKUREK MAH.,410,360,347,167,180
ESENYURT,NECIP FAZIL KISAKUREK MAH.,410,350,342,194,148
ESENYURT,NECIP FAZIL KISAKUREK MAH.,410,344,337,176,161
ESENYURT,NECIP FAZIL KISAKUREK MAH.,411,333,329,194,135
ESENYURT,OSMANGAZI MAH.,140,134,130,71,59
ESENYURT,OSMANGAZI MAH.,415,357,355,194,161
ESENYURT,OSMANGAZI MAH.,415,359,353,200,153
ESENYURT,OSMANGAZI MAH.,415,375,368,200,168
ESENYURT,OSMANGAZI MAH.,414,359,350,226,124
ESENYURT,OSMANGAZI MAH.,413,378,374,205,169
ESENYURT,OSMANGAZI MAH.,415,365,360,244,116
ESENYURT,OSMANGAZI MAH.,415,347,337,223,114
ESENYURT,OSMANGAZI MAH.,413,367,359,229,130
ESENYURT,OSMANGAZI MAH.,413,360,354,194,160
ESENYURT,OSMANGAZI MAH.,413,362,351,220,131
ESENYURT,OSMANGAZI MAH.,410,317,307,143,164
ESENYURT,OSMANGAZI MAH.,415,324,313,175,138
ESENYURT,OSMANGAZI MAH.,410,357,352,215,137
ESENYURT,OSMANGAZI MAH.,409,349,343,207,136
ESENYURT,OSMANGAZI MAH.,409,373,366,197,169
ESENYURT,OSMANGAZI MAH.,409,335,329,169,160
ESENYURT,OSMANGAZI MAH.,410,333,329,190,139
ESENYURT,OSMANGAZI MAH.,410,346,346,205,141
ESENYURT,OSMANGAZI MAH.,409,364,351,197,154
ESENYURT,OSMANGAZI MAH.,410,362,361,205,156
ESENYURT,OSMANGAZI MAH.,410,352,345,191,154
ESENYURT,OSMANGAZI MAH.,409,362,351,182,169
ESENYURT,OSMANGAZI MAH.,409,348,346,182,164
ESENYURT,OSMANGAZI MAH.,409,359,354,206,148
ESENYURT,OSMANGAZI MAH.,410,356,349,187,162
ESENYURT,OSMANGAZI MAH.,410,353,349,199,150
ESENYURT,OSMANGAZI MAH.,409,355,353,190,163
ESENYURT,OSMANGAZI MAH.,410,367,364,192,172
ESENYURT,OSMANGAZI MAH.,410,356,350,204,146
ESENYURT,OSMANGAZI MAH.,410,360,349,207,142
ESENYURT,OSMANGAZI MAH.,410,342,338,182,156
ESENYURT,OSMANGAZI MAH.,410,361,357,192,165
ESENYURT,OSMANGAZI MAH.,410,366,361,208,153
ESENYURT,OSMANGAZI MAH.,409,360,355,211,144
ESENYURT,OSMANGAZI MAH.,409,354,343,215,128
ESENYURT,OSMANGAZI MAH.,410,347,344,193,151
ESENYURT,OSMANGAZI MAH.,409,355,353,177,176
ESENYURT,OSMANGAZI MAH.,410,350,343,184,159
ESENYURT,OSMANGAZI MAH.,415,360,356,200,156
ESENYURT,OSMANGAZI MAH.,410,368,365,223,142
ESENYURT,OSMANGAZI MAH.,410,344,340,181,159
ESENYURT,OSMANGAZI MAH.,411,354,346,191,155
ESENYURT,OSMANGAZI MAH.,409,363,358,202,156
ESENYURT,OSMANGAZI MAH.,409,351,344,202,142
ESENYURT,OSMANGAZI MAH.,410,364,360,229,131
ESENYURT,OSMANGAZI MAH.,409,349,342,210,132
ESENYURT,PINAR MAH.,406,341,334,163,171
ESENYURT,PINAR MAH.,404,333,326,154,172
ESENYURT,PINAR MAH.,403,336,330,132,198
ESENYURT,PINAR MAH.,404,349,344,167,177
ESENYURT,PINAR MAH.,407,359,351,150,201
ESENYURT,PINAR MAH.,404,340,332,100,232
ESENYURT,PINAR MAH.,403,331,324,150,174
ESENYURT,PINAR MAH.,403,343,335,168,167
ESENYURT,PINAR MAH.,404,357,353,181,172
ESENYURT,PINAR MAH.,404,344,342,143,199
ESENYURT,PINAR MAH.,403,329,319,143,176
ESENYURT,PINAR MAH.,404,345,338,162,176
ESENYURT,PINAR MAH.,403,358,347,159,188
ESENYURT,PINAR MAH.,404,343,338,173,165
ESENYURT,PINAR MAH.,403,345,340,152,188
ESENYURT,PINAR MAH.,403,340,336,163,173
ESENYURT,PINAR MAH.,404,340,338,158,180
ESENYURT,PINAR MAH.,403,338,333,155,178
ESENYURT,PINAR MAH.,403,355,352,176,176
ESENYURT,PINAR MAH.,396,338,331,173,158
ESENYURT,PINAR MAH.,395,321,313,173,140
ESENYURT,PINAR MAH.,395,335,332,160,172
ESENYURT,PINAR MAH.,394,330,323,187,136
ESENYURT,PINAR MAH.,395,352,345,188,157
ESENYURT,PINAR MAH.,395,359,354,228,126
ESENYURT,PINAR MAH.,394,329,321,163,158
ESENYURT,PINAR MAH.,397,350,345,194,151
ESENYURT,PINAR MAH.,395,326,320,176,144
ESENYURT,PINAR MAH.,394,332,324,198,126
ESENYURT,PINAR MAH.,399,336,331,149,182
ESENYURT,PINAR MAH.,403,320,316,139,177
ESENYURT,PINAR MAH.,399,354,348,153,195
ESENYURT,PINAR MAH.,405,347,340,129,211
ESENYURT,PINAR MAH.,399,328,326,147,179
ESENYURT,PINAR MAH.,403,324,317,121,196
ESENYURT,PINAR MAH.,402,347,345,132,213
ESENYURT,PINAR MAH.,399,342,336,158,178
ESENYURT,PINAR MAH.,399,341,336,163,173
ESENYURT,PINAR MAH.,399,336,330,161,169
ESENYURT,PINAR MAH.,400,345,342,161,181
ESENYURT,PINAR MAH.,399,344,342,143,199
ESENYURT,PINAR MAH.,398,342,328,141,187
ESENYURT,PINAR MAH.,398,343,335,158,177
ESENYURT,PINAR MAH.,398,322,316,146,170
ESENYURT,PINAR MAH.,398,331,327,150,177
ESENYURT,PINAR MAH.,399,337,332,140,192
ESENYURT,PINAR MAH.,398,346,341,132,209
ESENYURT,PINAR MAH.,398,335,331,142,189
ESENYURT,PINAR MAH.,398,338,335,144,191
ESENYURT,PINAR MAH.,399,348,338,144,194
ESENYURT,PINAR MAH.,399,343,332,161,171
ESENYURT,PINAR MAH.,398,316,310,151,159
ESENYURT,PINAR MAH.,399,355,343,149,194
ESENYURT,PIRI REIS MAH.,415,330,328,116,212
ESENYURT,PIRI REIS MAH.,415,369,368,158,210
ESENYURT,PIRI REIS MAH.,415,361,357,104,253
ESENYURT,PIRI REIS MAH.,415,351,348,151,197
ESENYURT,PIRI REIS MAH.,413,352,348,101,247
ESENYURT,PIRI REIS MAH.,412,361,358,115,243
ESENYURT,PIRI REIS MAH.,413,370,363,119,244
ESENYURT,PIRI REIS MAH.,413,356,354,120,234
ESENYURT,PIRI REIS MAH.,413,368,362,115,247
ESENYURT,PIRI REIS MAH.,413,343,337,98,239
ESENYURT,PIRI REIS MAH.,413,349,346,114,232
ESENYURT,PIRI REIS MAH.,411,367,365,114,251
ESENYURT,PIRI REIS MAH.,412,349,345,119,226
ESENYURT,PIRI REIS MAH.,411,360,356,136,220
ESENYURT,PIRI REIS MAH.,412,358,352,114,238
ESENYURT,PIRI REIS MAH.,412,358,355,126,229
ESENYURT,PIRI REIS MAH.,413,357,353,108,245
ESENYURT,SEHITLER MAH.,415,338,320,176,144
ESENYURT,SEHITLER MAH.,415,336,328,143,185
ESENYURT,SEHITLER MAH.,414,364,361,180,181
ESENYURT,SEHITLER MAH.,415,345,338,194,144
ESENYURT,SEHITLER MAH.,414,343,335,185,150
ESENYURT,SEHITLER MAH.,414,369,362,196,166
ESENYURT,SEHITLER MAH.,415,355,341,209,132
ESENYURT,SEHITLER MAH.,415,355,347,188,159
ESENYURT,SEHITLER MAH.,409,358,347,185,162
ESENYURT,SEHITLER MAH.,414,365,362,215,147
ESENYURT,SEHITLER MAH.,413,347,342,179,163
ESENYURT,SEHITLER MAH.,413,355,349,240,109
ESENYURT,SEHITLER MAH.,414,357,348,202,146
ESENYURT,SEHITLER MAH.,414,360,351,187,164
ESENYURT,SEHITLER MAH.,415,360,354,212,142
ESENYURT,SEHITLER MAH.,412,353,345,216,129
ESENYURT,SEHITLER MAH.,411,365,356,209,147
ESENYURT,SEHITLER MAH.,412,359,354,210,144
ESENYURT,SEHITLER MAH.,413,349,340,182,158
ESENYURT,SEHITLER MAH.,412,343,335,172,163
ESENYURT,SEHITLER MAH.,414,366,355,219,136
ESENYURT,SEHITLER MAH.,414,360,355,227,128
ESENYURT,SEHITLER MAH.,412,346,344,185,159
ESENYURT,SEHITLER MAH.,415,355,348,182,166
ESENYURT,TALATPASA MAH.,411,333,327,147,180
ESENYURT,TALATPASA MAH.,415,365,360,190,170
ESENYURT,TALATPASA MAH.,410,358,355,181,174
ESENYURT,TALATPASA MAH.,415,352,347,160,187
ESENYURT,TALATPASA MAH.,415,365,354,169,185
ESENYURT,TALATPASA MAH.,410,338,334,136,198
ESENYURT,TALATPASA MAH.,415,350,350,179,171
ESENYURT,TALATPASA MAH.,415,355,348,192,156
ESENYURT,TALATPASA MAH.,412,351,347,169,178
ESENYURT,TALATPASA MAH.,412,347,342,185,157
ESENYURT,TALATPASA MAH.,415,339,336,160,176
ESENYURT,TALATPASA MAH.,415,348,343,159,184
ESENYURT,TALATPASA MAH.,415,349,343,158,185
ESENYURT,TALATPASA MAH.,415,348,343,160,183
ESENYURT,TALATPASA MAH.,413,355,349,156,193
ESENYURT,TALATPASA MAH.,410,369,359,208,151
ESENYURT,TALATPASA MAH.,400,315,305,156,149
ESENYURT,TALATPASA MAH.,400,324,317,160,157
ESENYURT,TALATPASA MAH.,400,324,320,159,161
ESENYURT,TALATPASA MAH.,404,341,336,175,161
ESENYURT,TALATPASA MAH.,399,343,336,184,152
ESENYURT,TALATPASA MAH.,400,343,333,177,156
ESENYURT,TALATPASA MAH.,401,331,327,168,159
ESENYURT,TALATPASA MAH.,400,327,325,168,157
ESENYURT,TALATPASA MAH.,400,342,337,169,168
ESENYURT,TALATPASA MAH.,399,339,328,186,142
ESENYURT,TALATPASA MAH.,399,348,344,205,139
ESENYURT,TALATPASA MAH.,399,344,338,204,134
ESENYURT,TALATPASA MAH.,399,357,351,172,179
ESENYURT,TALATPASA MAH.,399,333,327,151,176
ESENYURT,TALATPASA MAH.,399,328,327,171,156
ESENYURT,TALATPASA MAH.,400,332,324,164,160
ESENYURT,TALATPASA MAH.,399,339,328,143,185
ESENYURT,TALATPASA MAH.,400,326,321,191,130
ESENYURT,TALATPASA MAH.,400,343,335,159,176
ESENYURT,TALATPASA MAH.,400,335,331,163,168
ESENYURT,TALATPASA MAH.,400,332,324,192,132
ESENYURT,TALATPASA MAH.,401,327,323,187,136
ESENYURT,YESILKENT MAH.,415,341,333,131,202
ESENYURT,YESILKENT MAH.,415,371,369,194,175
ESENYURT,YESILKENT MAH.,415,336,327,130,197
ESENYURT,YESILKENT MAH.,415,330,325,144,181
ESENYURT,YESILKENT MAH.,416,348,343,153,190
ESENYURT,YESILKENT MAH.,413,346,341,163,178
ESENYURT,YESILKENT MAH.,415,339,334,138,196
ESENYURT,YESILKENT MAH.,415,346,344,151,193
ESENYURT,YESILKENT MAH.,415,332,331,149,182
ESENYURT,YESILKENT MAH.,415,344,337,131,206
ESENYURT,YESILKENT MAH.,415,346,338,160,178
ESENYURT,YESILKENT MAH.,416,339,333,140,193
ESENYURT,YESILKENT MAH.,415,340,337,157,180
ESENYURT,YESILKENT MAH.,416,336,331,146,185
ESENYURT,YESILKENT MAH.,413,350,342,157,185
ESENYURT,YESILKENT MAH.,415,347,338,139,199
ESENYURT,YESILKENT MAH.,416,343,336,140,196
ESENYURT,YESILKENT MAH.,413,340,337,127,210
ESENYURT,YESILKENT MAH.,415,320,313,143,170
ESENYURT,YESILKENT MAH.,411,332,329,148,181
ESENYURT,YESILKENT MAH.,415,332,327,109,218
ESENYURT,YESILKENT MAH.,410,328,325,113,212
ESENYURT,YESILKENT MAH.,412,349,345,123,222
ESENYURT,YESILKENT MAH.,411,328,328,154,174
ESENYURT,YESILKENT MAH.,415,332,330,130,200
ESENYURT,YESILKENT MAH.,412,323,322,114,208
ESENYURT,YESILKENT MAH.,414,338,336,141,195
ESENYURT,YESILKENT MAH.,413,322,320,130,190
ESENYURT,YESILKENT MAH.,412,325,319,131,188
ESENYURT,YESILKENT MAH.,413,328,324,134,190
ESENYURT,YESILKENT MAH.,413,309,307,105,202
ESENYURT,YESILKENT MAH.,412,329,327,118,209
ESENYURT,YESILKENT MAH.,413,312,305,91,214
ESENYURT,YESILKENT MAH.,413,327,322,126,196
ESENYURT,YESILKENT MAH.,413,315,305,111,194
ESENYURT,YESILKENT MAH.,413,337,335,138,197
ESENYURT,YESILKENT MAH.,413,337,334,128,206
ESENYURT,YESILKENT MAH.,413,320,316,128,188
ESENYURT,YESILKENT MAH.,413,313,306,121,185
ESENYURT,YESILKENT MAH.,412,332,329,104,225
ESENYURT,YESILKENT MAH.,411,345,344,154,190
KARTAL,ATALAR MAH.,395,338,334,208,126
KARTAL,ATALAR MAH.,395,358,356,206,150
KARTAL,ATALAR MAH.,396,344,337,201,136
KARTAL,ATALAR MAH.,394,357,350,203,147
KARTAL,ATALAR MAH.,396,355,348,202,146
KARTAL,ATALAR MAH.,396,340,335,192,143
KARTAL,ATALAR MAH.,404,343,338,144,194
KARTAL,ATALAR MAH.,406,344,335,110,225
KARTAL,ATALAR MAH.,404,347,342,127,215
KARTAL,ATALAR MAH.,406,369,368,118,250
KARTAL,ATALAR MAH.,403,363,361,133,228
KARTAL,ATALAR MAH.,404,353,351,140,211
KARTAL,ATALAR MAH.,403,376,370,143,227
KARTAL,ATALAR MAH.,404,354,351,146,205
KARTAL,ATALAR MAH.,404,376,372,145,227
KARTAL,ATALAR MAH.,404,362,358,152,206
KARTAL,ATALAR MAH.,404,362,357,118,239
KARTAL,ATALAR MAH.,403,376,372,150,222
KARTAL,ATALAR MAH.,404,361,358,158,200
KARTAL,ATALAR MAH.,403,371,369,146,223
KARTAL,ATALAR MAH.,404,373,365,136,229
KARTAL,ATALAR MAH.,403,366,358,133,225
KARTAL,ATALAR MAH.,403,369,366,141,225
KARTAL,ATALAR MAH.,403,360,354,144,210
KARTAL,ATALAR MAH.,404,372,367,123,244
KARTAL,ATALAR MAH.,404,376,374,113,261
KARTAL,ATALAR MAH.,403,380,375,120,255
KARTAL,ATALAR MAH.,369,311,308,77,231
KARTAL,ATALAR MAH.,369,345,338,87,251
KARTAL,ATALAR MAH.,371,337,333,86,247
KARTAL,ATALAR MAH.,368,331,328,81,247
KARTAL,ATALAR MAH.,370,340,337,88,249
KARTAL,ATALAR MAH.,369,338,333,97,236
KARTAL,ATALAR MAH.,369,337,335,86,249
KARTAL,ATALAR MAH.,368,346,338,106,232
KARTAL,ATALAR MAH.,395,337,332,179,153
KARTAL,ATALAR MAH.,392,363,359,175,184
KARTAL,ATALAR MAH.,393,366,361,179,182
KARTAL,ATALAR MAH.,392,359,357,198,159
KARTAL,ATALAR MAH.,392,354,347,173,174
KARTAL,ATALAR MAH.,393,340,337,188,149
KARTAL,ATALAR MAH.,395,343,339,148,191
KARTAL,ATALAR MAH.,393,358,353,161,192
KARTAL,ATALAR MAH.,393,349,342,162,180
KARTAL,ATALAR MAH.,392,358,350,190,160
KARTAL,ATALAR MAH.,415,349,341,164,177
KARTAL,ATALAR MAH.,412,326,322,194,128
KARTAL,ATALAR MAH.,415,365,362,191,171
KARTAL,ATALAR MAH.,415,367,363,190,173
KARTAL,ATALAR MAH.,415,384,383,190,193
KARTAL,ATALAR MAH.,412,381,379,202,177
KARTAL,ATALAR MAH.,415,370,368,180,188
KARTAL,ATALAR MAH.,415,380,379,201,178
KARTAL,ATALAR MAH.,411,370,366,184,182
KARTAL,ATALAR MAH.,415,383,378,206,172
KARTAL,ATALAR MAH.,416,377,372,181,191
KARTAL,ATALAR MAH.,416,378,373,199,174
KARTAL,ATALAR MAH.,416,374,366,185,181
KARTAL,ATALAR MAH.,415,386,384,215,169
KARTAL,ATALAR MAH.,414,376,375,187,188
KARTAL,CUMHURIYET MAH.,416,354,348,93,255
KARTAL,CUMHURIYET MAH.,416,356,355,80,275
KARTAL,CUMHURIYET MAH.,415,381,373,100,273
KARTAL,CUMHURIYET MAH.,416,382,378,79,299
KARTAL,CUMHURIYET MAH.,415,387,384,108,276
KARTAL,CUMHURIYET MAH.,415,382,380,101,279
KARTAL,CUMHURIYET MAH.,416,382,381,106,275
KARTAL,CUMHURIYET MAH.,415,383,376,108,268
KARTAL,CUMHURIYET MAH.,415,377,375,120,255
KARTAL,CUMHURIYET MAH.,414,390,386,108,278
KARTAL,CUMHURIYET MAH.,415,387,379,93,286
KARTAL,CUMHURIYET MAH.,414,382,378,105,273
KARTAL,CUMHURIYET MAH.,416,369,362,100,262
KARTAL,CUMHURIYET MAH.,414,384,381,78,303
KARTAL,CUMHURIYET MAH.,415,395,394,111,283
KARTAL,CUMHURIYET MAH.,415,389,384,114,270
KARTAL,CUMHURIYET MAH.,415,395,394,125,269
KARTAL,CUMHURIYET MAH.,414,385,378,112,266
KARTAL,CUMHURIYET MAH.,415,376,375,110,265
KARTAL,CUMHURIYET MAH.,398,344,334,130,204
KARTAL,CUMHURIYET MAH.,399,363,355,121,234
KARTAL,CUMHURIYET MAH.,398,366,365,128,237
KARTAL,CUMHURIYET MAH.,400,365,363,174,189
KARTAL,CUMHURIYET MAH.,400,369,361,170,191
KARTAL,CUMHURIYET MAH.,399,370,364,150,214
KARTAL,CUMHURIYET MAH.,399,368,362,160,202
KARTAL,CUMHURIYET MAH.,399,366,362,140,222
KARTAL,CUMHURIYET MAH.,398,370,368,164,204
KARTAL,CUMHURIYET MAH.,398,359,354,162,192
KARTAL,CUMHURIYET MAH.,399,348,344,124,220
KARTAL,CUMHURIYET MAH.,399,366,357,152,205
KARTAL,CUMHURIYET MAH.,399,356,350,133,217
KARTAL,CUMHURIYET MAH.,399,349,343,129,214
KARTAL,CUMHURIYET MAH.,398,345,342,136,206
KARTAL,CUMHURIYET MAH.,399,366,362,168,194
KARTAL,CUMHURIYET MAH.,399,362,356,149,207
KARTAL,CUMHURIYET MAH.,398,363,352,141,211
KARTAL,CUMHURIYET MAH.,399,368,362,175,187
KARTAL,CUMHURIYET MAH.,399,356,352,147,205
KARTAL,CAVUSOGLU MAH.,401,335,329,135,194
KARTAL,CAVUSOGLU MAH.,402,369,367,138,229
KARTAL,CAVUSOGLU MAH.,403,367,361,173,188
KARTAL,CAVUSOGLU MAH.,402,362,359,152,207
KARTAL,CAVUSOGLU MAH.,402,370,366,191,175
KARTAL,CAVUSOGLU MAH.,404,365,360,133,227
KARTAL,CAVUSOGLU MAH.,401,373,369,140,229
KARTAL,CAVUSOGLU MAH.,401,364,364,150,214
KARTAL,CAVUSOGLU MAH.,402,375,374,174,200
KARTAL,CAVUSOGLU MAH.,402,374,368,156,212
KARTAL,CAVUSOGLU MAH.,402,370,364,162,202
KARTAL,CAVUSOGLU MAH.,402,373,371,159,212
KARTAL,CAVUSOGLU MAH.,400,335,327,82,245
KARTAL,CAVUSOGLU MAH.,400,325,320,74,246
KARTAL,CAVUSOGLU MAH.,400,372,368,112,256
KARTAL,CAVUSOGLU MAH.,401,365,362,120,242
KARTAL,CAVUSOGLU MAH.,401,369,366,110,256
KARTAL,CAVUSOGLU MAH.,400,368,363,113,250
KARTAL,CAVUSOGLU MAH.,400,366,362,125,237
KARTAL,CAVUSOGLU MAH.,401,356,354,115,239
KARTAL,CAVUSOGLU MAH.,400,348,348,116,232
KARTAL,CAVUSOGLU MAH.,400,363,358,112,246
KARTAL,CAVUSOGLU MAH.,401,358,356,115,241
KARTAL,CAVUSOGLU MAH.,401,370,366,134,232
KARTAL,CAVUSOGLU MAH.,402,366,364,112,252
KARTAL,CAVUSOGLU MAH.,401,373,368,137,231
KARTAL,CAVUSOGLU MAH.,400,379,371,132,239
KARTAL,HURRIYET MAH.,406,333,328,214,114
KARTAL,HURRIYET MAH.,408,358,352,220,132
KARTAL,HURRIYET MAH.,407,360,353,216,137
KARTAL,HURRIYET MAH.,407,370,364,229,135
KARTAL,HURRIYET MAH.,408,368,365,215,150
KARTAL,HURRIYET MAH.,407,372,367,250,117
KARTAL,HURRIYET MAH.,407,377,369,204,165
KARTAL,HURRIYET MAH.,407,348,343,225,118
KARTAL,HURRIYET MAH.,407,378,372,252,120
KARTAL,HURRIYET MAH.,411,381,374,224,150
KARTAL,HURRIYET MAH.,407,355,355,225,130
KARTAL,HURRIYET MAH.,406,361,359,221,138
KARTAL,HURRIYET MAH.,409,377,376,232,144
KARTAL,HURRIYET MAH.,406,379,376,244,132
KARTAL,HURRIYET MAH.,409,378,375,203,172
KARTAL,HURRIYET MAH.,407,369,364,228,136
KARTAL,HURRIYET MAH.,407,379,373,225,148
KARTAL,HURRIYET MAH.,407,373,366,201,165
KARTAL,HURRIYET MAH.,406,371,367,239,128
KARTAL,HURRIYET MAH.,415,353,345,198,147
KARTAL,HURRIYET MAH.,415,339,331,194,137
KARTAL,HURRIYET MAH.,415,360,357,223,134
KARTAL,HURRIYET MAH.,412,372,364,208,156
KARTAL,HURRIYET MAH.,412,358,354,196,158
KARTAL,HURRIYET MAH.,415,376,369,240,129
KARTAL,HURRIYET MAH.,415,369,360,202,158
KARTAL,HURRIYET MAH.,412,372,365,218,147
KARTAL,HURRIYET MAH.,415,373,361,208,153
KARTAL,HURRIYET MAH.,412,367,362,204,158
KARTAL,HURRIYET MAH.,411,388,384,196,188
KARTAL,HURRIYET MAH.,412,363,354,212,142
KARTAL,HURRIYET MAH.,415,384,381,219,162
KARTAL,HURRIYET MAH.,412,357,350,219,131
KARTAL,HURRIYET MAH.,411,360,354,216,138
KARTAL,HURRIYET MAH.,412,358,353,206,147
KARTAL,HURRIYET MAH.,415,381,372,227,145
KARTAL,HURRIYET MAH.,415,379,371,203,168
KARTAL,HURRIYET MAH.,412,377,367,201,166
KARTAL,HURRIYET MAH.,389,331,324,98,226
KARTAL,HURRIYET MAH.,389,359,355,145,210
KARTAL,HURRIYET MAH.,389,359,355,139,216
KARTAL,HURRIYET MAH.,390,355,355,153,202
KARTAL,HURRIYET MAH.,388,340,339,138,201
KARTAL,HURRIYET MAH.,388,355,347,143,204
KARTAL,HURRIYET MAH.,391,352,343,127,216
KARTAL,HURRIYET MAH.,390,342,340,135,205
KARTAL,HURRIYET MAH.,388,349,341,139,202
KARTAL,HURRIYET MAH.,389,351,344,134,210
KARTAL,HURRIYET MAH.,387,346,340,147,193
KARTAL,HURRIYET MAH.,393,306,304,138,166
KARTAL,HURRIYET MAH.,393,335,332,136,196
KARTAL,HURRIYET MAH.,392,346,341,156,185
KARTAL,HURRIYET MAH.,392,363,361,151,210
KARTAL,HURRIYET MAH.,394,353,351,173,178
KARTAL,HURRIYET MAH.,393,355,348,170,178
KARTAL,HURRIYET MAH.,391,346,342,152,190
KARTAL,HURRIYET MAH.,391,353,346,157,189
KARTAL,HURRIYET MAH.,393,365,358,173,185
KARTAL,HURRIYET MAH.,393,350,344,187,157
KARTAL,HURRIYET MAH.,393,358,350,150,200
KARTAL,HURRIYET MAH.,391,349,341,142,199
KARTAL,HURRIYET MAH.,398,356,349,162,187
KARTAL,HURRIYET MAH.,390,355,353,177,176
KARTAL,HURRIYET MAH.,393,361,355,148,207
KARTAL,HURRIYET MAH.,404,332,327,116,211
KARTAL,HURRIYET MAH.,405,368,361,145,216
KARTAL,HURRIYET MAH.,405,367,363,119,244
KARTAL,HURRIYET MAH.,404,357,354,157,197
KARTAL,HURRIYET MAH.,404,343,339,125,214
KARTAL,HURRIYET MAH.,405,363,357,157,200
KARTAL,HURRIYET MAH.,405,368,363,173,190
KARTAL,HURRIYET MAH.,404,358,356,150,206
KARTAL,HURRIYET MAH.,405,352,349,141,208
KARTAL,HURRIYET MAH.,403,348,342,150,192
KARTAL,HURRIYET MAH.,405,365,360,152,208
KARTAL,HURRIYET MAH.,405,373,368,163,205
KARTAL,HURRIYET MAH.,411,359,344,201,143
KARTAL,HURRIYET MAH.,413,368,364,172,192
KARTAL,HURRIYET MAH.,415,385,382,196,186
KARTAL,HURRIYET MAH.,411,370,365,185,180
KARTAL,HURRIYET MAH.,411,380,370,179,191
KARTAL,HURRIYET MAH.,411,359,354,177,177
KARTAL,HURRIYET MAH.,412,358,351,170,181
KARTAL,HURRIYET MAH.,412,365,360,189,171
KARTAL,HURRIYET MAH.,411,370,361,170,191
KARTAL,HURRIYET MAH.,411,368,362,182,180
KARTAL,HURRIYET MAH.,412,359,352,167,185
KARTAL,KARLIKTEPE MAH.,416,353,347,108,239
KARTAL,KARLIKTEPE MAH.,417,389,384,159,225
KARTAL,KARLIKTEPE MAH.,415,372,369,166,203
KARTAL,KARLIKTEPE MAH.,415,374,372,155,217
KARTAL,KARLIKTEPE MAH.,416,370,369,181,188
KARTAL,KARLIKTEPE MAH.,415,389,382,149,233
KARTAL,KARLIKTEPE MAH.,415,384,379,168,211
KARTAL,KARLIKTEPE MAH.,404,358,356,61,295
KARTAL,KARLIKTEPE MAH.,405,354,347,69,278
KARTAL,KARLIKTEPE MAH.,405,374,372,114,258
KARTAL,KARLIKTEPE MAH.,405,370,367,88,279
KARTAL,KARLIKTEPE MAH.,405,357,354,85,269
KARTAL,KARLIKTEPE MAH.,406,368,363,90,273
KARTAL,KARLIKTEPE MAH.,405,375,373,86,287
KARTAL,KARLIKTEPE MAH.,405,369,363,75,288
KARTAL,KARLIKTEPE MAH.,405,375,372,95,277
KARTAL,KARLIKTEPE MAH.,407,375,372,83,289
KARTAL,KARLIKTEPE MAH.,404,367,365,92,273
KARTAL,KARLIKTEPE MAH.,404,382,377,95,282
KARTAL,KARLIKTEPE MAH.,405,370,366,117,249
KARTAL,KARLIKTEPE MAH.,405,379,376,91,285
KARTAL,KARLIKTEPE MAH.,404,368,364,97,267
KARTAL,KARLIKTEPE MAH.,405,368,364,97,267
KARTAL,KARLIKTEPE MAH.,405,372,371,96,275
KARTAL,KARLIKTEPE MAH.,397,345,341,111,230
KARTAL,KARLIKTEPE MAH.,396,329,318,79,239
KARTAL,KARLIKTEPE MAH.,395,374,371,126,245
KARTAL,KARLIKTEPE MAH.,395,367,363,110,253
KARTAL,KARLIKTEPE MAH.,396,355,351,127,224
KARTAL,KARLIKTEPE MAH.,396,359,358,118,240
KARTAL,KARLIKTEPE MAH.,396,367,363,141,222
KARTAL,KARLIKTEPE MAH.,397,376,370,113,257
KARTAL,KARLIKTEPE MAH.,395,372,371,97,274
KARTAL,KARLIKTEPE MAH.,396,369,366,106,260
KARTAL,KARLIKTEPE MAH.,396,358,353,107,246
KARTAL,KARLIKTEPE MAH.,398,347,345,102,243
KARTAL,KARLIKTEPE MAH.,395,371,363,111,252
KARTAL,KARLIKTEPE MAH.,396,357,350,104,246
KARTAL,KARLIKTEPE MAH.,395,367,361,93,268
KARTAL,KARLIKTEPE MAH.,395,360,356,119,237
KARTAL,KARLIKTEPE MAH.,395,364,359,109,250
KARTAL,KARLIKTEPE MAH.,396,364,362,120,242
KARTAL,KARLIKTEPE MAH.,396,367,366,101,265
KARTAL,KARLIKTEPE MAH.,394,319,313,102,211
KARTAL,KARLIKTEPE MAH.,395,332,324,107,217
KARTAL,KARLIKTEPE MAH.,393,351,343,96,247
KARTAL,KARLIKTEPE MAH.,394,347,342,110,232
KARTAL,KARLIKTEPE MAH.,396,350,349,87,262
KARTAL,KARLIKTEPE MAH.,395,363,360,103,257
KARTAL,KARLIKTEPE MAH.,397,358,355,114,241
KARTAL,KARLIKTEPE MAH.,393,344,340,112,228
KARTAL,KARLIKTEPE MAH.,393,363,360,103,257
KARTAL,KARLIKTEPE MAH.,393,360,357,137,220
KARTAL,KARLIKTEPE MAH.,394,359,356,110,246
KARTAL,KARLIKTEPE MAH.,394,364,361,125,236
KARTAL,KARLIKTEPE MAH.,393,349,347,106,241
KARTAL,KARLIKTEPE MAH.,395,372,362,105,257
KARTAL,KARLIKTEPE MAH.,393,348,346,100,246
KARTAL,KARLIKTEPE MAH.,393,360,354,109,245
KARTAL,KARLIKTEPE MAH.,395,364,353,93,260
KARTAL,KORDONBOYU MAH.,408,347,343,62,281
KARTAL,KORDONBOYU MAH.,408,332,330,62,268
KARTAL,KORDONBOYU MAH.,410,346,342,62,280
KARTAL,KORDONBOYU MAH.,408,361,358,89,269
KARTAL,KORDONBOYU MAH.,409,374,373,87,286
KARTAL,KORDONBOYU MAH.,410,371,363,101,262
KARTAL,KORDONBOYU MAH.,408,373,364,76,288
KARTAL,KORDONBOYU MAH.,408,362,357,67,290
KARTAL,KORDONBOYU MAH.,408,363,359,66,293
KARTAL,KORDONBOYU MAH.,408,368,364,78,286
KARTAL,KORDONBOYU MAH.,409,370,366,55,311
KARTAL,KORDONBOYU MAH.,408,369,365,79,286
KARTAL,KORDONBOYU MAH.,409,379,378,57,321
KARTAL,KORDONBOYU MAH.,408,368,366,54,312
KARTAL,KORDONBOYU MAH.,410,366,363,79,284
KARTAL,KORDONBOYU MAH.,408,378,374,86,288
KARTAL,KORDONBOYU MAH.,409,359,353,66,287
KARTAL,KORDONBOYU MAH.,408,383,377,61,316
KARTAL,KORDONBOYU MAH.,408,367,365,86,279
KARTAL,KORDONBOYU MAH.,410,378,374,80,294
KARTAL,KORDONBOYU MAH.,407,360,355,89,266
KARTAL,KORDONBOYU MAH.,407,376,373,72,301
KARTAL,ORHANTEPE MAH.,409,341,336,94,242
KARTAL,ORHANTEPE MAH.,409,325,318,61,257
KARTAL,ORHANTEPE MAH.,410,386,385,76,309
KARTAL,ORHANTEPE MAH.,410,365,360,106,254
KARTAL,ORHANTEPE MAH.,410,374,370,75,295
KARTAL,ORHANTEPE MAH.,408,376,375,103,272
KARTAL,ORHANTEPE MAH.,410,381,377,109,268
KARTAL,ORHANTEPE MAH.,410,367,361,113,248
KARTAL,ORHANTEPE MAH.,410,374,368,98,270
KARTAL,ORHANTEPE MAH.,409,373,368,90,278
KARTAL,ORHANTEPE MAH.,409,371,369,79,290
KARTAL,ORHANTEPE MAH.,410,381,374,91,283
KARTAL,ORHANTEPE MAH.,410,373,370,98,272
KARTAL,ORHANTEPE MAH.,409,355,353,195,158
KARTAL,ORHANTEPE MAH.,408,349,348,215,133
KARTAL,ORHANTEPE MAH.,408,368,365,216,149
KARTAL,ORHANTEPE MAH.,408,350,346,200,146
KARTAL,ORHANTEPE MAH.,408,375,366,216,150
KARTAL,ORHANTEPE MAH.,408,357,351,195,156
KARTAL,ORHANTEPE MAH.,409,361,355,213,142
KARTAL,ORHANTEPE MAH.,408,360,352,182,170
KARTAL,ORHANTEPE MAH.,408,380,377,186,191
KARTAL,ORHANTEPE MAH.,411,370,362,205,157
KARTAL,ORHANTEPE MAH.,409,376,370,222,148
KARTAL,ORHANTEPE MAH.,408,380,371,194,177
KARTAL,ORHANTEPE MAH.,408,364,355,185,170
KARTAL,ORHANTEPE MAH.,407,367,362,206,156
KARTAL,ORHANTEPE MAH.,407,382,374,215,159
KARTAL,ORHANTEPE MAH.,384,335,332,79,253
KARTAL,ORHANTEPE MAH.,383,342,341,110,231
KARTAL,ORHANTEPE MAH.,384,343,343,122,221
KARTAL,ORHANTEPE MAH.,383,348,346,103,243
KARTAL,ORHANTEPE MAH.,383,351,346,118,228
KARTAL,ORHANTEPE MAH.,389,350,350,95,255
KARTAL,ORHANTEPE MAH.,398,347,335,192,143
KARTAL,ORHANTEPE MAH.,400,338,334,209,125
KARTAL,ORHANTEPE MAH.,397,335,328,174,154
KARTAL,ORHANTEPE MAH.,397,361,356,230,126
KARTAL,ORHANTEPE MAH.,398,354,352,210,142
KARTAL,ORHANTEPE MAH.,397,360,358,203,155
KARTAL,ORHANTEPE MAH.,397,364,358,217,141
KARTAL,ORHANTEPE MAH.,398,367,365,217,148
KARTAL,ORHANTEPE MAH.,398,336,331,205,126
KARTAL,ORHANTEPE MAH.,397,354,352,232,120
KARTAL,ORHANTEPE MAH.,397,362,358,209,149
KARTAL,ORHANTEPE MAH.,398,365,360,211,149
KARTAL,ORHANTEPE MAH.,397,363,358,234,124
KARTAL,ORHANTEPE MAH.,398,339,335,187,148
KARTAL,ORHANTEPE MAH.,397,361,359,209,150
KARTAL,ORHANTEPE MAH.,398,363,359,190,169
KARTAL,ORHANTEPE MAH.,397,353,347,166,181
KARTAL,ORHANTEPE MAH.,398,363,360,218,142
KARTAL,ORHANTEPE MAH.,398,350,346,185,161
KARTAL,ORHANTEPE MAH.,398,366,365,204,161
KARTAL,ORHANTEPE MAH.,398,331,326,196,130
KARTAL,ORHANTEPE MAH.,397,364,362,225,137
KARTAL,ORHANTEPE MAH.,398,357,351,194,157
KARTAL,PETROL IS MAH.,415,364,360,80,280
KARTAL,PETROL IS MAH.,415,362,357,74,283
KARTAL,PETROL IS MAH.,410,378,375,102,273
KARTAL,PETROL IS MAH.,411,369,366,86,280
KARTAL,PETROL IS MAH.,415,378,377,98,279
KARTAL,PETROL IS MAH.,415,395,392,107,285
KARTAL,PETROL IS MAH.,411,377,370,93,277
KARTAL,PETROL IS MAH.,415,379,377,102,275
KARTAL,PETROL IS MAH.,411,370,367,127,240
KARTAL,PETROL IS MAH.,411,383,381,101,280
KARTAL,PETROL IS MAH.,411,374,368,89,279
KARTAL,PETROL IS MAH.,411,368,362,75,287
KARTAL,PETROL IS MAH.,415,394,391,138,253
KARTAL,PETROL IS MAH.,411,383,381,115,266
KARTAL,PETROL IS MAH.,415,373,369,124,245
KARTAL,PETROL IS MAH.,410,374,367,93,274
KARTAL,PETROL IS MAH.,410,378,371,100,271
KARTAL,PETROL IS MAH.,409,352,346,93,253
KARTAL,PETROL IS MAH.,408,349,345,94,251
KARTAL,PETROL IS MAH.,408,378,371,97,274
KARTAL,PETROL IS MAH.,409,380,377,124,253
KARTAL,PETROL IS MAH.,410,395,393,135,258
KARTAL,PETROL IS MAH.,408,373,370,123,247
KARTAL,PETROL IS MAH.,408,374,370,100,270
KARTAL,PETROL IS MAH.,408,369,366,101,265
KARTAL,PETROL IS MAH.,410,362,357,113,244
KARTAL,PETROL IS MAH.,410,374,368,83,285
KARTAL,PETROL IS MAH.,408,388,388,120,268
KARTAL,PETROL IS MAH.,409,375,371,107,264
KARTAL,PETROL IS MAH.,410,386,384,108,276
KARTAL,PETROL IS MAH.,409,380,378,130,248
KARTAL,PETROL IS MAH.,415,387,380,113,267
KARTAL,PETROL IS MAH.,408,376,371,129,242
KARTAL,PETROL IS MAH.,408,366,363,126,237
KARTAL,PETROL IS MAH.,408,374,369,112,257
KARTAL,PETROL IS MAH.,409,385,385,125,260
KARTAL,PETROL IS MAH.,412,342,341,101,240
KARTAL,PETROL IS MAH.,415,355,353,72,281
KARTAL,PETROL IS MAH.,411,343,341,85,256
KARTAL,PETROL IS MAH.,412,377,369,98,271
KARTAL,PETROL IS MAH.,415,366,363,97,266
KARTAL,PETROL IS MAH.,411,374,369,98,271
KARTAL,PETROL IS MAH.,410,379,376,78,298
KARTAL,PETROL IS MAH.,410,378,373,97,276
KARTAL,PETROL IS MAH.,410,367,361,103,258
KARTAL,PETROL IS MAH.,410,373,367,103,264
KARTAL,PETROL IS MAH.,411,387,383,116,267
KARTAL,PETROL IS MAH.,410,371,366,84,282
KARTAL,PETROL IS MAH.,411,378,374,79,295
KARTAL,PETROL IS MAH.,411,369,367,98,269
KARTAL,PETROL IS MAH.,410,368,365,100,265
KARTAL,PETROL IS MAH.,411,380,378,108,270
KARTAL,PETROL IS MAH.,411,374,373,93,280
KARTAL,PETROL IS MAH.,411,376,375,127,248
KARTAL,YUKARI MAH.,392,321,314,84,230
KARTAL,YUKARI MAH.,392,337,329,77,252
KARTAL,YUKARI MAH.,393,334,331,80,251
KARTAL,YUKARI MAH.,392,351,348,96,252
KARTAL,YUKARI MAH.,396,334,331,82,249
KARTAL,YUKARI MAH.,392,362,357,84,273
KARTAL,YUKARI MAH.,392,356,352,108,244
KARTAL,YUKARI MAH.,392,352,347,96,251
KARTAL,YUKARI MAH.,392,345,337,97,240
KARTAL,YUKARI MAH.,392,359,355,118,237
KARTAL,YUKARI MAH.,393,356,355,114,241
KARTAL,YUKARI MAH.,392,346,344,88,256
KARTAL,YUKARI MAH.,391,351,349,92,257
KARTAL,YUKARI MAH.,392,344,340,92,248
KARTAL,YUKARI MAH.,392,355,348,108,240
KARTAL,YUKARI MAH.,392,364,362,114,248
KARTAL,YUKARI MAH.,391,336,326,117,209
KARTAL,CEVIZLI MAH.,404,358,346,193,153
KARTAL,CEVIZLI MAH.,404,366,362,222,140
KARTAL,CEVIZLI MAH.,404,360,354,232,122
KARTAL,CEVIZLI MAH.,406,355,347,215,132
KARTAL,CEVIZLI MAH.,404,356,354,227,127
KARTAL,CEVIZLI MAH.,404,362,358,219,139
KARTAL,CEVIZLI MAH.,405,371,370,228,142
KARTAL,CEVIZLI MAH.,404,366,364,238,126
KARTAL,CEVIZLI MAH.,405,379,376,244,132
KARTAL,CEVIZLI MAH.,403,371,365,233,132
KARTAL,CEVIZLI MAH.,410,327,321,224,97
KARTAL,CEVIZLI MAH.,415,364,362,229,133
KARTAL,CEVIZLI MAH.,415,355,353,222,131
KARTAL,CEVIZLI MAH.,415,386,379,198,181
KARTAL,CEVIZLI MAH.,415,360,352,216,136
KARTAL,CEVIZLI MAH.,415,370,367,213,154
KARTAL,CEVIZLI MAH.,415,352,350,203,147
KARTAL,CEVIZLI MAH.,415,373,368,199,169
KARTAL,CEVIZLI MAH.,411,363,359,220,139
KARTAL,CEVIZLI MAH.,413,372,370,234,136
KARTAL,CEVIZLI MAH.,413,361,354,222,132
KARTAL,CEVIZLI MAH.,411,376,373,229,144
KARTAL,CEVIZLI MAH.,413,374,369,244,125
KARTAL,CEVIZLI MAH.,413,372,367,219,148
KARTAL,CEVIZLI MAH.,415,372,366,235,131
KARTAL,CEVIZLI MAH.,410,361,352,195,157
KARTAL,CEVIZLI MAH.,408,336,333,200,133
KARTAL,CEVIZLI MAH.,406,354,349,235,114
KARTAL,CEVIZLI MAH.,405,371,368,220,148
KARTAL,CEVIZLI MAH.,406,378,376,220,156
KARTAL,CEVIZLI MAH.,405,366,364,222,142
KARTAL,CEVIZLI MAH.,406,361,353,225,128
KARTAL,CEVIZLI MAH.,406,352,349,205,144
KARTAL,CEVIZLI MAH.,407,370,366,209,157
KARTAL,CEVIZLI MAH.,406,358,347,208,139
KARTAL,CEVIZLI MAH.,405,374,371,216,155
KARTAL,CEVIZLI MAH.,406,371,370,206,164
KARTAL,CEVIZLI MAH.,406,368,364,220,144
KARTAL,CEVIZLI MAH.,395,339,334,226,108
KARTAL,CEVIZLI MAH.,394,350,346,191,155
KARTAL,CEVIZLI MAH.,398,343,340,179,161
KARTAL,CEVIZLI MAH.,393,351,343,185,158
KARTAL,CEVIZLI MAH.,393,329,323,198,125
KARTAL,CEVIZLI MAH.,394,347,341,175,166
KARTAL,CEVIZLI MAH.,393,356,348,195,153
KARTAL,CEVIZLI MAH.,394,340,333,192,141
KARTAL,CEVIZLI MAH.,394,345,339,199,140
KARTAL,CEVIZLI MAH.,393,335,329,189,140
KARTAL,CEVIZLI MAH.,394,359,354,221,133
KARTAL,CEVIZLI MAH.,393,361,351,210,141
KARTAL,ESENTEPE MAH.,381,330,323,203,120
KARTAL,ESENTEPE MAH.,381,344,340,205,135
KARTAL,ESENTEPE MAH.,381,356,354,203,151
KARTAL,ESENTEPE MAH.,382,350,345,190,155
KARTAL,ESENTEPE MAH.,382,348,347,162,185
KARTAL,ESENTEPE MAH.,381,343,339,213,126
KARTAL,ESENTEPE MAH.,381,341,337,189,148
KARTAL,ESENTEPE MAH.,382,355,353,203,150
KARTAL,ESENTEPE MAH.,382,349,340,198,142
KARTAL,ESENTEPE MAH.,404,347,342,167,175
KARTAL,ESENTEPE MAH.,404,363,361,209,152
KARTAL,ESENTEPE MAH.,404,375,372,194,178
KARTAL,ESENTEPE MAH.,404,373,370,187,183
KARTAL,ESENTEPE MAH.,403,365,358,183,175
KARTAL,ESENTEPE MAH.,404,373,362,206,156
KARTAL,ESENTEPE MAH.,404,369,363,201,162
KARTAL,ESENTEPE MAH.,404,366,362,211,151
KARTAL,ESENTEPE MAH.,404,374,371,211,160
KARTAL,ESENTEPE MAH.,402,372,366,199,167
KARTAL,ESENTEPE MAH.,404,373,363,228,135
KARTAL,ESENTEPE MAH.,394,337,326,177,149
KARTAL,ESENTEPE MAH.,394,345,339,162,177
KARTAL,ESENTEPE MAH.,394,360,353,179,174
KARTAL,ESENTEPE MAH.,394,360,356,206,150
KARTAL,ESENTEPE MAH.,392,367,364,175,189
KARTAL,ESENTEPE MAH.,392,355,352,144,208
KARTAL,ESENTEPE MAH.,392,368,364,184,180
KARTAL,ESENTEPE MAH.,392,345,338,181,157
KARTAL,ESENTEPE MAH.,392,353,350,187,163
KARTAL,ESENTEPE MAH.,392,347,337,153,184
KARTAL,ESENTEPE MAH.,392,359,356,184,172
KARTAL,ESENTEPE MAH.,394,354,347,175,172
KARTAL,ESENTEPE MAH.,392,357,351,162,189
KARTAL,ESENTEPE MAH.,392,369,361,176,185
KARTAL,ESENTEPE MAH.,393,349,345,172,173
KARTAL,ESENTEPE MAH.,392,358,353,167,186
KARTAL,ESENTEPE MAH.,395,371,368,183,185
KARTAL,ESENTEPE MAH.,393,370,362,193,169
KARTAL,ESENTEPE MAH.,385,335,330,159,171
KARTAL,ESENTEPE MAH.,385,337,331,196,135
KARTAL,ESENTEPE MAH.,384,340,336,192,144
KARTAL,ESENTEPE MAH.,385,348,343,178,165
KARTAL,ESENTEPE MAH.,386,353,346,174,172
KARTAL,ESENTEPE MAH.,385,350,343,192,151
KARTAL,ESENTEPE MAH.,384,345,339,176,163
KARTAL,ESENTEPE MAH.,386,342,340,189,151
KARTAL,ESENTEPE MAH.,385,344,339,212,127
KARTAL,ESENTEPE MAH.,384,334,329,200,129
KARTAL,ESENTEPE MAH.,385,356,354,185,169
KARTAL,ESENTEPE MAH.,387,357,351,200,151
KARTAL,GUMUSPINAR MAH.,392,344,337,159,178
KARTAL,GUMUSPINAR MAH.,390,311,303,156,147
KARTAL,GUMUSPINAR MAH.,391,345,344,164,180
KARTAL,GUMUSPINAR MAH.,394,358,354,205,149
KARTAL,GUMUSPINAR MAH.,391,348,344,182,162
KARTAL,GUMUSPINAR MAH.,391,352,352,154,198
KARTAL,GUMUSPINAR MAH.,390,361,357,170,187
KARTAL,GUMUSPINAR MAH.,390,353,349,142,207
KARTAL,GUMUSPINAR MAH.,391,366,363,185,178
KARTAL,GUMUSPINAR MAH.,391,352,346,167,179
KARTAL,GUMUSPINAR MAH.,391,353,349,181,168
KARTAL,GUMUSPINAR MAH.,391,339,337,165,172
KARTAL,GUMUSPINAR MAH.,392,349,345,150,195
KARTAL,GUMUSPINAR MAH.,390,354,350,160,190
KARTAL,GUMUSPINAR MAH.,391,349,347,141,206
KARTAL,GUMUSPINAR MAH.,405,346,335,186,149
KARTAL,GUMUSPINAR MAH.,405,358,354,163,191
KARTAL,GUMUSPINAR MAH.,404,378,368,214,154
KARTAL,GUMUSPINAR MAH.,405,363,354,157,197
KARTAL,GUMUSPINAR MAH.,404,372,362,197,165
KARTAL,GUMUSPINAR MAH.,405,367,360,183,177
KARTAL,GUMUSPINAR MAH.,406,372,370,169,201
KARTAL,GUMUSPINAR MAH.,405,356,347,160,187
KARTAL,GUMUSPINAR MAH.,404,359,356,173,183
KARTAL,GUMUSPINAR MAH.,404,380,376,205,171
KARTAL,GUMUSPINAR MAH.,405,373,367,160,207
KARTAL,GUMUSPINAR MAH.,405,363,356,170,186
KARTAL,GUMUSPINAR MAH.,403,361,355,157,198
KARTAL,GUMUSPINAR MAH.,407,359,353,191,162
KARTAL,GUMUSPINAR MAH.,404,361,355,155,200
KARTAL,GUMUSPINAR MAH.,404,372,369,169,200
KARTAL,GUMUSPINAR MAH.,406,364,360,131,229
KARTAL,GUMUSPINAR MAH.,404,364,361,183,178
KARTAL,GUMUSPINAR MAH.,403,368,361,169,192
KARTAL,GUMUSPINAR MAH.,405,351,341,144,197
KARTAL,GUMUSPINAR MAH.,405,331,328,162,166
KARTAL,GUMUSPINAR MAH.,405,373,368,173,195
KARTAL,GUMUSPINAR MAH.,405,365,362,183,179
KARTAL,GUMUSPINAR MAH.,406,379,377,210,167
KARTAL,GUMUSPINAR MAH.,406,375,365,202,163
KARTAL,GUMUSPINAR MAH.,406,367,362,167,195
KARTAL,GUMUSPINAR MAH.,406,383,380,153,227
KARTAL,GUMUSPINAR MAH.,405,382,374,192,182
KARTAL,GUMUSPINAR MAH.,406,377,368,181,187
KARTAL,GUMUSPINAR MAH.,406,366,361,157,204
KARTAL,GUMUSPINAR MAH.,405,364,356,188,168
KARTAL,GUMUSPINAR MAH.,405,377,369,202,167
KARTAL,GUMUSPINAR MAH.,405,380,367,175,192
KARTAL,ORTA MAH.,412,347,339,170,169
KARTAL,ORTA MAH.,411,353,343,188,155
KARTAL,ORTA MAH.,412,345,336,203,133
KARTAL,ORTA MAH.,412,370,367,188,179
KARTAL,ORTA MAH.,411,378,373,173,200
KARTAL,ORTA MAH.,412,383,379,206,173
KARTAL,ORTA MAH.,412,388,387,206,181
KARTAL,ORTA MAH.,412,381,380,173,207
KARTAL,ORTA MAH.,411,362,360,181,179
KARTAL,ORTA MAH.,415,388,386,208,178
KARTAL,ORTA MAH.,411,377,375,202,173
KARTAL,ORTA MAH.,411,360,357,164,193
KARTAL,ORTA MAH.,412,374,369,186,183
KARTAL,ORTA MAH.,412,372,366,190,176
KARTAL,ORTA MAH.,411,379,378,180,198
KARTAL,ORTA MAH.,410,366,361,192,169
KARTAL,ORTA MAH.,412,363,357,167,190
KARTAL,ORTA MAH.,410,374,369,165,204
KARTAL,ORTA MAH.,412,360,357,203,154
KARTAL,ORTA MAH.,412,371,364,179,185
KARTAL,ORTA MAH.,412,373,372,198,174
KARTAL,ORTA MAH.,412,380,367,179,188
KARTAL,ORTA MAH.,412,363,359,171,188
KARTAL,ORTA MAH.,412,384,377,198,179
KARTAL,ORTA MAH.,412,365,360,161,199
KARTAL,ORTA MAH.,412,366,363,174,189
KARTAL,ORTA MAH.,411,374,373,153,220
KARTAL,ORTA MAH.,412,378,374,180,194
KARTAL,ORTA MAH.,412,376,371,143,228
KARTAL,ORTA MAH.,412,376,372,196,176
KARTAL,ORTA MAH.,411,382,377,196,181
KARTAL,ORTA MAH.,411,370,368,161,207
KARTAL,ORTA MAH.,410,384,380,228,152
KARTAL,SOGANLIK YENI MAH.,392,323,315,192,123
KARTAL,SOGANLIK YENI MAH.,393,356,353,171,182
KARTAL,SOGANLIK YENI MAH.,392,357,352,160,192
KARTAL,SOGANLIK YENI MAH.,392,362,359,159,200
KARTAL,SOGANLIK YENI MAH.,392,352,349,145,204
KARTAL,SOGANLIK YENI MAH.,392,349,341,167,174
KARTAL,SOGANLIK YENI MAH.,393,353,349,183,166
KARTAL,SOGANLIK YENI MAH.,392,349,345,163,182
KARTAL,SOGANLIK YENI MAH.,392,367,357,159,198
KARTAL,SOGANLIK YENI MAH.,392,357,354,153,201
KARTAL,SOGANLIK YENI MAH.,392,358,352,160,192
KARTAL,SOGANLIK YENI MAH.,392,361,356,160,196
KARTAL,SOGANLIK YENI MAH.,391,335,330,134,196
KARTAL,SOGANLIK YENI MAH.,391,359,356,142,214
KARTAL,SOGANLIK YENI MAH.,391,364,358,164,194
KARTAL,SOGANLIK YENI MAH.,391,361,361,187,174
KARTAL,SOGANLIK YENI MAH.,407,342,340,213,127
KARTAL,SOGANLIK YENI MAH.,406,355,349,175,174
KARTAL,SOGANLIK YENI MAH.,405,368,365,211,154
KARTAL,SOGANLIK YENI MAH.,405,364,361,194,167
KARTAL,SOGANLIK YENI MAH.,406,359,354,159,195
KARTAL,SOGANLIK YENI MAH.,406,353,349,189,160
KARTAL,SOGANLIK YENI MAH.,407,378,374,191,183
KARTAL,SOGANLIK YENI MAH.,405,364,361,195,166
KARTAL,SOGANLIK YENI MAH.,405,374,364,206,158
KARTAL,SOGANLIK YENI MAH.,405,370,362,189,173
KARTAL,SOGANLIK YENI MAH.,405,375,370,182,188
KARTAL,SOGANLIK YENI MAH.,405,361,355,188,167
KARTAL,SOGANLIK YENI MAH.,405,374,369,175,194
KARTAL,SOGANLIK YENI MAH.,406,379,369,176,193
KARTAL,SOGANLIK YENI MAH.,405,371,364,190,174
KARTAL,SOGANLIK YENI MAH.,405,360,354,183,171
KARTAL,SOGANLIK YENI MAH.,404,346,338,182,156
KARTAL,SOGANLIK YENI MAH.,406,342,336,175,161
KARTAL,SOGANLIK YENI MAH.,404,354,345,171,174
KARTAL,SOGANLIK YENI MAH.,404,352,350,188,162
KARTAL,SOGANLIK YENI MAH.,404,365,358,173,185
KARTAL,SOGANLIK YENI MAH.,404,367,365,204,161
KARTAL,SOGANLIK YENI MAH.,403,372,369,160,209
KARTAL,SOGANLIK YENI MAH.,403,358,355,183,172
KARTAL,SOGANLIK YENI MAH.,404,376,372,181,191
KARTAL,SOGANLIK YENI MAH.,403,370,366,170,196
KARTAL,SOGANLIK YENI MAH.,403,364,355,194,161
KARTAL,SOGANLIK YENI MAH.,404,363,362,165,197
KARTAL,SOGANLIK YENI MAH.,404,365,364,187,177
KARTAL,SOGANLIK YENI MAH.,404,361,359,188,171
KARTAL,SOGANLIK YENI MAH.,404,357,355,188,167
KARTAL,SOGANLIK YENI MAH.,404,374,370,172,198
KARTAL,SOGANLIK YENI MAH.,404,364,355,160,195
KARTAL,TOPSELVI MAH.,400,322,312,168,144
KARTAL,TOPSELVI MAH.,401,349,339,184,155
KARTAL,TOPSELVI MAH.,400,353,349,193,156
KARTAL,TOPSELVI MAH.,400,360,355,185,170
KARTAL,TOPSELVI MAH.,401,359,345,183,162
KARTAL,TOPSELVI MAH.,403,359,352,210,142
KARTAL,TOPSELVI MAH.,400,359,356,182,174
KARTAL,TOPSELVI MAH.,401,365,358,198,160
KARTAL,TOPSELVI MAH.,401,353,349,176,173
KARTAL,TOPSELVI MAH.,401,374,369,182,187
KARTAL,TOPSELVI MAH.,401,363,359,198,161
KARTAL,TOPSELVI MAH.,400,364,358,220,138
KARTAL,TOPSELVI MAH.,401,352,343,211,132
KARTAL,TOPSELVI MAH.,401,369,365,207,158
KARTAL,TOPSELVI MAH.,400,365,362,209,153
KARTAL,TOPSELVI MAH.,401,358,350,187,163
KARTAL,TOPSELVI MAH.,401,357,351,180,171
KARTAL,TOPSELVI MAH.,401,370,363,203,160
KARTAL,TOPSELVI MAH.,400,353,350,217,133
KARTAL,TOPSELVI MAH.,401,357,351,192,159
KARTAL,TOPSELVI MAH.,400,357,351,184,167
KARTAL,TOPSELVI MAH.,401,364,360,214,146
KARTAL,UGUR MUMCU MAH.,380,315,309,122,187
KARTAL,UGUR MUMCU MAH.,381,336,333,117,216
KARTAL,UGUR MUMCU MAH.,379,355,352,111,241
KARTAL,UGUR MUMCU MAH.,380,350,341,137,204
KARTAL,UGUR MUMCU MAH.,380,348,346,137,209
KARTAL,UGUR MUMCU MAH.,380,350,344,130,214
KARTAL,UGUR MUMCU MAH.,379,342,340,136,204
KARTAL,UGUR MUMCU MAH.,380,351,349,131,218
KARTAL,UGUR MUMCU MAH.,379,334,324,127,197
KARTAL,UGUR MUMCU MAH.,379,350,347,119,228
KARTAL,UGUR MUMCU MAH.,401,328,325,83,242
KARTAL,UGUR MUMCU MAH.,402,357,350,108,242
KARTAL,UGUR MUMCU MAH.,402,353,346,100,246
KARTAL,UGUR MUMCU MAH.,400,366,359,113,246
KARTAL,UGUR MUMCU MAH.,401,356,354,113,241
KARTAL,UGUR MUMCU MAH.,401,365,361,106,255
KARTAL,UGUR MUMCU MAH.,401,358,358,129,229
KARTAL,UGUR MUMCU MAH.,401,366,362,127,235
KARTAL,UGUR MUMCU MAH.,401,359,355,98,257
KARTAL,UGUR MUMCU MAH.,401,365,363,118,245
KARTAL,UGUR MUMCU MAH.,400,355,351,113,238
KARTAL,UGUR MUMCU MAH.,400,367,366,104,262
KARTAL,UGUR MUMCU MAH.,401,357,353,118,235
KARTAL,UGUR MUMCU MAH.,400,360,355,109,246
KARTAL,UGUR MUMCU MAH.,401,363,359,94,265
KARTAL,UGUR MUMCU MAH.,400,367,361,123,238
KARTAL,UGUR MUMCU MAH.,400,371,368,98,270
KARTAL,UGUR MUMCU MAH.,405,363,354,133,221
KARTAL,UGUR MUMCU MAH.,404,372,369,115,254
KARTAL,UGUR MUMCU MAH.,404,369,364,126,238
KARTAL,UGUR MUMCU MAH.,405,361,357,137,220
KARTAL,UGUR MUMCU MAH.,408,365,361,149,212
KARTAL,UGUR MUMCU MAH.,402,366,365,136,229
KARTAL,UGUR MUMCU MAH.,404,377,372,135,237
KARTAL,UGUR MUMCU MAH.,406,372,369,137,232
KARTAL,UGUR MUMCU MAH.,398,331,327,112,215
KARTAL,UGUR MUMCU MAH.,399,344,338,130,208
KARTAL,UGUR MUMCU MAH.,400,360,357,121,236
KARTAL,UGUR MUMCU MAH.,400,363,359,145,214
KARTAL,UGUR MUMCU MAH.,402,369,363,127,236
KARTAL,UGUR MUMCU MAH.,398,369,369,131,238
KARTAL,UGUR MUMCU MAH.,399,372,369,122,247
KARTAL,UGUR MUMCU MAH.,400,373,369,117,252
KARTAL,UGUR MUMCU MAH.,400,369,367,112,255
KARTAL,UGUR MUMCU MAH.,399,359,355,137,218
KARTAL,UGUR MUMCU MAH.,400,374,371,125,246
KARTAL,UGUR MUMCU MAH.,399,361,356,137,219
KARTAL,UGUR MUMCU MAH.,400,357,353,127,226
KARTAL,UGUR MUMCU MAH.,400,373,368,127,241
KARTAL,UGUR MUMCU MAH.,400,379,376,128,248
KARTAL,UGUR MUMCU MAH.,401,346,338,112,226
KARTAL,UGUR MUMCU MAH.,400,345,337,121,216
KARTAL,UGUR MUMCU MAH.,400,370,364,135,229
KARTAL,UGUR MUMCU MAH.,400,373,370,135,235
KARTAL,UGUR MUMCU MAH.,402,367,365,132,233
KARTAL,UGUR MUMCU MAH.,400,371,367,151,216
KARTAL,UGUR MUMCU MAH.,401,350,346,108,238
KARTAL,UGUR MUMCU MAH.,400,378,375,138,237
KARTAL,UGUR MUMCU MAH.,399,362,358,121,237
KARTAL,UGUR MUMCU MAH.,401,367,358,129,229
KARTAL,UGUR MUMCU MAH.,400,355,351,122,229
KARTAL,UGUR MUMCU MAH.,401,357,346,134,212
KARTAL,UGUR MUMCU MAH.,400,364,361,111,250
KARTAL,UGUR MUMCU MAH.,401,352,349,126,223
KARTAL,UGUR MUMCU MAH.,401,367,361,125,236
KARTAL,UGUR MUMCU MAH.,400,367,358,124,234
KARTAL,UGUR MUMCU MAH.,399,365,362,125,237
KARTAL,UGUR MUMCU MAH.,403,365,362,141,221
KARTAL,UGUR MUMCU MAH.,405,341,335,86,249
KARTAL,UGUR MUMCU MAH.,406,350,346,113,233
KARTAL,UGUR MUMCU MAH.,406,369,363,125,238
KARTAL,UGUR MUMCU MAH.,405,370,367,133,234
KARTAL,UGUR MUMCU MAH.,406,363,362,120,242
KARTAL,UGUR MUMCU MAH.,406,351,345,108,237
KARTAL,UGUR MUMCU MAH.,408,387,383,124,259
KARTAL,UGUR MUMCU MAH.,406,368,367,114,253
KARTAL,UGUR MUMCU MAH.,406,367,362,131,231
KARTAL,UGUR MUMCU MAH.,405,377,372,154,218
KARTAL,UGUR MUMCU MAH.,405,376,370,117,253
KARTAL,YAKACIK CARSI MAH.,415,339,332,148,184
KARTAL,YAKACIK CARSI MAH.,412,335,329,131,198
KARTAL,YAKACIK CARSI MAH.,412,373,369,158,211
KARTAL,YAKACIK CARSI MAH.,412,367,358,161,197
KARTAL,YAKACIK CARSI MAH.,412,362,358,154,204
KARTAL,YAKACIK CARSI MAH.,411,362,357,125,232
KARTAL,YAKACIK CARSI MAH.,412,368,362,163,199
KARTAL,YAKACIK CARSI MAH.,412,365,358,151,207
KARTAL,YAKACIK CARSI MAH.,412,377,367,147,220
KARTAL,YAKACIK CARSI MAH.,411,380,375,180,195
KARTAL,YAKACIK CARSI MAH.,415,371,369,169,200
KARTAL,YAKACIK CARSI MAH.,412,381,376,178,198
KARTAL,YAKACIK CARSI MAH.,412,374,366,177,189
KARTAL,YAKACIK CARSI MAH.,412,370,365,168,197
KARTAL,YAKACIK CARSI MAH.,416,365,357,94,263
KARTAL,YAKACIK CARSI MAH.,415,353,346,134,212
KARTAL,YAKACIK CARSI MAH.,416,388,381,140,241
KARTAL,YAKACIK CARSI MAH.,416,385,381,143,238
KARTAL,YAKACIK CARSI MAH.,414,380,379,140,239
KARTAL,YAKACIK CARSI MAH.,415,375,368,143,225
KARTAL,YAKACIK CARSI MAH.,416,381,380,128,252
KARTAL,YAKACIK CARSI MAH.,415,381,375,134,241
KARTAL,YAKACIK CARSI MAH.,415,385,384,110,274
KARTAL,YAKACIK CARSI MAH.,416,390,387,140,247
KARTAL,YAKACIK CARSI MAH.,416,370,361,108,253
KARTAL,YAKACIK CARSI MAH.,417,391,389,141,248
KARTAL,YAKACIK CARSI MAH.,415,386,378,141,237
KARTAL,YAKACIK CARSI MAH.,416,375,368,145,223
KARTAL,YAKACIK YENI MAH.,405,325,322,144,178
KARTAL,YAKACIK YENI MAH.,405,346,337,168,169
KARTAL,YAKACIK YENI MAH.,405,359,356,181,175
KARTAL,YAKACIK YENI MAH.,407,366,364,198,166
KARTAL,YAKACIK YENI MAH.,407,371,365,163,202
KARTAL,YAKACIK YENI MAH.,407,381,376,158,218
KARTAL,YAKACIK YENI MAH.,408,365,356,177,179
KARTAL,YAKACIK YENI MAH.,406,368,362,189,173
KARTAL,YAKACIK YENI MAH.,406,359,355,178,177
KARTAL,YAKACIK YENI MAH.,407,360,356,180,176
KARTAL,YAKACIK YENI MAH.,406,370,360,166,194
KARTAL,YAKACIK YENI MAH.,406,378,376,191,185
KARTAL,YAKACIK YENI MAH.,406,378,374,192,182
KARTAL,YAKACIK YENI MAH.,406,360,354,157,197
KARTAL,YAKACIK YENI MAH.,409,366,362,172,190
KARTAL,YAKACIK YENI MAH.,406,361,355,158,197
KARTAL,YAKACIK YENI MAH.,406,372,364,181,183
KARTAL,YAKACIK YENI MAH.,410,382,371,229,142
KARTAL,YAKACIK YENI MAH.,406,373,365,185,180
KARTAL,YAKACIK YENI MAH.,406,361,354,177,177
KARTAL,YAKACIK YENI MAH.,405,380,375,156,219
KARTAL,YAKACIK YENI MAH.,405,360,355,172,183
KARTAL,YAKACIK YENI MAH.,406,361,357,161,196
KARTAL,YAKACIK YENI MAH.,405,374,370,160,210
KARTAL,YAKACIK YENI MAH.,406,369,366,179,187
KARTAL,YAKACIK YENI MAH.,405,370,361,189,172
KARTAL,YAKACIK YENI MAH.,405,364,351,177,174
KARTAL,YAKACIK YENI MAH.,408,371,369,185,184
KARTAL,YALI MAH.,415,343,340,209,131
KARTAL,YALI MAH.,410,333,330,157,173
KARTAL,YALI MAH.,415,380,371,175,196
KARTAL,YALI MAH.,411,365,363,175,188
KARTAL,YALI MAH.,411,373,372,188,184
KARTAL,YALI MAH.,412,377,373,198,175
KARTAL,YALI MAH.,411,377,373,208,165
KARTAL,YALI MAH.,411,374,370,181,189
KARTAL,YALI MAH.,412,360,353,180,173
KARTAL,YALI MAH.,411,371,369,183,186
KARTAL,YALI MAH.,411,368,364,191,173
KARTAL,YALI MAH.,410,375,371,202,169
KARTAL,YALI MAH.,411,391,386,205,181
KARTAL,YALI MAH.,411,360,353,170,183
KARTAL,YALI MAH.,410,365,359,179,180
KARTAL,YALI MAH.,410,362,358,190,168
KARTAL,YALI MAH.,410,360,356,184,172
KARTAL,YALI MAH.,410,376,368,199,169
KARTAL,YALI MAH.,410,374,370,200,170
KARTAL,YALI MAH.,411,368,366,186,180
KARTAL,YALI MAH.,410,372,368,172,196
KARTAL,YUNUS MAH.,409,343,340,189,151
KARTAL,YUNUS MAH.,408,348,348,132,216
KARTAL,YUNUS MAH.,408,367,362,155,207
KARTAL,YUNUS MAH.,408,358,353,193,160
KARTAL,YUNUS MAH.,408,364,361,169,192
KARTAL,YUNUS MAH.,408,382,376,187,189
KARTAL,YUNUS MAH.,408,366,364,194,170
KARTAL,YUNUS MAH.,408,372,371,191,180
KARTAL,YUNUS MAH.,410,371,369,172,197
KARTAL,YUNUS MAH.,408,378,372,166,206
KARTAL,YUNUS MAH.,408,370,362,176,186
KARTAL,YUNUS MAH.,407,374,366,195,171
KARTAL,YUNUS MAH.,410,369,365,181,184
KARTAL,YUNUS MAH.,409,368,366,185,181
KARTAL,YUNUS MAH.,409,368,366,169,197
KARTAL,YUNUS MAH.,408,379,374,185,189
KARTAL,YUNUS MAH.,408,371,369,173,196
KARTAL,YUNUS MAH.,408,365,360,175,185
KARTAL,YUNUS MAH.,407,365,360,170,190
KARTAL,YUNUS MAH.,408,351,345,152,193
KARTAL,YUNUS MAH.,408,375,371,205,166
KARTAL,YUNUS MAH.,408,373,367,180,187
KARTAL,YUNUS MAH.,408,375,371,177,194
KARTAL,YUNUS MAH.,408,365,361,189,172
KARTAL,YUNUS MAH.,408,365,356,176,180
KARTAL,YUNUS MAH.,407,367,358,198,160
KARTAL,YUNUS MAH.,408,364,358,199,159
KARTAL,YUNUS MAH.,409,373,365,191,174
BAKIRKOY,ATAKOY 1. KISIM MAH.,340,278,271,38,233
BAKIRKOY,ATAKOY 1. KISIM MAH.,339,299,296,60,236
BAKIRKOY,ATAKOY 1. KISIM MAH.,338,312,311,51,260
BAKIRKOY,ATAKOY 1. KISIM MAH.,337,320,318,61,257
BAKIRKOY,ATAKOY 2-5-6. KISIM MAH.,402,351,347,50,297
BAKIRKOY,ATAKOY 2-5-6. KISIM MAH.,401,349,342,51,291
BAKIRKOY,ATAKOY 2-5-6. KISIM MAH.,402,364,357,59,298
BAKIRKOY,ATAKOY 2-5-6. KISIM MAH.,401,374,368,55,313
BAKIRKOY,ATAKOY 2-5-6. KISIM MAH.,401,368,360,43,317
BAKIRKOY,ATAKOY 2-5-6. KISIM MAH.,402,372,368,67,301
BAKIRKOY,ATAKOY 2-5-6. KISIM MAH.,402,359,357,66,291
BAKIRKOY,ATAKOY 2-5-6. KISIM MAH.,401,360,354,56,298
BAKIRKOY,ATAKOY 2-5-6. KISIM MAH.,402,371,366,59,307
BAKIRKOY,ATAKOY 2-5-6. KISIM MAH.,401,381,377,59,318
BAKIRKOY,ATAKOY 2-5-6. KISIM MAH.,400,377,373,65,308
BAKIRKOY,ATAKOY 2-5-6. KISIM MAH.,401,365,364,56,308
BAKIRKOY,ATAKOY 2-5-6. KISIM MAH.,400,376,370,74,296
BAKIRKOY,ATAKOY 2-5-6. KISIM MAH.,401,367,361,63,298
BAKIRKOY,ATAKOY 2-5-6. KISIM MAH.,391,354,350,51,299
BAKIRKOY,ATAKOY 2-5-6. KISIM MAH.,390,334,328,61,267
BAKIRKOY,ATAKOY 2-5-6. KISIM MAH.,391,359,355,69,286
BAKIRKOY,ATAKOY 2-5-6. KISIM MAH.,390,358,354,70,284
BAKIRKOY,ATAKOY 2-5-6. KISIM MAH.,389,359,357,64,293
BAKIRKOY,ATAKOY 2-5-6. KISIM MAH.,391,366,364,74,290
BAKIRKOY,ATAKOY 2-5-6. KISIM MAH.,389,370,366,66,300
BAKIRKOY,ATAKOY 2-5-6. KISIM MAH.,390,359,353,73,280
BAKIRKOY,ATAKOY 2-5-6. KISIM MAH.,390,356,352,68,284
BAKIRKOY,ATAKOY 2-5-6. KISIM MAH.,390,362,355,75,280
BAKIRKOY,ATAKOY 2-5-6. KISIM MAH.,389,368,366,46,320
BAKIRKOY,ATAKOY 2-5-6. KISIM MAH.,390,372,365,63,302
BAKIRKOY,ATAKOY 3-4-11. KISIM MAH.,410,366,359,47,312
BAKIRKOY,ATAKOY 3-4-11. KISIM MAH.,411,355,353,30,323
BAKIRKOY,ATAKOY 3-4-11. KISIM MAH.,409,388,383,46,337
BAKIRKOY,ATAKOY 3-4-11. KISIM MAH.,410,392,386,58,328
BAKIRKOY,ATAKOY 3-4-11. KISIM MAH.,408,386,380,64,316
BAKIRKOY,ATAKOY 3-4-11. KISIM MAH.,409,393,386,63,323
BAKIRKOY,ATAKOY 3-4-11. KISIM MAH.,409,368,363,63,300
BAKIRKOY,ATAKOY 3-4-11. KISIM MAH.,409,380,375,43,332
BAKIRKOY,ATAKOY 3-4-11. KISIM MAH.,410,388,385,54,331
BAKIRKOY,ATAKOY 3-4-11. KISIM MAH.,413,353,347,37,310
BAKIRKOY,ATAKOY 3-4-11. KISIM MAH.,412,370,367,41,326
BAKIRKOY,ATAKOY 3-4-11. KISIM MAH.,411,381,377,56,321
BAKIRKOY,ATAKOY 3-4-11. KISIM MAH.,415,389,383,56,327
BAKIRKOY,ATAKOY 3-4-11. KISIM MAH.,411,398,394,51,343
BAKIRKOY,ATAKOY 3-4-11. KISIM MAH.,412,373,368,41,327
BAKIRKOY,ATAKOY 3-4-11. KISIM MAH.,412,394,390,53,337
BAKIRKOY,ATAKOY 7-8-9-10. KISIM MAH.,414,348,338,43,295
BAKIRKOY,ATAKOY 7-8-9-10. KISIM MAH.,416,392,389,56,333
BAKIRKOY,ATAKOY 7-8-9-10. KISIM MAH.,416,385,384,54,330
BAKIRKOY,ATAKOY 7-8-9-10. KISIM MAH.,415,396,389,65,324
BAKIRKOY,ATAKOY 7-8-9-10. KISIM MAH.,415,380,376,61,315
BAKIRKOY,ATAKOY 7-8-9-10. KISIM MAH.,415,391,387,54,333
BAKIRKOY,ATAKOY 7-8-9-10. KISIM MAH.,416,392,387,59,328
BAKIRKOY,ATAKOY 7-8-9-10. KISIM MAH.,415,388,382,47,335
BAKIRKOY,ATAKOY 7-8-9-10. KISIM MAH.,415,389,388,67,321
BAKIRKOY,ATAKOY 7-8-9-10. KISIM MAH.,414,389,382,52,330
BAKIRKOY,ATAKOY 7-8-9-10. KISIM MAH.,382,333,330,40,290
BAKIRKOY,ATAKOY 7-8-9-10. KISIM MAH.,382,346,340,45,295
BAKIRKOY,ATAKOY 7-8-9-10. KISIM MAH.,382,368,365,70,295
BAKIRKOY,ATAKOY 7-8-9-10. KISIM MAH.,382,348,345,58,287
BAKIRKOY,ATAKOY 7-8-9-10. KISIM MAH.,382,353,350,66,284
BAKIRKOY,ATAKOY 7-8-9-10. KISIM MAH.,384,363,352,61,291
BAKIRKOY,ATAKOY 7-8-9-10. KISIM MAH.,382,353,349,56,293
BAKIRKOY,ATAKOY 7-8-9-10. KISIM MAH.,382,362,358,52,306
BAKIRKOY,ATAKOY 7-8-9-10. KISIM MAH.,382,361,356,56,300
BAKIRKOY,ATAKOY 7-8-9-10. KISIM MAH.,382,356,351,52,299
BAKIRKOY,ATAKOY 7-8-9-10. KISIM MAH.,382,355,353,61,292
BAKIRKOY,ATAKOY 7-8-9-10. KISIM MAH.,392,331,323,47,276
BAKIRKOY,ATAKOY 7-8-9-10. KISIM MAH.,392,363,354,58,296
BAKIRKOY,ATAKOY 7-8-9-10. KISIM MAH.,392,356,353,53,300
BAKIRKOY,ATAKOY 7-8-9-10. KISIM MAH.,392,375,370,49,321
BAKIRKOY,ATAKOY 7-8-9-10. KISIM MAH.,392,377,374,68,306
BAKIRKOY,ATAKOY 7-8-9-10. KISIM MAH.,392,372,367,52,315
BAKIRKOY,ATAKOY 7-8-9-10. KISIM MAH.,393,378,378,52,326
BAKIRKOY,ATAKOY 7-8-9-10. KISIM MAH.,393,358,349,49,300
BAKIRKOY,ATAKOY 7-8-9-10. KISIM MAH.,394,372,369,46,323
BAKIRKOY,ATAKOY 7-8-9-10. KISIM MAH.,393,363,356,40,316
BAKIRKOY,ATAKOY 7-8-9-10. KISIM MAH.,393,369,367,52,315
BAKIRKOY,ATAKOY 7-8-9-10. KISIM MAH.,395,338,335,35,300
BAKIRKOY,ATAKOY 7-8-9-10. KISIM MAH.,397,338,333,31,302
BAKIRKOY,ATAKOY 7-8-9-10. KISIM MAH.,395,362,360,48,312
BAKIRKOY,ATAKOY 7-8-9-10. KISIM MAH.,394,352,349,45,304
BAKIRKOY,ATAKOY 7-8-9-10. KISIM MAH.,395,368,363,45,318
BAKIRKOY,ATAKOY 7-8-9-10. KISIM MAH.,395,376,372,53,319
BAKIRKOY,ATAKOY 7-8-9-10. KISIM MAH.,395,359,355,42,313
BAKIRKOY,ATAKOY 7-8-9-10. KISIM MAH.,394,362,355,44,311
BAKIRKOY,ATAKOY 7-8-9-10. KISIM MAH.,395,374,369,61,308
BAKIRKOY,ATAKOY 7-8-9-10. KISIM MAH.,395,367,364,46,318
BAKIRKOY,ATAKOY 7-8-9-10. KISIM MAH.,395,355,350,44,306
BAKIRKOY,ATAKOY 7-8-9-10. KISIM MAH.,394,368,368,41,327
BAKIRKOY,ATAKOY 7-8-9-10. KISIM MAH.,395,347,346,44,302
BAKIRKOY,ATAKOY 7-8-9-10. KISIM MAH.,395,356,353,50,303
BAKIRKOY,ATAKOY 7-8-9-10. KISIM MAH.,394,368,363,43,320
BAKIRKOY,BASINKOY MAH.,403,333,326,104,222
BAKIRKOY,BASINKOY MAH.,403,358,351,117,234
BAKIRKOY,BASINKOY MAH.,402,357,349,162,187
BAKIRKOY,BASINKOY MAH.,404,374,371,154,217
BAKIRKOY,BASINKOY MAH.,405,370,368,143,225
BAKIRKOY,BASINKOY MAH.,405,363,357,109,248
BAKIRKOY,BASINKOY MAH.,403,358,353,111,242
BAKIRKOY,BASINKOY MAH.,403,372,365,146,219
BAKIRKOY,BASINKOY MAH.,403,370,365,137,228
BAKIRKOY,BASINKOY MAH.,403,342,333,110,223
BAKIRKOY,BASINKOY MAH.,403,363,361,119,242
BAKIRKOY,CEVIZLIK MAH.,415,326,324,59,265
BAKIRKOY,CEVIZLIK MAH.,410,308,304,56,248
BAKIRKOY,CEVIZLIK MAH.,411,341,334,70,264
BAKIRKOY,CEVIZLIK MAH.,411,356,352,56,296
BAKIRKOY,CEVIZLIK MAH.,411,341,339,69,270
BAKIRKOY,CEVIZLIK MAH.,411,372,370,76,294
BAKIRKOY,CEVIZLIK MAH.,411,356,352,46,306
BAKIRKOY,CEVIZLIK MAH.,411,354,349,87,262
BAKIRKOY,CEVIZLIK MAH.,411,346,343,71,272
BAKIRKOY,CEVIZLIK MAH.,412,352,349,73,276
BAKIRKOY,KARTALTEPE MAH.,403,327,323,78,245
BAKIRKOY,KARTALTEPE MAH.,403,309,303,56,247
BAKIRKOY,KARTALTEPE MAH.,406,325,320,75,245
BAKIRKOY,KARTALTEPE MAH.,403,349,346,69,277
BAKIRKOY,KARTALTEPE MAH.,403,367,361,71,290
BAKIRKOY,KARTALTEPE MAH.,403,352,348,64,284
BAKIRKOY,KARTALTEPE MAH.,402,372,368,67,301
BAKIRKOY,KARTALTEPE MAH.,404,373,371,64,307
BAKIRKOY,KARTALTEPE MAH.,403,369,368,70,298
BAKIRKOY,KARTALTEPE MAH.,402,353,351,69,282
BAKIRKOY,KARTALTEPE MAH.,403,367,360,89,271
BAKIRKOY,KARTALTEPE MAH.,403,357,353,89,264
BAKIRKOY,KARTALTEPE MAH.,403,353,353,105,248
BAKIRKOY,KARTALTEPE MAH.,404,364,359,75,284
BAKIRKOY,KARTALTEPE MAH.,405,379,373,77,296
BAKIRKOY,KARTALTEPE MAH.,402,339,311,94,217
BAKIRKOY,KARTALTEPE MAH.,403,365,364,68,296
BAKIRKOY,KARTALTEPE MAH.,402,365,356,73,283
BAKIRKOY,KARTALTEPE MAH.,402,364,360,86,274
BAKIRKOY,KARTALTEPE MAH.,404,359,356,76,280
BAKIRKOY,KARTALTEPE MAH.,364,312,307,44,263
BAKIRKOY,KARTALTEPE MAH.,365,329,327,58,269
BAKIRKOY,KARTALTEPE MAH.,364,327,326,70,256
BAKIRKOY,KARTALTEPE MAH.,364,337,333,80,253
BAKIRKOY,KARTALTEPE MAH.,363,327,323,71,252
BAKIRKOY,KARTALTEPE MAH.,392,327,324,67,257
BAKIRKOY,KARTALTEPE MAH.,392,343,339,85,254
BAKIRKOY,KARTALTEPE MAH.,393,317,310,68,242
BAKIRKOY,KARTALTEPE MAH.,392,357,354,65,289
BAKIRKOY,KARTALTEPE MAH.,393,344,339,77,262
BAKIRKOY,KARTALTEPE MAH.,392,369,360,77,283
BAKIRKOY,KARTALTEPE MAH.,392,355,352,74,278
BAKIRKOY,KARTALTEPE MAH.,393,365,358,84,274
BAKIRKOY,KARTALTEPE MAH.,393,361,358,74,284
BAKIRKOY,KARTALTEPE MAH.,393,367,364,85,279
BAKIRKOY,KARTALTEPE MAH.,393,371,365,59,306
BAKIRKOY,KARTALTEPE MAH.,392,364,359,82,277
BAKIRKOY,KARTALTEPE MAH.,393,357,352,81,271
BAKIRKOY,KARTALTEPE MAH.,392,351,347,102,245
BAKIRKOY,KARTALTEPE MAH.,392,362,359,78,281
BAKIRKOY,KARTALTEPE MAH.,393,360,358,68,290
BAKIRKOY,KARTALTEPE MAH.,396,363,360,68,292
BAKIRKOY,KARTALTEPE MAH.,393,360,357,86,271
BAKIRKOY,KARTALTEPE MAH.,404,334,325,88,237
BAKIRKOY,KARTALTEPE MAH.,401,336,329,70,259
BAKIRKOY,KARTALTEPE MAH.,400,357,350,83,267
BAKIRKOY,KARTALTEPE MAH.,400,369,361,73,288
BAKIRKOY,KARTALTEPE MAH.,401,349,348,77,271
BAKIRKOY,KARTALTEPE MAH.,400,356,353,96,257
BAKIRKOY,KARTALTEPE MAH.,401,370,365,74,291
BAKIRKOY,KARTALTEPE MAH.,400,375,371,69,302
BAKIRKOY,KARTALTEPE MAH.,400,373,367,82,285
BAKIRKOY,KARTALTEPE MAH.,399,373,368,105,263
BAKIRKOY,KARTALTEPE MAH.,400,360,358,79,279
BAKIRKOY,KARTALTEPE MAH.,384,335,330,75,255
BAKIRKOY,KARTALTEPE MAH.,384,306,299,61,238
BAKIRKOY,KARTALTEPE MAH.,384,324,321,65,256
BAKIRKOY,KARTALTEPE MAH.,387,362,360,70,290
BAKIRKOY,KARTALTEPE MAH.,384,347,344,85,259
BAKIRKOY,KARTALTEPE MAH.,383,343,335,79,256
BAKIRKOY,KARTALTEPE MAH.,383,355,351,79,272
BAKIRKOY,KARTALTEPE MAH.,384,343,339,65,274
BAKIRKOY,KARTALTEPE MAH.,384,358,354,73,281
BAKIRKOY,KARTALTEPE MAH.,384,350,347,49,298
BAKIRKOY,KARTALTEPE MAH.,383,348,345,66,279
BAKIRKOY,KARTALTEPE MAH.,384,345,344,84,260
BAKIRKOY,KARTALTEPE MAH.,415,353,345,84,261
BAKIRKOY,KARTALTEPE MAH.,413,350,345,87,258
BAKIRKOY,KARTALTEPE MAH.,410,358,353,99,254
BAKIRKOY,KARTALTEPE MAH.,415,376,375,93,282
BAKIRKOY,KARTALTEPE MAH.,413,389,384,94,290
BAKIRKOY,KARTALTEPE MAH.,413,373,366,84,282
BAKIRKOY,KARTALTEPE MAH.,411,388,384,68,316
BAKIRKOY,KARTALTEPE MAH.,412,377,372,87,285
BAKIRKOY,KARTALTEPE MAH.,413,377,372,110,262
BAKIRKOY,KARTALTEPE MAH.,413,383,374,98,276
BAKIRKOY,KARTALTEPE MAH.,412,380,377,89,288
BAKIRKOY,OSMANIYE MAH.,415,343,334,113,221
BAKIRKOY,OSMANIYE MAH.,415,343,337,135,202
BAKIRKOY,OSMANIYE MAH.,414,376,373,145,228
BAKIRKOY,OSMANIYE MAH.,415,366,360,120,240
BAKIRKOY,OSMANIYE MAH.,415,367,361,135,226
BAKIRKOY,OSMANIYE MAH.,415,369,362,121,241
BAKIRKOY,OSMANIYE MAH.,413,353,349,128,221
BAKIRKOY,OSMANIYE MAH.,414,368,367,115,252
BAKIRKOY,OSMANIYE MAH.,414,363,353,120,233
BAKIRKOY,OSMANIYE MAH.,414,361,356,126,230
BAKIRKOY,OSMANIYE MAH.,414,360,359,111,248
BAKIRKOY,OSMANIYE MAH.,413,370,366,117,249
BAKIRKOY,OSMANIYE MAH.,403,319,310,95,215
BAKIRKOY,OSMANIYE MAH.,405,356,349,120,229
BAKIRKOY,OSMANIYE MAH.,402,358,353,101,252
BAKIRKOY,OSMANIYE MAH.,403,353,351,130,221
BAKIRKOY,OSMANIYE MAH.,403,364,359,135,224
BAKIRKOY,OSMANIYE MAH.,402,349,345,130,215
BAKIRKOY,OSMANIYE MAH.,402,338,332,124,208
BAKIRKOY,OSMANIYE MAH.,402,367,362,146,216
BAKIRKOY,OSMANIYE MAH.,402,361,355,121,234
BAKIRKOY,OSMANIYE MAH.,411,336,329,123,206
BAKIRKOY,OSMANIYE MAH.,411,367,364,99,265
BAKIRKOY,OSMANIYE MAH.,410,377,374,118,256
BAKIRKOY,OSMANIYE MAH.,410,375,368,138,230
BAKIRKOY,OSMANIYE MAH.,410,371,368,144,224
BAKIRKOY,OSMANIYE MAH.,411,367,364,142,222
BAKIRKOY,OSMANIYE MAH.,411,372,369,126,243
BAKIRKOY,OSMANIYE MAH.,410,362,360,122,238
BAKIRKOY,OSMANIYE MAH.,410,371,366,124,242
BAKIRKOY,OSMANIYE MAH.,411,382,378,142,236
BAKIRKOY,OSMANIYE MAH.,398,337,335,95,240
BAKIRKOY,OSMANIYE MAH.,398,320,318,104,214
BAKIRKOY,OSMANIYE MAH.,399,353,348,131,217
BAKIRKOY,OSMANIYE MAH.,398,365,361,112,249
BAKIRKOY,OSMANIYE MAH.,398,360,355,111,244
BAKIRKOY,OSMANIYE MAH.,398,366,361,127,234
BAKIRKOY,OSMANIYE MAH.,398,361,358,129,229
BAKIRKOY,OSMANIYE MAH.,399,349,345,127,218
BAKIRKOY,OSMANIYE MAH.,397,365,357,108,249
BAKIRKOY,OSMANIYE MAH.,398,344,336,107,229
BAKIRKOY,OSMANIYE MAH.,399,357,350,104,246
BAKIRKOY,OSMANIYE MAH.,402,369,363,126,237
BAKIRKOY,OSMANIYE MAH.,400,349,344,111,233
BAKIRKOY,OSMANIYE MAH.,397,359,355,120,235
BAKIRKOY,OSMANIYE MAH.,397,358,351,112,239
BAKIRKOY,SAKIZAGACI MAH.,415,298,292,43,249
BAKIRKOY,SAKIZAGACI MAH.,410,305,297,42,255
BAKIRKOY,SAKIZAGACI MAH.,415,309,303,54,249
BAKIRKOY,SAKIZAGACI MAH.,415,343,337,34,303
BAKIRKOY,SAKIZAGACI MAH.,411,366,359,56,303
BAKIRKOY,SAKIZAGACI MAH.,412,355,349,49,300
BAKIRKOY,SAKIZAGACI MAH.,412,359,354,67,287
BAKIRKOY,SAKIZAGACI MAH.,412,371,367,84,283
BAKIRKOY,SAKIZAGACI MAH.,412,345,343,63,280
BAKIRKOY,SAKIZAGACI MAH.,411,353,351,57,294
BAKIRKOY,SAKIZAGACI MAH.,410,364,361,71,290
BAKIRKOY,SAKIZAGACI MAH.,411,348,345,64,281
BAKIRKOY,SAKIZAGACI MAH.,412,355,353,69,284
BAKIRKOY,SAKIZAGACI MAH.,410,360,358,54,304
BAKIRKOY,SAKIZAGACI MAH.,412,356,350,52,298
BAKIRKOY,SAKIZAGACI MAH.,410,351,347,42,305
BAKIRKOY,SENLIKKOY MAH.,410,342,335,120,215
BAKIRKOY,SENLIKKOY MAH.,411,362,359,96,263
BAKIRKOY,SENLIKKOY MAH.,410,364,359,121,238
BAKIRKOY,SENLIKKOY MAH.,410,356,354,124,230
BAKIRKOY,SENLIKKOY MAH.,408,351,348,114,234
BAKIRKOY,SENLIKKOY MAH.,409,366,364,136,228
BAKIRKOY,SENLIKKOY MAH.,409,360,355,131,224
BAKIRKOY,SENLIKKOY MAH.,415,371,366,132,234
BAKIRKOY,SENLIKKOY MAH.,410,356,354,131,223
BAKIRKOY,SENLIKKOY MAH.,410,366,361,139,222
BAKIRKOY,SENLIKKOY MAH.,409,368,365,126,239
BAKIRKOY,SENLIKKOY MAH.,409,370,369,124,245
BAKIRKOY,SENLIKKOY MAH.,408,359,354,136,218
BAKIRKOY,SENLIKKOY MAH.,409,352,352,106,246
BAKIRKOY,SENLIKKOY MAH.,409,384,380,123,257
BAKIRKOY,SENLIKKOY MAH.,401,326,318,114,204
BAKIRKOY,SENLIKKOY MAH.,402,339,331,98,233
BAKIRKOY,SENLIKKOY MAH.,400,362,358,158,200
BAKIRKOY,SENLIKKOY MAH.,400,364,361,165,196
BAKIRKOY,SENLIKKOY MAH.,401,364,359,145,214
BAKIRKOY,SENLIKKOY MAH.,399,356,353,123,230
BAKIRKOY,SENLIKKOY MAH.,402,368,365,151,214
BAKIRKOY,SENLIKKOY MAH.,400,360,359,115,244
BAKIRKOY,SENLIKKOY MAH.,399,364,364,145,219
BAKIRKOY,SENLIKKOY MAH.,399,364,360,144,216
BAKIRKOY,SENLIKKOY MAH.,400,366,362,122,240
BAKIRKOY,SENLIKKOY MAH.,400,360,353,132,221
BAKIRKOY,SENLIKKOY MAH.,399,373,366,120,246
BAKIRKOY,SENLIKKOY MAH.,399,355,352,123,229
BAKIRKOY,SENLIKKOY MAH.,402,369,366,125,241
BAKIRKOY,SENLIKKOY MAH.,399,358,357,135,222
BAKIRKOY,SENLIKKOY MAH.,400,371,366,142,224
BAKIRKOY,SENLIKKOY MAH.,381,329,324,126,198
BAKIRKOY,SENLIKKOY MAH.,382,320,317,110,207
BAKIRKOY,SENLIKKOY MAH.,380,347,340,117,223
BAKIRKOY,SENLIKKOY MAH.,381,344,343,119,224
BAKIRKOY,SENLIKKOY MAH.,380,352,348,109,239
BAKIRKOY,SENLIKKOY MAH.,380,347,342,124,218
BAKIRKOY,SENLIKKOY MAH.,380,338,333,111,222
BAKIRKOY,SENLIKKOY MAH.,381,349,345,125,220
BAKIRKOY,SENLIKKOY MAH.,381,348,344,91,253
BAKIRKOY,SENLIKKOY MAH.,380,354,353,110,243
BAKIRKOY,SENLIKKOY MAH.,380,346,344,123,221
BAKIRKOY,SENLIKKOY MAH.,395,314,312,64,248
BAKIRKOY,SENLIKKOY MAH.,394,356,354,118,236
BAKIRKOY,SENLIKKOY MAH.,394,365,358,102,256
BAKIRKOY,SENLIKKOY MAH.,395,364,360,126,234
BAKIRKOY,SENLIKKOY MAH.,395,369,367,119,248
BAKIRKOY,SENLIKKOY MAH.,395,332,327,138,189
BAKIRKOY,SENLIKKOY MAH.,395,334,333,127,206
BAKIRKOY,SENLIKKOY MAH.,392,345,343,124,219
BAKIRKOY,SENLIKKOY MAH.,397,337,334,131,203
BAKIRKOY,YENIMAHALLE MAH.,399,302,298,47,251
BAKIRKOY,YENIMAHALLE MAH.,400,302,299,54,245
BAKIRKOY,YENIMAHALLE MAH.,400,313,307,57,250
BAKIRKOY,YENIMAHALLE MAH.,400,349,346,47,299
BAKIRKOY,YENIMAHALLE MAH.,400,352,350,42,308
BAKIRKOY,YENIMAHALLE MAH.,399,346,335,56,279
BAKIRKOY,YENIMAHALLE MAH.,400,346,341,58,283
BAKIRKOY,YENIMAHALLE MAH.,399,361,357,92,265
BAKIRKOY,YENIMAHALLE MAH.,400,348,343,63,280
BAKIRKOY,YENIMAHALLE MAH.,400,350,348,78,270
BAKIRKOY,YENIMAHALLE MAH.,399,343,337,69,268
BAKIRKOY,YENIMAHALLE MAH.,399,349,343,68,275
BAKIRKOY,YENIMAHALLE MAH.,399,348,342,74,268
BAKIRKOY,YENIMAHALLE MAH.,399,351,348,73,275
BAKIRKOY,YESILKOY MAH.,408,340,335,50,285
BAKIRKOY,YESILKOY MAH.,408,308,301,47,254
BAKIRKOY,YESILKOY MAH.,408,284,278,45,233
BAKIRKOY,YESILKOY MAH.,408,177,174,35,139
BAKIRKOY,YESILKOY MAH.,408,329,323,47,276
BAKIRKOY,YESILKOY MAH.,409,368,365,65,300
BAKIRKOY,YESILKOY MAH.,407,376,371,42,329
BAKIRKOY,YESILKOY MAH.,408,363,360,35,325
BAKIRKOY,YESILKOY MAH.,407,353,350,58,292
BAKIRKOY,YESILKOY MAH.,408,367,361,43,318
BAKIRKOY,YESILKOY MAH.,408,368,364,33,331
BAKIRKOY,YESILKOY MAH.,408,351,344,34,310
BAKIRKOY,YESILKOY MAH.,408,362,357,46,311
BAKIRKOY,YESILKOY MAH.,408,377,371,44,327
BAKIRKOY,YESILKOY MAH.,408,370,365,65,300
BAKIRKOY,YESILKOY MAH.,408,373,370,53,317
BAKIRKOY,YESILKOY MAH.,408,359,356,58,298
BAKIRKOY,YESILKOY MAH.,408,368,366,34,332
BAKIRKOY,YESILKOY MAH.,408,361,358,68,290
BAKIRKOY,YESILKOY MAH.,394,322,318,48,270
BAKIRKOY,YESILKOY MAH.,393,323,316,42,274
BAKIRKOY,YESILKOY MAH.,394,332,328,36,292
BAKIRKOY,YESILKOY MAH.,393,356,352,68,284
BAKIRKOY,YESILKOY MAH.,395,352,351,56,295
BAKIRKOY,YESILKOY MAH.,393,341,336,49,287
BAKIRKOY,YESILKOY MAH.,394,361,353,58,295
BAKIRKOY,YESILKOY MAH.,393,360,358,60,298
BAKIRKOY,YESILKOY MAH.,393,356,352,57,295
BAKIRKOY,YESILKOY MAH.,393,352,347,54,293
BAKIRKOY,YESILKOY MAH.,393,360,357,54,303
BAKIRKOY,YESILKOY MAH.,393,348,344,51,293
BAKIRKOY,YESILKOY MAH.,387,322,316,62,254
BAKIRKOY,YESILKOY MAH.,387,303,298,33,265
BAKIRKOY,YESILKOY MAH.,390,335,332,42,290
BAKIRKOY,YESILKOY MAH.,390,339,332,39,293
BAKIRKOY,YESILKOY MAH.,389,345,342,55,287
BAKIRKOY,YESILKOY MAH.,387,314,312,67,245
BAKIRKOY,YESILKOY MAH.,390,357,354,39,315
BAKIRKOY,YESILKOY MAH.,388,346,343,57,286
BAKIRKOY,YESILKOY MAH.,388,356,353,46,307
BAKIRKOY,YESILKOY MAH.,387,347,345,54,291
BAKIRKOY,YESILKOY MAH.,388,362,358,51,307
BAKIRKOY,YESILKOY MAH.,387,339,332,50,282
BAKIRKOY,YESILKOY MAH.,388,337,335,41,294
BAKIRKOY,YESILYURT MAH.,397,334,331,46,285
BAKIRKOY,YESILYURT MAH.,396,332,327,56,271
BAKIRKOY,YESILYURT MAH.,395,356,354,51,303
BAKIRKOY,YESILYURT MAH.,396,355,353,59,294
BAKIRKOY,YESILYURT MAH.,396,366,361,58,303
BAKIRKOY,YESILYURT MAH.,396,364,358,63,295
BAKIRKOY,YESILYURT MAH.,395,354,350,71,279
BAKIRKOY,YESILYURT MAH.,396,365,362,47,315
BAKIRKOY,YESILYURT MAH.,396,351,347,75,272
BAKIRKOY,YESILYURT MAH.,395,358,356,72,284
BAKIRKOY,YESILYURT MAH.,396,366,360,79,281
BAKIRKOY,YESILYURT MAH.,395,352,351,58,293
BAKIRKOY,YESILYURT MAH.,396,369,367,69,298
BAKIRKOY,ZEYTINLIK MAH.,399,309,308,35,273
BAKIRKOY,ZEYTINLIK MAH.,401,291,287,46,241
BAKIRKOY,ZEYTINLIK MAH.,400,339,335,53,282
BAKIRKOY,ZEYTINLIK MAH.,401,350,346,77,269
BAKIRKOY,ZEYTINLIK MAH.,399,355,351,56,295
BAKIRKOY,ZEYTINLIK MAH.,399,345,343,45,298
BAKIRKOY,ZEYTINLIK MAH.,399,346,343,57,286
BAKIRKOY,ZEYTINLIK MAH.,399,351,347,76,271
BAKIRKOY,ZEYTINLIK MAH.,399,349,348,60,288
BAKIRKOY,ZEYTINLIK MAH.,399,349,346,62,284
BAKIRKOY,ZEYTINLIK MAH.,399,354,346,66,280
BAKIRKOY,ZUHURATBABA MAH.,394,320,313,49,264
BAKIRKOY,ZUHURATBABA MAH.,394,313,307,55,252
BAKIRKOY,ZUHURATBABA MAH.,393,356,354,49,305
BAKIRKOY,ZUHURATBABA MAH.,393,358,355,65,290
BAKIRKOY,ZUHURATBABA MAH.,392,358,356,78,278
BAKIRKOY,ZUHURATBABA MAH.,393,350,344,50,294
BAKIRKOY,ZUHURATBABA MAH.,393,360,358,53,305
BAKIRKOY,ZUHURATBABA MAH.,394,356,354,63,291
BAKIRKOY,ZUHURATBABA MAH.,393,357,353,58,295
BAKIRKOY,ZUHURATBABA MAH.,415,349,345,63,282
BAKIRKOY,ZUHURATBABA MAH.,415,339,334,65,269
BAKIRKOY,ZUHURATBABA MAH.,415,336,332,70,262
BAKIRKOY,ZUHURATBABA MAH.,415,386,381,84,297
BAKIRKOY,ZUHURATBABA MAH.,415,388,381,76,305
BAKIRKOY,ZUHURATBABA MAH.,415,384,376,76,300
BAKIRKOY,ZUHURATBABA MAH.,415,387,380,74,306
BAKIRKOY,ZUHURATBABA MAH.,415,374,371,76,295
BAKIRKOY,ZUHURATBABA MAH.,415,387,383,83,300
BAKIRKOY,ZUHURATBABA MAH.,415,371,368,57,311
BAKIRKOY,ZUHURATBABA MAH.,413,375,372,82,290
BAKIRKOY,ZUHURATBABA MAH.,413,382,382,59,323
BAKIRKOY,ZUHURATBABA MAH.,413,370,366,70,296
BAKIRKOY,ZUHURATBABA MAH.,415,368,365,82,283
BAKIRKOY,ZUHURATBABA MAH.,412,299,294,62,232
BAKIRKOY,ZUHURATBABA MAH.,411,344,340,63,277
BAKIRKOY,ZUHURATBABA MAH.,409,378,376,78,298
BAKIRKOY,ZUHURATBABA MAH.,409,361,358,60,298
BAKIRKOY,ZUHURATBABA MAH.,410,382,377,83,294
BAKIRKOY,ZUHURATBABA MAH.,409,380,378,92,286
BAKIRKOY,ZUHURATBABA MAH.,410,369,363,79,284
BAKIRKOY,ZUHURATBABA MAH.,410,378,376,75,301
BAKIRKOY,ZUHURATBABA MAH.,410,361,360,73,287
BAKIRKOY,ZUHURATBABA MAH.,409,372,369,92,277
BAKIRKOY,ZUHURATBABA MAH.,375,245,243,54,189
BAKIRKOY,ZUHURATBABA MAH.,375,264,259,53,206
BAKIRKOY,ZUHURATBABA MAH.,375,330,327,71,256
BAKIRKOY,ZUHURATBABA MAH.,375,340,336,62,274
BAKIRKOY,ZUHURATBABA MAH.,375,331,329,61,268
BAKIRKOY,ZUHURATBABA MAH.,375,306,300,62,238
BAKIRKOY,ZUHURATBABA MAH.,375,346,345,75,270
BAKIRKOY,ZUHURATBABA MAH.,374,326,324,53,271
BAKIRKOY,BAKIRKOY KADIN KAPALI CEZA INFAZ KURUMU,409,391,381,102,279
BAHCELIEVLER,BAHCELIEVLER MAH.,390,346,343,88,255
BAHCELIEVLER,BAHCELIEVLER MAH.,390,356,348,65,283
BAHCELIEVLER,BAHCELIEVLER MAH.,391,372,369,72,297
BAHCELIEVLER,BAHCELIEVLER MAH.,390,362,358,85,273
BAHCELIEVLER,BAHCELIEVLER MAH.,391,359,355,83,272
BAHCELIEVLER,BAHCELIEVLER MAH.,391,359,357,82,275
BAHCELIEVLER,BAHCELIEVLER MAH.,391,366,362,108,254
BAHCELIEVLER,BAHCELIEVLER MAH.,390,365,365,93,272
BAHCELIEVLER,BAHCELIEVLER MAH.,391,353,349,85,264
BAHCELIEVLER,BAHCELIEVLER MAH.,391,361,360,80,280
BAHCELIEVLER,BAHCELIEVLER MAH.,401,335,328,91,237
BAHCELIEVLER,BAHCELIEVLER MAH.,401,366,364,98,266
BAHCELIEVLER,BAHCELIEVLER MAH.,402,381,376,92,284
BAHCELIEVLER,BAHCELIEVLER MAH.,401,369,366,111,255
BAHCELIEVLER,BAHCELIEVLER MAH.,400,379,374,99,275
BAHCELIEVLER,BAHCELIEVLER MAH.,400,377,371,104,267
BAHCELIEVLER,BAHCELIEVLER MAH.,401,378,376,117,259
BAHCELIEVLER,BAHCELIEVLER MAH.,401,364,357,100,257
BAHCELIEVLER,BAHCELIEVLER MAH.,402,370,366,90,276
BAHCELIEVLER,BAHCELIEVLER MAH.,400,364,359,116,243
BAHCELIEVLER,BAHCELIEVLER MAH.,401,360,353,105,248
BAHCELIEVLER,BAHCELIEVLER MAH.,365,334,328,72,256
BAHCELIEVLER,BAHCELIEVLER MAH.,365,346,344,71,273
BAHCELIEVLER,BAHCELIEVLER MAH.,364,342,341,69,272
BAHCELIEVLER,BAHCELIEVLER MAH.,365,348,344,83,261
BAHCELIEVLER,BAHCELIEVLER MAH.,365,346,344,94,250
BAHCELIEVLER,BAHCELIEVLER MAH.,365,334,330,79,251
BAHCELIEVLER,BAHCELIEVLER MAH.,366,337,335,95,240
BAHCELIEVLER,BAHCELIEVLER MAH.,405,336,333,99,234
BAHCELIEVLER,BAHCELIEVLER MAH.,405,332,328,103,225
BAHCELIEVLER,BAHCELIEVLER MAH.,406,356,353,118,235
BAHCELIEVLER,BAHCELIEVLER MAH.,406,362,357,135,222
BAHCELIEVLER,BAHCELIEVLER MAH.,410,368,364,136,228
BAHCELIEVLER,BAHCELIEVLER MAH.,406,382,380,161,219
BAHCELIEVLER,BAHCELIEVLER MAH.,405,372,368,165,203
BAHCELIEVLER,BAHCELIEVLER MAH.,406,366,362,142,220
BAHCELIEVLER,BAHCELIEVLER MAH.,405,366,362,117,245
BAHCELIEVLER,BAHCELIEVLER MAH.,406,365,359,132,227
BAHCELIEVLER,BAHCELIEVLER MAH.,406,364,361,121,240
BAHCELIEVLER,BAHCELIEVLER MAH.,406,370,366,153,213
BAHCELIEVLER,BAHCELIEVLER MAH.,390,328,320,75,245
BAHCELIEVLER,BAHCELIEVLER MAH.,385,320,317,102,215
BAHCELIEVLER,BAHCELIEVLER MAH.,385,355,349,91,258
BAHCELIEVLER,BAHCELIEVLER MAH.,386,355,353,96,257
BAHCELIEVLER,BAHCELIEVLER MAH.,386,357,354,84,270
BAHCELIEVLER,BAHCELIEVLER MAH.,385,351,351,96,255
BAHCELIEVLER,BAHCELIEVLER MAH.,387,365,362,100,262
BAHCELIEVLER,BAHCELIEVLER MAH.,386,349,347,87,260
BAHCELIEVLER,BAHCELIEVLER MAH.,386,347,341,81,260
BAHCELIEVLER,BAHCELIEVLER MAH.,386,361,355,97,258
BAHCELIEVLER,BAHCELIEVLER MAH.,387,366,364,110,254
BAHCELIEVLER,BAHCELIEVLER MAH.,386,359,355,108,247
BAHCELIEVLER,BAHCELIEVLER MAH.,385,369,367,103,264
BAHCELIEVLER,BAHCELIEVLER MAH.,386,356,356,93,263
BAHCELIEVLER,BAHCELIEVLER MAH.,392,332,327,103,224
BAHCELIEVLER,BAHCELIEVLER MAH.,392,341,333,111,222
BAHCELIEVLER,BAHCELIEVLER MAH.,392,354,351,115,236
BAHCELIEVLER,BAHCELIEVLER MAH.,392,352,349,127,222
BAHCELIEVLER,BAHCELIEVLER MAH.,391,362,359,121,238
BAHCELIEVLER,BAHCELIEVLER MAH.,391,361,360,118,242
BAHCELIEVLER,BAHCELIEVLER MAH.,392,354,350,109,241
BAHCELIEVLER,BAHCELIEVLER MAH.,392,358,354,105,249
BAHCELIEVLER,BAHCELIEVLER MAH.,392,355,347,128,219
BAHCELIEVLER,BAHCELIEVLER MAH.,393,358,355,101,254
BAHCELIEVLER,BAHCELIEVLER MAH.,394,358,355,154,201
BAHCELIEVLER,BAHCELIEVLER MAH.,401,333,330,86,244
BAHCELIEVLER,BAHCELIEVLER MAH.,402,358,354,92,262
BAHCELIEVLER,BAHCELIEVLER MAH.,402,371,369,123,246
BAHCELIEVLER,BAHCELIEVLER MAH.,400,376,372,102,270
BAHCELIEVLER,BAHCELIEVLER MAH.,402,365,362,126,236
BAHCELIEVLER,BAHCELIEVLER MAH.,401,366,359,121,238
BAHCELIEVLER,BAHCELIEVLER MAH.,401,368,365,119,246
BAHCELIEVLER,BAHCELIEVLER MAH.,400,388,387,105,282
BAHCELIEVLER,BAHCELIEVLER MAH.,403,372,364,134,230
BAHCELIEVLER,BAHCELIEVLER MAH.,401,367,360,138,222
BAHCELIEVLER,BAHCELIEVLER MAH.,410,345,340,118,222
BAHCELIEVLER,BAHCELIEVLER MAH.,411,326,317,110,207
BAHCELIEVLER,BAHCELIEVLER MAH.,415,351,344,113,231
BAHCELIEVLER,BAHCELIEVLER MAH.,415,349,348,126,222
BAHCELIEVLER,BAHCELIEVLER MAH.,411,348,341,127,214
BAHCELIEVLER,BAHCELIEVLER MAH.,411,374,372,133,239
BAHCELIEVLER,BAHCELIEVLER MAH.,411,370,369,143,226
BAHCELIEVLER,BAHCELIEVLER MAH.,415,378,372,151,221
BAHCELIEVLER,BAHCELIEVLER MAH.,410,365,363,132,231
BAHCELIEVLER,BAHCELIEVLER MAH.,411,366,362,115,247
BAHCELIEVLER,BAHCELIEVLER MAH.,410,377,377,152,225
BAHCELIEVLER,BAHCELIEVLER MAH.,411,384,377,131,246
BAHCELIEVLER,BAHCELIEVLER MAH.,411,379,377,127,250
BAHCELIEVLER,BAHCELIEVLER MAH.,410,376,373,116,257
BAHCELIEVLER,BAHCELIEVLER MAH.,411,388,384,141,243
BAHCELIEVLER,BAHCELIEVLER MAH.,410,369,364,128,236
BAHCELIEVLER,BAHCELIEVLER MAH.,410,372,365,146,219
BAHCELIEVLER,BAHCELIEVLER MAH.,410,364,362,120,242
BAHCELIEVLER,BAHCELIEVLER MAH.,410,386,381,160,221
BAHCELIEVLER,BAHCELIEVLER MAH.,411,382,376,136,240
BAHCELIEVLER,BAHCELIEVLER MAH.,415,383,380,134,246
BAHCELIEVLER,BAHCELIEVLER MAH.,411,378,374,131,243
BAHCELIEVLER,BAHCELIEVLER MAH.,410,364,359,113,246
BAHCELIEVLER,BAHCELIEVLER MAH.,409,358,353,116,237
BAHCELIEVLER,BAHCELIEVLER MAH.,410,385,382,136,246
BAHCELIEVLER,BAHCELIEVLER MAH.,410,380,374,121,253
BAHCELIEVLER,BAHCELIEVLER MAH.,411,372,371,138,233
BAHCELIEVLER,BAHCELIEVLER MAH.,410,376,371,123,248
BAHCELIEVLER,BAHCELIEVLER MAH.,410,371,359,131,228
BAHCELIEVLER,BAHCELIEVLER MAH.,411,363,359,137,222
BAHCELIEVLER,BAHCELIEVLER MAH.,390,313,309,91,218
BAHCELIEVLER,BAHCELIEVLER MAH.,389,322,320,105,215
BAHCELIEVLER,BAHCELIEVLER MAH.,390,354,350,124,226
BAHCELIEVLER,BAHCELIEVLER MAH.,390,322,319,101,218
BAHCELIEVLER,BAHCELIEVLER MAH.,390,355,352,130,222
BAHCELIEVLER,BAHCELIEVLER MAH.,390,359,356,117,239
BAHCELIEVLER,BAHCELIEVLER MAH.,389,354,351,115,236
BAHCELIEVLER,BAHCELIEVLER MAH.,389,362,360,138,222
BAHCELIEVLER,BAHCELIEVLER MAH.,391,360,355,137,218
BAHCELIEVLER,BAHCELIEVLER MAH.,391,358,355,129,226
BAHCELIEVLER,BAHCELIEVLER MAH.,390,352,344,110,234
BAHCELIEVLER,BAHCELIEVLER MAH.,390,354,349,135,214
BAHCELIEVLER,SIYAVUSPASA MAH.,407,324,315,121,194
BAHCELIEVLER,SIYAVUSPASA MAH.,406,348,345,134,211
BAHCELIEVLER,SIYAVUSPASA MAH.,415,324,318,133,185
BAHCELIEVLER,SIYAVUSPASA MAH.,407,369,367,167,200
BAHCELIEVLER,SIYAVUSPASA MAH.,407,366,357,135,222
BAHCELIEVLER,SIYAVUSPASA MAH.,408,357,354,135,219
BAHCELIEVLER,SIYAVUSPASA MAH.,407,356,348,147,201
BAHCELIEVLER,SIYAVUSPASA MAH.,407,334,334,132,202
BAHCELIEVLER,SIYAVUSPASA MAH.,406,359,354,148,206
BAHCELIEVLER,SIYAVUSPASA MAH.,407,355,349,156,193
BAHCELIEVLER,SIYAVUSPASA MAH.,406,357,353,148,205
BAHCELIEVLER,SIYAVUSPASA MAH.,407,362,357,150,207
BAHCELIEVLER,SIYAVUSPASA MAH.,407,347,346,142,204
BAHCELIEVLER,SIYAVUSPASA MAH.,406,356,348,156,192
BAHCELIEVLER,SIYAVUSPASA MAH.,406,361,352,142,210
BAHCELIEVLER,SIYAVUSPASA MAH.,407,372,365,154,211
BAHCELIEVLER,SIYAVUSPASA MAH.,406,358,351,148,203
BAHCELIEVLER,SIYAVUSPASA MAH.,407,365,357,141,216
BAHCELIEVLER,SIYAVUSPASA MAH.,407,358,348,121,227
BAHCELIEVLER,SIYAVUSPASA MAH.,410,373,368,138,230
BAHCELIEVLER,SIYAVUSPASA MAH.,406,347,342,138,204
BAHCELIEVLER,SIYAVUSPASA MAH.,409,352,348,159,189
BAHCELIEVLER,SIYAVUSPASA MAH.,378,314,307,138,169
BAHCELIEVLER,SIYAVUSPASA MAH.,379,337,336,159,177
BAHCELIEVLER,SIYAVUSPASA MAH.,378,332,327,183,144
BAHCELIEVLER,SIYAVUSPASA MAH.,378,344,338,172,166
BAHCELIEVLER,SIYAVUSPASA MAH.,379,336,330,168,162
BAHCELIEVLER,SIYAVUSPASA MAH.,379,334,334,157,177
BAHCELIEVLER,SIYAVUSPASA MAH.,378,338,334,146,188
BAHCELIEVLER,SIYAVUSPASA MAH.,380,347,343,182,161
BAHCELIEVLER,SIYAVUSPASA MAH.,379,336,334,189,145
BAHCELIEVLER,SIYAVUSPASA MAH.,379,335,332,173,159
BAHCELIEVLER,SIYAVUSPASA MAH.,378,347,342,164,178
BAHCELIEVLER,SIYAVUSPASA MAH.,407,321,313,107,206
BAHCELIEVLER,SIYAVUSPASA MAH.,408,314,309,98,211
BAHCELIEVLER,SIYAVUSPASA MAH.,408,355,351,97,254
BAHCELIEVLER,SIYAVUSPASA MAH.,409,351,345,125,220
BAHCELIEVLER,SIYAVUSPASA MAH.,408,363,352,122,230
BAHCELIEVLER,SIYAVUSPASA MAH.,408,354,352,134,218
BAHCELIEVLER,SIYAVUSPASA MAH.,407,361,359,139,220
BAHCELIEVLER,SIYAVUSPASA MAH.,415,369,361,132,229
BAHCELIEVLER,SIYAVUSPASA MAH.,407,346,341,100,241
BAHCELIEVLER,SIYAVUSPASA MAH.,407,363,360,127,233
BAHCELIEVLER,SIYAVUSPASA MAH.,407,369,367,113,254
BAHCELIEVLER,SIYAVUSPASA MAH.,409,369,368,89,279
BAHCELIEVLER,SIYAVUSPASA MAH.,407,360,353,135,218
BAHCELIEVLER,SIYAVUSPASA MAH.,408,353,351,128,223
BAHCELIEVLER,SIYAVUSPASA MAH.,408,364,359,98,261
BAHCELIEVLER,SIYAVUSPASA MAH.,408,345,340,115,225
BAHCELIEVLER,SIYAVUSPASA MAH.,411,335,325,125,200
BAHCELIEVLER,SIYAVUSPASA MAH.,411,327,322,149,173
BAHCELIEVLER,SIYAVUSPASA MAH.,415,367,366,165,201
BAHCELIEVLER,SIYAVUSPASA MAH.,415,376,375,199,176
BAHCELIEVLER,SIYAVUSPASA MAH.,410,370,361,144,217
BAHCELIEVLER,SIYAVUSPASA MAH.,411,373,370,161,209
BAHCELIEVLER,SIYAVUSPASA MAH.,410,350,348,159,189
BAHCELIEVLER,SIYAVUSPASA MAH.,411,359,356,174,182
BAHCELIEVLER,SIYAVUSPASA MAH.,410,348,344,145,199
BAHCELIEVLER,SIYAVUSPASA MAH.,411,356,348,138,210
BAHCELIEVLER,SIYAVUSPASA MAH.,410,371,368,146,222
BAHCELIEVLER,SIYAVUSPASA MAH.,410,357,352,155,197
BAHCELIEVLER,SIYAVUSPASA MAH.,415,346,343,163,180
BAHCELIEVLER,SIYAVUSPASA MAH.,410,341,340,165,175
BAHCELIEVLER,SIYAVUSPASA MAH.,411,359,350,137,213
BAHCELIEVLER,SIYAVUSPASA MAH.,410,352,346,144,202
BAHCELIEVLER,SIYAVUSPASA MAH.,411,354,353,154,199
BAHCELIEVLER,SIYAVUSPASA MAH.,411,359,358,182,176
BAHCELIEVLER,SIYAVUSPASA MAH.,410,327,324,145,179
BAHCELIEVLER,SIYAVUSPASA MAH.,410,319,315,127,188
BAHCELIEVLER,SIYAVUSPASA MAH.,409,347,341,152,189
BAHCELIEVLER,SIYAVUSPASA MAH.,410,352,345,136,209
BAHCELIEVLER,SIYAVUSPASA MAH.,410,355,350,142,208
BAHCELIEVLER,SIYAVUSPASA MAH.,409,361,357,146,211
BAHCELIEVLER,SIYAVUSPASA MAH.,409,373,366,162,204
BAHCELIEVLER,SIYAVUSPASA MAH.,410,361,357,171,186
BAHCELIEVLER,SIYAVUSPASA MAH.,410,347,345,149,196
BAHCELIEVLER,SIYAVUSPASA MAH.,411,336,333,141,192
BAHCELIEVLER,SIYAVUSPASA MAH.,409,364,360,131,229
BAHCELIEVLER,SIYAVUSPASA MAH.,409,370,368,162,206
BAHCELIEVLER,SIYAVUSPASA MAH.,410,371,370,151,219
BAHCELIEVLER,SIYAVUSPASA MAH.,410,358,357,124,233
BAHCELIEVLER,SIYAVUSPASA MAH.,409,364,358,148,210
BAHCELIEVLER,SIYAVUSPASA MAH.,409,357,353,134,219
BAHCELIEVLER,SIYAVUSPASA MAH.,410,363,359,135,224
BAHCELIEVLER,SIYAVUSPASA MAH.,410,367,367,143,224
BAHCELIEVLER,SIYAVUSPASA MAH.,409,357,354,134,220
BAHCELIEVLER,SIYAVUSPASA MAH.,408,348,345,133,212
BAHCELIEVLER,SIYAVUSPASA MAH.,408,322,318,135,183
BAHCELIEVLER,SIYAVUSPASA MAH.,407,339,333,125,208
BAHCELIEVLER,SIYAVUSPASA MAH.,405,335,331,134,197
BAHCELIEVLER,SIYAVUSPASA MAH.,405,339,338,141,197
BAHCELIEVLER,SIYAVUSPASA MAH.,405,352,345,153,192
BAHCELIEVLER,SIYAVUSPASA MAH.,407,357,352,148,204
BAHCELIEVLER,SIYAVUSPASA MAH.,406,365,357,148,209
BAHCELIEVLER,SIYAVUSPASA MAH.,405,355,348,137,211
BAHCELIEVLER,SIYAVUSPASA MAH.,405,347,342,135,207
BAHCELIEVLER,SIYAVUSPASA MAH.,405,369,365,168,197
BAHCELIEVLER,SIYAVUSPASA MAH.,405,345,341,123,218
BAHCELIEVLER,SIYAVUSPASA MAH.,408,360,357,126,231
BAHCELIEVLER,SIYAVUSPASA MAH.,405,359,357,165,192
BAHCELIEVLER,SIYAVUSPASA MAH.,405,346,344,129,215
BAHCELIEVLER,SIYAVUSPASA MAH.,405,352,351,136,215
BAHCELIEVLER,SIYAVUSPASA MAH.,405,343,340,123,217
BAHCELIEVLER,SIYAVUSPASA MAH.,405,343,337,146,191
BAHCELIEVLER,SIYAVUSPASA MAH.,405,363,357,152,205
BAHCELIEVLER,SIYAVUSPASA MAH.,405,353,349,128,221
BAHCELIEVLER,SIYAVUSPASA MAH.,407,358,355,162,193
BAHCELIEVLER,SIYAVUSPASA MAH.,405,348,344,139,205
BAHCELIEVLER,SIYAVUSPASA MAH.,404,341,337,146,191
BAHCELIEVLER,SIYAVUSPASA MAH.,406,355,352,157,195
BAHCELIEVLER,SIYAVUSPASA MAH.,405,352,349,137,212
BAHCELIEVLER,SIYAVUSPASA MAH.,404,333,329,138,191
BAHCELIEVLER,SIYAVUSPASA MAH.,404,362,357,150,207
BAHCELIEVLER,SIYAVUSPASA MAH.,405,363,359,149,210
BAHCELIEVLER,SIYAVUSPASA MAH.,406,351,348,148,200
BAHCELIEVLER,SIYAVUSPASA MAH.,406,362,359,153,206
BAHCELIEVLER,SIYAVUSPASA MAH.,406,358,357,123,234
BAHCELIEVLER,SIYAVUSPASA MAH.,404,343,342,140,202
BAHCELIEVLER,SIYAVUSPASA MAH.,400,324,319,141,178
BAHCELIEVLER,SIYAVUSPASA MAH.,400,360,359,164,195
BAHCELIEVLER,SIYAVUSPASA MAH.,400,350,343,195,148
BAHCELIEVLER,SIYAVUSPASA MAH.,401,354,351,194,157
BAHCELIEVLER,SIYAVUSPASA MAH.,400,349,343,178,165
BAHCELIEVLER,SIYAVUSPASA MAH.,399,336,332,157,175
BAHCELIEVLER,SIYAVUSPASA MAH.,400,354,347,179,168
BAHCELIEVLER,SIYAVUSPASA MAH.,402,355,350,175,175
BAHCELIEVLER,SIYAVUSPASA MAH.,400,361,356,194,162
BAHCELIEVLER,SOGANLI MAH.,415,339,332,171,161
BAHCELIEVLER,SOGANLI MAH.,415,312,303,151,152
BAHCELIEVLER,SOGANLI MAH.,415,332,320,136,184
BAHCELIEVLER,SOGANLI MAH.,412,366,362,160,202
BAHCELIEVLER,SOGANLI MAH.,415,371,364,214,150
BAHCELIEVLER,SOGANLI MAH.,412,373,369,193,176
BAHCELIEVLER,SOGANLI MAH.,415,357,354,194,160
BAHCELIEVLER,SOGANLI MAH.,412,352,349,174,175
BAHCELIEVLER,SOGANLI MAH.,412,357,348,179,169
BAHCELIEVLER,SOGANLI MAH.,411,354,348,163,185
BAHCELIEVLER,SOGANLI MAH.,415,370,368,204,164
BAHCELIEVLER,SOGANLI MAH.,412,354,348,183,165
BAHCELIEVLER,SOGANLI MAH.,415,374,369,190,179
BAHCELIEVLER,SOGANLI MAH.,410,376,374,186,188
BAHCELIEVLER,SOGANLI MAH.,415,351,344,181,163
BAHCELIEVLER,SOGANLI MAH.,410,355,352,154,198
BAHCELIEVLER,SOGANLI MAH.,415,359,353,180,173
BAHCELIEVLER,SOGANLI MAH.,411,359,352,185,167
BAHCELIEVLER,SOGANLI MAH.,411,345,343,171,172
BAHCELIEVLER,SOGANLI MAH.,412,362,358,166,192
BAHCELIEVLER,SOGANLI MAH.,413,370,364,163,201
BAHCELIEVLER,SOGANLI MAH.,411,366,363,168,195
BAHCELIEVLER,SOGANLI MAH.,412,383,380,150,230
BAHCELIEVLER,SOGANLI MAH.,413,372,361,167,194
BAHCELIEVLER,SOGANLI MAH.,411,362,352,152,200
BAHCELIEVLER,SOGANLI MAH.,411,339,334,148,186
BAHCELIEVLER,SOGANLI MAH.,411,364,360,156,204
BAHCELIEVLER,SOGANLI MAH.,400,322,321,169,152
BAHCELIEVLER,SOGANLI MAH.,402,329,328,160,168
BAHCELIEVLER,SOGANLI MAH.,402,360,359,173,186
BAHCELIEVLER,SOGANLI MAH.,402,343,342,194,148
BAHCELIEVLER,SOGANLI MAH.,401,346,336,155,181
BAHCELIEVLER,SOGANLI MAH.,402,367,361,188,173
BAHCELIEVLER,SOGANLI MAH.,402,362,360,178,182
BAHCELIEVLER,SOGANLI MAH.,402,352,347,157,190
BAHCELIEVLER,SOGANLI MAH.,401,365,363,189,174
BAHCELIEVLER,SOGANLI MAH.,402,345,343,152,191
BAHCELIEVLER,SOGANLI MAH.,404,351,348,198,150
BAHCELIEVLER,SOGANLI MAH.,402,356,352,187,165
BAHCELIEVLER,SOGANLI MAH.,400,349,341,198,143
BAHCELIEVLER,SOGANLI MAH.,401,348,344,206,138
BAHCELIEVLER,SOGANLI MAH.,400,356,351,172,179
BAHCELIEVLER,SOGANLI MAH.,401,344,341,199,142
BAHCELIEVLER,SOGANLI MAH.,401,347,345,166,179
BAHCELIEVLER,SOGANLI MAH.,401,356,350,205,145
BAHCELIEVLER,SOGANLI MAH.,402,351,350,175,175
BAHCELIEVLER,SOGANLI MAH.,402,329,327,204,123
BAHCELIEVLER,SOGANLI MAH.,415,352,351,126,225
BAHCELIEVLER,SOGANLI MAH.,408,349,346,151,195
BAHCELIEVLER,SOGANLI MAH.,411,359,355,171,184
BAHCELIEVLER,SOGANLI MAH.,415,377,374,177,197
BAHCELIEVLER,SOGANLI MAH.,415,370,361,155,206
BAHCELIEVLER,SOGANLI MAH.,409,357,349,164,185
BAHCELIEVLER,SOGANLI MAH.,410,325,322,168,154
BAHCELIEVLER,SOGANLI MAH.,411,367,360,171,189
BAHCELIEVLER,SOGANLI MAH.,409,376,375,202,173
BAHCELIEVLER,SOGANLI MAH.,409,351,345,198,147
BAHCELIEVLER,SOGANLI MAH.,410,371,368,196,172
BAHCELIEVLER,SOGANLI MAH.,409,372,367,198,169
BAHCELIEVLER,SOGANLI MAH.,409,351,348,178,170
BAHCELIEVLER,SOGANLI MAH.,410,367,364,175,189
BAHCELIEVLER,SOGANLI MAH.,410,364,362,160,202
BAHCELIEVLER,SOGANLI MAH.,410,366,360,198,162
BAHCELIEVLER,SOGANLI MAH.,409,355,351,154,197
BAHCELIEVLER,SOGANLI MAH.,408,365,360,184,176
BAHCELIEVLER,SOGANLI MAH.,410,354,349,170,179
BAHCELIEVLER,SOGANLI MAH.,409,360,357,184,173
BAHCELIEVLER,SOGANLI MAH.,408,368,363,200,163
BAHCELIEVLER,SOGANLI MAH.,410,357,352,193,159
BAHCELIEVLER,SOGANLI MAH.,410,378,372,210,162
BAHCELIEVLER,SOGANLI MAH.,409,353,350,203,147
BAHCELIEVLER,SOGANLI MAH.,415,352,346,176,170
BAHCELIEVLER,SOGANLI MAH.,415,350,345,185,160
BAHCELIEVLER,SOGANLI MAH.,415,376,375,181,194
BAHCELIEVLER,SOGANLI MAH.,415,360,355,159,196
BAHCELIEVLER,SOGANLI MAH.,415,370,363,180,183
BAHCELIEVLER,SOGANLI MAH.,414,360,355,196,159
BAHCELIEVLER,SOGANLI MAH.,412,355,347,151,196
BAHCELIEVLER,SOGANLI MAH.,415,372,371,177,194
BAHCELIEVLER,SOGANLI MAH.,415,375,373,191,182
BAHCELIEVLER,SOGANLI MAH.,415,366,363,168,195
BAHCELIEVLER,SOGANLI MAH.,415,369,362,138,224
BAHCELIEVLER,SOGANLI MAH.,414,361,357,187,170
BAHCELIEVLER,SOGANLI MAH.,415,366,363,197,166
BAHCELIEVLER,SOGANLI MAH.,414,370,369,188,181
BAHCELIEVLER,SOGANLI MAH.,414,369,365,193,172
BAHCELIEVLER,SOGANLI MAH.,415,338,337,168,169
BAHCELIEVLER,SOGANLI MAH.,415,343,333,156,177
BAHCELIEVLER,SOGANLI MAH.,412,332,328,127,201
BAHCELIEVLER,SOGANLI MAH.,412,361,356,141,215
BAHCELIEVLER,SOGANLI MAH.,415,363,362,142,220
BAHCELIEVLER,SOGANLI MAH.,415,379,375,145,230
BAHCELIEVLER,SOGANLI MAH.,415,369,360,161,199
BAHCELIEVLER,SOGANLI MAH.,415,365,362,178,184
BAHCELIEVLER,SOGANLI MAH.,412,368,364,180,184
BAHCELIEVLER,SOGANLI MAH.,412,380,375,154,221
BAHCELIEVLER,SOGANLI MAH.,412,362,352,155,197
BAHCELIEVLER,SOGANLI MAH.,410,367,362,158,204
BAHCELIEVLER,SOGANLI MAH.,415,376,372,157,215
BAHCELIEVLER,SOGANLI MAH.,412,380,377,132,245
BAHCELIEVLER,SOGANLI MAH.,411,359,353,146,207
BAHCELIEVLER,SOGANLI MAH.,410,375,370,154,216
BAHCELIEVLER,SOGANLI MAH.,412,372,370,161,209
BAHCELIEVLER,SOGANLI MAH.,412,358,354,162,192
BAHCELIEVLER,SOGANLI MAH.,412,359,355,143,212
BAHCELIEVLER,SOGANLI MAH.,412,376,374,125,249
BAHCELIEVLER,SOGANLI MAH.,411,378,375,174,201
BAHCELIEVLER,SOGANLI MAH.,411,350,348,140,208
BAHCELIEVLER,SOGANLI MAH.,412,370,364,159,205
BAHCELIEVLER,SOGANLI MAH.,411,374,369,156,213
BAHCELIEVLER,SOGANLI MAH.,412,364,359,138,221
BAHCELIEVLER,SOGANLI MAH.,411,363,356,140,216
BAHCELIEVLER,SOGANLI MAH.,412,379,373,170,203
BAHCELIEVLER,SOGANLI MAH.,410,375,370,158,212
BAHCELIEVLER,SOGANLI MAH.,416,345,340,170,170
BAHCELIEVLER,SOGANLI MAH.,415,345,341,186,155
BAHCELIEVLER,SOGANLI MAH.,415,365,362,217,145
BAHCELIEVLER,SOGANLI MAH.,415,374,371,200,171
BAHCELIEVLER,SOGANLI MAH.,416,345,342,212,130
BAHCELIEVLER,SOGANLI MAH.,416,356,350,204,146
BAHCELIEVLER,SOGANLI MAH.,415,353,352,180,172
BAHCELIEVLER,SOGANLI MAH.,415,371,368,193,175
BAHCELIEVLER,SOGANLI MAH.,415,362,356,215,141
BAHCELIEVLER,SOGANLI MAH.,416,369,366,194,172
BAHCELIEVLER,SOGANLI MAH.,413,367,363,183,180
BAHCELIEVLER,SOGANLI MAH.,415,358,355,219,136
BAHCELIEVLER,SOGANLI MAH.,414,356,355,189,166
BAHCELIEVLER,SOGANLI MAH.,414,371,365,211,154
BAHCELIEVLER,SOGANLI MAH.,414,372,366,207,159
BAHCELIEVLER,SOGANLI MAH.,413,356,351,205,146
BAHCELIEVLER,CUMHURIYET MAH.,405,338,336,149,187
BAHCELIEVLER,CUMHURIYET MAH.,406,346,344,186,158
BAHCELIEVLER,CUMHURIYET MAH.,409,375,373,226,147
BAHCELIEVLER,CUMHURIYET MAH.,405,377,376,205,171
BAHCELIEVLER,CUMHURIYET MAH.,406,355,349,202,147
BAHCELIEVLER,CUMHURIYET MAH.,405,342,340,195,145
BAHCELIEVLER,CUMHURIYET MAH.,404,364,360,191,169
BAHCELIEVLER,CUMHURIYET MAH.,406,356,350,145,205
BAHCELIEVLER,CUMHURIYET MAH.,406,352,348,190,158
BAHCELIEVLER,CUMHURIYET MAH.,405,362,357,183,174
BAHCELIEVLER,CUMHURIYET MAH.,405,373,371,186,185
BAHCELIEVLER,CUMHURIYET MAH.,406,365,361,184,177
BAHCELIEVLER,CUMHURIYET MAH.,406,363,358,194,164
BAHCELIEVLER,CUMHURIYET MAH.,406,367,363,189,174
BAHCELIEVLER,CUMHURIYET MAH.,404,341,340,166,174
BAHCELIEVLER,CUMHURIYET MAH.,406,343,338,195,143
BAHCELIEVLER,CUMHURIYET MAH.,415,348,346,171,175
BAHCELIEVLER,CUMHURIYET MAH.,409,329,320,173,147
BAHCELIEVLER,CUMHURIYET MAH.,409,337,329,209,120
BAHCELIEVLER,CUMHURIYET MAH.,415,355,351,199,152
BAHCELIEVLER,CUMHURIYET MAH.,410,368,361,199,162
BAHCELIEVLER,CUMHURIYET MAH.,410,369,366,247,119
BAHCELIEVLER,CUMHURIYET MAH.,410,350,346,176,170
BAHCELIEVLER,CUMHURIYET MAH.,409,359,354,213,141
BAHCELIEVLER,CUMHURIYET MAH.,409,376,375,212,163
BAHCELIEVLER,CUMHURIYET MAH.,410,375,367,208,159
BAHCELIEVLER,CUMHURIYET MAH.,409,363,361,203,158
BAHCELIEVLER,CUMHURIYET MAH.,411,372,369,234,135
BAHCELIEVLER,CUMHURIYET MAH.,410,348,345,164,181
BAHCELIEVLER,CUMHURIYET MAH.,408,364,360,187,173
BAHCELIEVLER,CUMHURIYET MAH.,409,353,349,203,146
BAHCELIEVLER,CUMHURIYET MAH.,410,354,352,191,161
BAHCELIEVLER,CUMHURIYET MAH.,409,372,367,187,180
BAHCELIEVLER,CUMHURIYET MAH.,409,358,356,202,154
BAHCELIEVLER,CUMHURIYET MAH.,410,361,355,205,150
BAHCELIEVLER,CUMHURIYET MAH.,410,364,359,190,169
BAHCELIEVLER,CUMHURIYET MAH.,410,375,370,212,158
BAHCELIEVLER,CUMHURIYET MAH.,408,360,353,206,147
BAHCELIEVLER,CUMHURIYET MAH.,408,372,368,189,179
BAHCELIEVLER,CUMHURIYET MAH.,408,364,359,207,152
BAHCELIEVLER,CUMHURIYET MAH.,410,363,358,186,172
BAHCELIEVLER,CUMHURIYET MAH.,409,351,344,204,140
BAHCELIEVLER,CUMHURIYET MAH.,410,359,353,202,151
BAHCELIEVLER,CUMHURIYET MAH.,408,360,358,175,183
BAHCELIEVLER,CUMHURIYET MAH.,409,367,366,207,159
BAHCELIEVLER,CUMHURIYET MAH.,409,373,371,215,156
BAHCELIEVLER,CUMHURIYET MAH.,410,353,350,185,165
BAHCELIEVLER,CUMHURIYET MAH.,409,368,366,202,164
BAHCELIEVLER,CUMHURIYET MAH.,409,357,354,207,147
BAHCELIEVLER,CUMHURIYET MAH.,409,375,370,199,171
BAHCELIEVLER,CUMHURIYET MAH.,410,374,367,235,132
BAHCELIEVLER,CUMHURIYET MAH.,410,344,338,222,116
BAHCELIEVLER,CUMHURIYET MAH.,409,371,367,197,170
BAHCELIEVLER,CUMHURIYET MAH.,409,362,356,237,119
BAHCELIEVLER,CUMHURIYET MAH.,399,315,310,137,173
BAHCELIEVLER,CUMHURIYET MAH.,398,313,309,164,145
BAHCELIEVLER,CUMHURIYET MAH.,400,357,349,198,151
BAHCELIEVLER,CUMHURIYET MAH.,400,362,359,174,185
BAHCELIEVLER,CUMHURIYET MAH.,400,342,333,156,177
BAHCELIEVLER,CUMHURIYET MAH.,398,355,353,168,185
BAHCELIEVLER,CUMHURIYET MAH.,401,353,349,175,174
BAHCELIEVLER,CUMHURIYET MAH.,399,354,348,208,140
BAHCELIEVLER,CUMHURIYET MAH.,399,352,347,164,183
BAHCELIEVLER,CUMHURIYET MAH.,398,364,356,194,162
BAHCELIEVLER,CUMHURIYET MAH.,398,348,345,181,164
BAHCELIEVLER,CUMHURIYET MAH.,398,362,359,183,176
BAHCELIEVLER,CUMHURIYET MAH.,399,357,354,185,169
BAHCELIEVLER,CUMHURIYET MAH.,398,336,330,162,168
BAHCELIEVLER,CUMHURIYET MAH.,399,349,344,159,185
BAHCELIEVLER,CUMHURIYET MAH.,399,346,344,183,161
BAHCELIEVLER,CUMHURIYET MAH.,399,338,332,200,132
BAHCELIEVLER,CUMHURIYET MAH.,399,356,350,172,178
BAHCELIEVLER,CUMHURIYET MAH.,398,353,351,187,164
BAHCELIEVLER,CUMHURIYET MAH.,398,355,353,166,187
BAHCELIEVLER,HURRIYET MAH.,400,307,304,210,94
BAHCELIEVLER,HURRIYET MAH.,399,357,347,229,118
BAHCELIEVLER,HURRIYET MAH.,400,340,330,201,129
BAHCELIEVLER,HURRIYET MAH.,400,339,337,186,151
BAHCELIEVLER,HURRIYET MAH.,399,353,347,211,136
BAHCELIEVLER,HURRIYET MAH.,401,346,339,211,128
BAHCELIEVLER,HURRIYET MAH.,399,351,348,216,132
BAHCELIEVLER,HURRIYET MAH.,402,348,344,210,134
BAHCELIEVLER,HURRIYET MAH.,400,369,365,231,134
BAHCELIEVLER,HURRIYET MAH.,400,347,339,209,130
BAHCELIEVLER,HURRIYET MAH.,399,347,345,212,133
BAHCELIEVLER,HURRIYET MAH.,403,355,350,223,127
BAHCELIEVLER,HURRIYET MAH.,410,322,314,172,142
BAHCELIEVLER,HURRIYET MAH.,409,313,309,160,149
BAHCELIEVLER,HURRIYET MAH.,409,331,320,164,156
BAHCELIEVLER,HURRIYET MAH.,410,348,344,175,169
BAHCELIEVLER,HURRIYET MAH.,409,345,341,169,172
BAHCELIEVLER,HURRIYET MAH.,410,363,355,177,178
BAHCELIEVLER,HURRIYET MAH.,409,346,337,175,162
BAHCELIEVLER,HURRIYET MAH.,409,362,360,199,161
BAHCELIEVLER,HURRIYET MAH.,415,362,352,190,162
BAHCELIEVLER,HURRIYET MAH.,409,353,347,166,181
BAHCELIEVLER,HURRIYET MAH.,408,329,329,168,161
BAHCELIEVLER,HURRIYET MAH.,409,362,359,179,180
BAHCELIEVLER,HURRIYET MAH.,408,329,326,178,148
BAHCELIEVLER,HURRIYET MAH.,409,336,327,182,145
BAHCELIEVLER,HURRIYET MAH.,408,347,345,168,177
BAHCELIEVLER,HURRIYET MAH.,410,353,348,171,177
BAHCELIEVLER,HURRIYET MAH.,410,351,346,154,192
BAHCELIEVLER,HURRIYET MAH.,409,353,347,177,170
BAHCELIEVLER,HURRIYET MAH.,409,339,333,170,163
BAHCELIEVLER,HURRIYET MAH.,409,338,333,190,143
BAHCELIEVLER,HURRIYET MAH.,408,358,353,192,161
BAHCELIEVLER,HURRIYET MAH.,408,348,343,182,161
BAHCELIEVLER,HURRIYET MAH.,409,361,357,173,184
BAHCELIEVLER,HURRIYET MAH.,409,357,351,171,180
BAHCELIEVLER,HURRIYET MAH.,409,355,348,156,192
BAHCELIEVLER,HURRIYET MAH.,411,358,354,195,159
BAHCELIEVLER,HURRIYET MAH.,409,353,347,173,174
BAHCELIEVLER,HURRIYET MAH.,408,352,342,167,175
BAHCELIEVLER,HURRIYET MAH.,409,367,358,169,189
BAHCELIEVLER,HURRIYET MAH.,409,356,352,170,182
BAHCELIEVLER,HURRIYET MAH.,408,358,355,204,151
BAHCELIEVLER,HURRIYET MAH.,408,344,341,161,180
BAHCELIEVLER,HURRIYET MAH.,409,347,342,181,161
BAHCELIEVLER,HURRIYET MAH.,407,309,301,171,130
BAHCELIEVLER,HURRIYET MAH.,407,331,325,175,150
BAHCELIEVLER,HURRIYET MAH.,407,349,345,201,144
BAHCELIEVLER,HURRIYET MAH.,408,343,341,200,141
BAHCELIEVLER,HURRIYET MAH.,406,338,332,204,128
BAHCELIEVLER,HURRIYET MAH.,407,352,351,214,137
BAHCELIEVLER,HURRIYET MAH.,406,354,348,193,155
BAHCELIEVLER,HURRIYET MAH.,407,347,344,230,114
BAHCELIEVLER,HURRIYET MAH.,407,342,340,193,147
BAHCELIEVLER,HURRIYET MAH.,407,350,349,211,138
BAHCELIEVLER,HURRIYET MAH.,407,365,365,215,150
BAHCELIEVLER,HURRIYET MAH.,405,358,358,210,148
BAHCELIEVLER,HURRIYET MAH.,407,355,350,182,168
BAHCELIEVLER,HURRIYET MAH.,408,360,354,215,139
BAHCELIEVLER,HURRIYET MAH.,407,352,350,225,125
BAHCELIEVLER,HURRIYET MAH.,405,360,354,228,126
BAHCELIEVLER,HURRIYET MAH.,407,351,349,225,124
BAHCELIEVLER,HURRIYET MAH.,405,330,321,185,136
BAHCELIEVLER,HURRIYET MAH.,401,330,326,205,121
BAHCELIEVLER,HURRIYET MAH.,400,357,347,219,128
BAHCELIEVLER,HURRIYET MAH.,400,358,352,202,150
BAHCELIEVLER,HURRIYET MAH.,401,358,354,207,147
BAHCELIEVLER,HURRIYET MAH.,401,335,334,197,137
BAHCELIEVLER,HURRIYET MAH.,401,359,351,201,150
BAHCELIEVLER,HURRIYET MAH.,403,346,342,202,140
BAHCELIEVLER,HURRIYET MAH.,400,341,336,212,124
BAHCELIEVLER,HURRIYET MAH.,408,352,346,206,140
BAHCELIEVLER,HURRIYET MAH.,400,349,344,225,119
BAHCELIEVLER,HURRIYET MAH.,400,335,332,182,150
BAHCELIEVLER,HURRIYET MAH.,401,359,358,220,138
BAHCELIEVLER,HURRIYET MAH.,401,361,359,234,125
BAHCELIEVLER,HURRIYET MAH.,400,358,356,193,163
BAHCELIEVLER,HURRIYET MAH.,404,347,346,202,144
BAHCELIEVLER,HURRIYET MAH.,400,361,357,220,137
BAHCELIEVLER,HURRIYET MAH.,400,343,338,186,152
BAHCELIEVLER,HURRIYET MAH.,401,340,335,218,117
BAHCELIEVLER,HURRIYET MAH.,401,354,350,193,157
BAHCELIEVLER,KOCASINAN MERKEZ MAH.,408,335,328,178,150
BAHCELIEVLER,KOCASINAN MERKEZ MAH.,408,364,357,150,207
BAHCELIEVLER,KOCASINAN MERKEZ MAH.,406,357,350,188,162
BAHCELIEVLER,KOCASINAN MERKEZ MAH.,406,383,377,196,181
BAHCELIEVLER,KOCASINAN MERKEZ MAH.,408,370,364,209,155
BAHCELIEVLER,KOCASINAN MERKEZ MAH.,410,377,373,178,195
BAHCELIEVLER,KOCASINAN MERKEZ MAH.,408,357,352,192,160
BAHCELIEVLER,KOCASINAN MERKEZ MAH.,407,362,353,227,126
BAHCELIEVLER,KOCASINAN MERKEZ MAH.,408,380,373,204,169
BAHCELIEVLER,KOCASINAN MERKEZ MAH.,409,368,361,186,175
BAHCELIEVLER,KOCASINAN MERKEZ MAH.,406,358,352,199,153
BAHCELIEVLER,KOCASINAN MERKEZ MAH.,410,377,374,221,153
BAHCELIEVLER,KOCASINAN MERKEZ MAH.,408,364,359,196,163
BAHCELIEVLER,KOCASINAN MERKEZ MAH.,408,367,362,182,180
BAHCELIEVLER,KOCASINAN MERKEZ MAH.,406,364,351,166,185
BAHCELIEVLER,KOCASINAN MERKEZ MAH.,407,363,363,181,182
BAHCELIEVLER,KOCASINAN MERKEZ MAH.,408,371,365,206,159
BAHCELIEVLER,KOCASINAN MERKEZ MAH.,406,364,362,199,163
BAHCELIEVLER,KOCASINAN MERKEZ MAH.,408,351,346,197,149
BAHCELIEVLER,KOCASINAN MERKEZ MAH.,400,331,323,138,185
BAHCELIEVLER,KOCASINAN MERKEZ MAH.,400,358,351,161,190
BAHCELIEVLER,KOCASINAN MERKEZ MAH.,399,367,365,174,191
BAHCELIEVLER,KOCASINAN MERKEZ MAH.,400,375,373,187,186
BAHCELIEVLER,KOCASINAN MERKEZ MAH.,401,369,362,157,205
BAHCELIEVLER,KOCASINAN MERKEZ MAH.,398,365,361,186,175
BAHCELIEVLER,KOCASINAN MERKEZ MAH.,399,342,341,167,174
BAHCELIEVLER,KOCASINAN MERKEZ MAH.,400,353,348,162,186
BAHCELIEVLER,KOCASINAN MERKEZ MAH.,400,343,340,135,205
BAHCELIEVLER,KOCASINAN MERKEZ MAH.,399,355,349,194,155
BAHCELIEVLER,KOCASINAN MERKEZ MAH.,400,355,352,192,160
BAHCELIEVLER,KOCASINAN MERKEZ MAH.,400,367,364,173,191
BAHCELIEVLER,KOCASINAN MERKEZ MAH.,399,350,346,148,198
BAHCELIEVLER,KOCASINAN MERKEZ MAH.,400,355,345,176,169
BAHCELIEVLER,KOCASINAN MERKEZ MAH.,409,346,337,143,194
BAHCELIEVLER,KOCASINAN MERKEZ MAH.,408,353,347,188,159
BAHCELIEVLER,KOCASINAN MERKEZ MAH.,409,365,358,169,189
BAHCELIEVLER,KOCASINAN MERKEZ MAH.,409,370,366,180,186
BAHCELIEVLER,KOCASINAN MERKEZ MAH.,408,369,363,188,175
BAHCELIEVLER,KOCASINAN MERKEZ MAH.,408,357,353,174,179
BAHCELIEVLER,KOCASINAN MERKEZ MAH.,409,374,367,187,180
BAHCELIEVLER,KOCASINAN MERKEZ MAH.,412,383,373,190,183
BAHCELIEVLER,KOCASINAN MERKEZ MAH.,407,369,368,187,181
BAHCELIEVLER,KOCASINAN MERKEZ MAH.,408,363,356,180,176
BAHCELIEVLER,KOCASINAN MERKEZ MAH.,408,376,373,179,194
BAHCELIEVLER,KOCASINAN MERKEZ MAH.,407,353,346,188,158
BAHCELIEVLER,KOCASINAN MERKEZ MAH.,408,353,345,179,166
BAHCELIEVLER,KOCASINAN MERKEZ MAH.,408,362,358,180,178
BAHCELIEVLER,KOCASINAN MERKEZ MAH.,407,360,357,173,184
BAHCELIEVLER,KOCASINAN MERKEZ MAH.,408,364,359,185,174
BAHCELIEVLER,KOCASINAN MERKEZ MAH.,408,363,359,195,164
BAHCELIEVLER,KOCASINAN MERKEZ MAH.,407,380,375,163,212
BAHCELIEVLER,KOCASINAN MERKEZ MAH.,408,364,355,195,160
BAHCELIEVLER,KOCASINAN MERKEZ MAH.,408,364,357,166,191
BAHCELIEVLER,KOCASINAN MERKEZ MAH.,408,330,317,162,155
BAHCELIEVLER,KOCASINAN MERKEZ MAH.,407,346,341,201,140
BAHCELIEVLER,KOCASINAN MERKEZ MAH.,407,367,365,189,176
BAHCELIEVLER,KOCASINAN MERKEZ MAH.,409,358,352,149,203
BAHCELIEVLER,KOCASINAN MERKEZ MAH.,407,351,347,192,155
BAHCELIEVLER,KOCASINAN MERKEZ MAH.,408,373,362,185,177
BAHCELIEVLER,KOCASINAN MERKEZ MAH.,409,373,370,192,178
BAHCELIEVLER,KOCASINAN MERKEZ MAH.,406,366,364,179,185
BAHCELIEVLER,KOCASINAN MERKEZ MAH.,407,372,368,167,201
BAHCELIEVLER,KOCASINAN MERKEZ MAH.,407,358,351,177,174
BAHCELIEVLER,KOCASINAN MERKEZ MAH.,409,361,357,182,175
BAHCELIEVLER,KOCASINAN MERKEZ MAH.,406,375,372,183,189
BAHCELIEVLER,KOCASINAN MERKEZ MAH.,407,368,362,164,198
BAHCELIEVLER,KOCASINAN MERKEZ MAH.,406,375,373,171,202
BAHCELIEVLER,KOCASINAN MERKEZ MAH.,406,357,350,176,174
BAHCELIEVLER,KOCASINAN MERKEZ MAH.,418,346,338,146,192
BAHCELIEVLER,KOCASINAN MERKEZ MAH.,415,361,355,221,134
BAHCELIEVLER,KOCASINAN MERKEZ MAH.,416,356,351,184,167
BAHCELIEVLER,KOCASINAN MERKEZ MAH.,415,365,360,204,156
BAHCELIEVLER,KOCASINAN MERKEZ MAH.,416,361,356,209,147
BAHCELIEVLER,KOCASINAN MERKEZ MAH.,415,357,352,189,163
BAHCELIEVLER,KOCASINAN MERKEZ MAH.,415,353,348,167,181
BAHCELIEVLER,KOCASINAN MERKEZ MAH.,415,352,347,181,166
BAHCELIEVLER,KOCASINAN MERKEZ MAH.,414,354,352,207,145
BAHCELIEVLER,KOCASINAN MERKEZ MAH.,415,370,365,187,178
BAHCELIEVLER,KOCASINAN MERKEZ MAH.,415,388,381,202,179
BAHCELIEVLER,KOCASINAN MERKEZ MAH.,414,369,367,188,179
BAHCELIEVLER,KOCASINAN MERKEZ MAH.,414,376,368,201,167
BAHCELIEVLER,KOCASINAN MERKEZ MAH.,397,333,328,128,200
BAHCELIEVLER,KOCASINAN MERKEZ MAH.,396,353,346,160,186
BAHCELIEVLER,KOCASINAN MERKEZ MAH.,397,363,355,144,211
BAHCELIEVLER,KOCASINAN MERKEZ MAH.,396,360,358,150,208
BAHCELIEVLER,KOCASINAN MERKEZ MAH.,397,338,336,141,195
BAHCELIEVLER,KOCASINAN MERKEZ MAH.,397,348,345,151,194
BAHCELIEVLER,KOCASINAN MERKEZ MAH.,397,353,348,152,196
BAHCELIEVLER,KOCASINAN MERKEZ MAH.,396,344,336,141,195
BAHCELIEVLER,KOCASINAN MERKEZ MAH.,396,358,353,168,185
BAHCELIEVLER,KOCASINAN MERKEZ MAH.,397,330,325,164,161
BAHCELIEVLER,KOCASINAN MERKEZ MAH.,395,351,347,147,200
BAHCELIEVLER,KOCASINAN MERKEZ MAH.,397,353,352,168,184
BAHCELIEVLER,KOCASINAN MERKEZ MAH.,397,358,353,166,187
BAHCELIEVLER,KOCASINAN MERKEZ MAH.,396,338,336,157,179
BAHCELIEVLER,KOCASINAN MERKEZ MAH.,397,350,348,169,179
BAHCELIEVLER,KOCASINAN MERKEZ MAH.,403,335,333,178,155
BAHCELIEVLER,KOCASINAN MERKEZ MAH.,402,355,353,202,151
BAHCELIEVLER,KOCASINAN MERKEZ MAH.,402,374,369,195,174
BAHCELIEVLER,KOCASINAN MERKEZ MAH.,402,353,352,195,157
BAHCELIEVLER,KOCASINAN MERKEZ MAH.,401,357,352,183,169
BAHCELIEVLER,KOCASINAN MERKEZ MAH.,401,359,351,196,155
BAHCELIEVLER,KOCASINAN MERKEZ MAH.,402,356,353,191,162
BAHCELIEVLER,KOCASINAN MERKEZ MAH.,402,354,351,201,150
BAHCELIEVLER,KOCASINAN MERKEZ MAH.,401,362,358,181,177
BAHCELIEVLER,KOCASINAN MERKEZ MAH.,402,357,353,196,157
BAHCELIEVLER,KOCASINAN MERKEZ MAH.,401,358,352,179,173
BAHCELIEVLER,KOCASINAN MERKEZ MAH.,396,347,344,181,163
BAHCELIEVLER,KOCASINAN MERKEZ MAH.,394,334,327,192,135
BAHCELIEVLER,KOCASINAN MERKEZ MAH.,395,352,342,173,169
BAHCELIEVLER,KOCASINAN MERKEZ MAH.,394,350,348,196,152
BAHCELIEVLER,KOCASINAN MERKEZ MAH.,395,355,352,166,186
BAHCELIEVLER,KOCASINAN MERKEZ MAH.,394,351,346,195,151
BAHCELIEVLER,KOCASINAN MERKEZ MAH.,394,353,352,197,155
BAHCELIEVLER,KOCASINAN MERKEZ MAH.,394,364,359,211,148
BAHCELIEVLER,KOCASINAN MERKEZ MAH.,394,358,354,230,124
BAHCELIEVLER,KOCASINAN MERKEZ MAH.,394,356,351,175,176
BAHCELIEVLER,KOCASINAN MERKEZ MAH.,395,356,352,195,157
BAHCELIEVLER,KOCASINAN MERKEZ MAH.,393,352,345,197,148
BAHCELIEVLER,KOCASINAN MERKEZ MAH.,393,342,340,184,156
BAHCELIEVLER,KOCASINAN MERKEZ MAH.,394,347,341,178,163
BAHCELIEVLER,KOCASINAN MERKEZ MAH.,394,356,351,220,131
BAHCELIEVLER,KOCASINAN MERKEZ MAH.,393,358,352,208,144
BAHCELIEVLER,KOCASINAN MERKEZ MAH.,394,350,343,207,136
BAHCELIEVLER,KOCASINAN MERKEZ MAH.,393,352,348,199,149
BAHCELIEVLER,KOCASINAN MERKEZ MAH.,393,351,345,174,171
BAHCELIEVLER,SIRINEVLER MAH.,405,324,323,203,120
BAHCELIEVLER,SIRINEVLER MAH.,405,316,309,195,114
BAHCELIEVLER,SIRINEVLER MAH.,405,346,341,188,153
BAHCELIEVLER,SIRINEVLER MAH.,405,376,370,234,136
BAHCELIEVLER,SIRINEVLER MAH.,405,349,346,200,146
BAHCELIEVLER,SIRINEVLER MAH.,405,340,338,202,136
BAHCELIEVLER,SIRINEVLER MAH.,404,360,357,207,150
BAHCELIEVLER,SIRINEVLER MAH.,405,354,349,219,130
BAHCELIEVLER,SIRINEVLER MAH.,405,344,338,213,125
BAHCELIEVLER,SIRINEVLER MAH.,405,352,347,201,146
BAHCELIEVLER,SIRINEVLER MAH.,404,368,363,233,130
BAHCELIEVLER,SIRINEVLER MAH.,404,338,333,173,160
BAHCELIEVLER,SIRINEVLER MAH.,404,342,338,203,135
BAHCELIEVLER,SIRINEVLER MAH.,405,351,344,222,122
BAHCELIEVLER,SIRINEVLER MAH.,404,366,363,220,143
BAHCELIEVLER,SIRINEVLER MAH.,404,359,352,223,129
BAHCELIEVLER,SIRINEVLER MAH.,405,356,352,205,147
BAHCELIEVLER,SIRINEVLER MAH.,405,343,341,199,142
BAHCELIEVLER,SIRINEVLER MAH.,404,359,357,205,152
BAHCELIEVLER,SIRINEVLER MAH.,407,326,314,212,102
BAHCELIEVLER,SIRINEVLER MAH.,403,343,338,224,114
BAHCELIEVLER,SIRINEVLER MAH.,402,351,345,210,135
BAHCELIEVLER,SIRINEVLER MAH.,403,362,355,194,161
BAHCELIEVLER,SIRINEVLER MAH.,403,344,339,191,148
BAHCELIEVLER,SIRINEVLER MAH.,403,343,337,202,135
BAHCELIEVLER,SIRINEVLER MAH.,405,354,346,218,128
BAHCELIEVLER,SIRINEVLER MAH.,402,350,350,214,136
BAHCELIEVLER,SIRINEVLER MAH.,402,353,352,209,143
BAHCELIEVLER,SIRINEVLER MAH.,403,368,363,233,130
BAHCELIEVLER,SIRINEVLER MAH.,402,361,356,233,123
BAHCELIEVLER,SIRINEVLER MAH.,402,363,360,232,128
BAHCELIEVLER,SIRINEVLER MAH.,404,350,348,216,132
BAHCELIEVLER,SIRINEVLER MAH.,403,357,356,219,137
BAHCELIEVLER,SIRINEVLER MAH.,403,359,357,208,149
BAHCELIEVLER,SIRINEVLER MAH.,403,356,349,197,152
BAHCELIEVLER,SIRINEVLER MAH.,402,350,348,245,103
BAHCELIEVLER,SIRINEVLER MAH.,402,355,353,229,124
BAHCELIEVLER,SIRINEVLER MAH.,402,358,358,234,124
BAHCELIEVLER,SIRINEVLER MAH.,402,357,351,209,142
BAHCELIEVLER,SIRINEVLER MAH.,403,355,351,221,130
BAHCELIEVLER,SIRINEVLER MAH.,410,323,321,185,136
BAHCELIEVLER,SIRINEVLER MAH.,415,333,327,154,173
BAHCELIEVLER,SIRINEVLER MAH.,409,368,363,173,190
BAHCELIEVLER,SIRINEVLER MAH.,409,361,354,194,160
BAHCELIEVLER,SIRINEVLER MAH.,409,350,348,178,170
BAHCELIEVLER,SIRINEVLER MAH.,410,365,362,183,179
BAHCELIEVLER,SIRINEVLER MAH.,410,359,353,217,136
BAHCELIEVLER,SIRINEVLER MAH.,410,364,361,196,165
BAHCELIEVLER,SIRINEVLER MAH.,410,367,366,182,184
BAHCELIEVLER,SIRINEVLER MAH.,410,351,349,188,161
BAHCELIEVLER,SIRINEVLER MAH.,409,355,349,187,162
BAHCELIEVLER,SIRINEVLER MAH.,410,370,362,196,166
BAHCELIEVLER,SIRINEVLER MAH.,410,368,363,159,204
BAHCELIEVLER,SIRINEVLER MAH.,409,357,352,190,162
BAHCELIEVLER,SIRINEVLER MAH.,410,350,347,178,169
BAHCELIEVLER,SIRINEVLER MAH.,409,370,366,191,175
BAHCELIEVLER,SIRINEVLER MAH.,412,345,342,179,163
BAHCELIEVLER,SIRINEVLER MAH.,410,361,361,181,180
BAHCELIEVLER,SIRINEVLER MAH.,410,357,351,224,127
BAHCELIEVLER,SIRINEVLER MAH.,409,367,362,182,180
BAHCELIEVLER,SIRINEVLER MAH.,410,358,355,204,151
BAHCELIEVLER,SIRINEVLER MAH.,409,361,356,191,165
BAHCELIEVLER,SIRINEVLER MAH.,394,316,312,184,128
BAHCELIEVLER,SIRINEVLER MAH.,395,331,325,180,145
BAHCELIEVLER,SIRINEVLER MAH.,394,349,344,206,138
BAHCELIEVLER,SIRINEVLER MAH.,394,339,336,187,149
BAHCELIEVLER,SIRINEVLER MAH.,394,339,333,190,143
BAHCELIEVLER,SIRINEVLER MAH.,396,355,354,170,184
BAHCELIEVLER,SIRINEVLER MAH.,395,344,341,200,141
BAHCELIEVLER,SIRINEVLER MAH.,396,347,341,189,152
BAHCELIEVLER,SIRINEVLER MAH.,394,350,343,195,148
BAHCELIEVLER,SIRINEVLER MAH.,393,350,350,205,145
BAHCELIEVLER,SIRINEVLER MAH.,394,354,348,200,148
BAHCELIEVLER,SIRINEVLER MAH.,395,344,342,193,149
BAHCELIEVLER,SIRINEVLER MAH.,395,353,346,201,145
BAHCELIEVLER,SIRINEVLER MAH.,415,319,313,140,173
BAHCELIEVLER,SIRINEVLER MAH.,415,329,316,126,190
BAHCELIEVLER,SIRINEVLER MAH.,414,325,324,128,196
BAHCELIEVLER,SIRINEVLER MAH.,413,330,324,120,204
BAHCELIEVLER,SIRINEVLER MAH.,415,342,334,148,186
BAHCELIEVLER,SIRINEVLER MAH.,413,358,354,153,201
BAHCELIEVLER,SIRINEVLER MAH.,412,341,331,122,209
BAHCELIEVLER,SIRINEVLER MAH.,414,361,360,146,214
BAHCELIEVLER,SIRINEVLER MAH.,414,340,335,158,177
BAHCELIEVLER,SIRINEVLER MAH.,414,346,342,142,200
BAHCELIEVLER,SIRINEVLER MAH.,414,347,342,138,204
BAHCELIEVLER,SIRINEVLER MAH.,413,342,334,152,182
BAHCELIEVLER,SIRINEVLER MAH.,414,346,338,139,199
BAHCELIEVLER,SIRINEVLER MAH.,413,340,336,157,179
BAHCELIEVLER,SIRINEVLER MAH.,412,336,335,141,194
BAHCELIEVLER,SIRINEVLER MAH.,412,340,334,147,187
BAHCELIEVLER,SIRINEVLER MAH.,413,358,355,160,195
BAHCELIEVLER,SIRINEVLER MAH.,414,349,342,159,183
BAHCELIEVLER,SIRINEVLER MAH.,414,347,341,145,196
BAHCELIEVLER,SIRINEVLER MAH.,412,352,351,176,175
BAHCELIEVLER,SIRINEVLER MAH.,415,358,352,143,209
BAHCELIEVLER,SIRINEVLER MAH.,413,354,351,160,191
BAHCELIEVLER,SIRINEVLER MAH.,412,320,315,141,174
BAHCELIEVLER,SIRINEVLER MAH.,413,360,355,159,196
BAHCELIEVLER,SIRINEVLER MAH.,414,350,344,141,203
BAHCELIEVLER,SIRINEVLER MAH.,413,336,328,161,167
BAHCELIEVLER,SIRINEVLER MAH.,415,361,360,160,200
BAHCELIEVLER,SIRINEVLER MAH.,414,357,353,168,185
BAHCELIEVLER,COBANCESME MAH.,394,330,323,202,121
BAHCELIEVLER,COBANCESME MAH.,393,346,339,242,97
BAHCELIEVLER,COBANCESME MAH.,394,366,360,232,128
BAHCELIEVLER,COBANCESME MAH.,393,358,348,234,114
BAHCELIEVLER,COBANCESME MAH.,396,361,357,219,138
BAHCELIEVLER,COBANCESME MAH.,396,350,345,226,119
BAHCELIEVLER,COBANCESME MAH.,393,361,358,245,113
BAHCELIEVLER,COBANCESME MAH.,393,348,348,219,129
BAHCELIEVLER,COBANCESME MAH.,394,374,371,259,112
BAHCELIEVLER,COBANCESME MAH.,393,365,357,235,122
BAHCELIEVLER,COBANCESME MAH.,393,368,366,234,132
BAHCELIEVLER,COBANCESME MAH.,395,360,354,238,116
BAHCELIEVLER,COBANCESME MAH.,398,339,330,204,126
BAHCELIEVLER,COBANCESME MAH.,399,332,330,181,149
BAHCELIEVLER,COBANCESME MAH.,399,357,351,204,147
BAHCELIEVLER,COBANCESME MAH.,399,353,348,215,133
BAHCELIEVLER,COBANCESME MAH.,401,362,356,211,145
BAHCELIEVLER,COBANCESME MAH.,398,356,352,217,135
BAHCELIEVLER,COBANCESME MAH.,398,346,340,206,134
BAHCELIEVLER,COBANCESME MAH.,399,358,349,248,101
BAHCELIEVLER,COBANCESME MAH.,396,349,344,192,152
BAHCELIEVLER,COBANCESME MAH.,399,347,338,187,151
BAHCELIEVLER,COBANCESME MAH.,399,360,356,225,131
BAHCELIEVLER,COBANCESME MAH.,399,360,357,196,161
BAHCELIEVLER,COBANCESME MAH.,398,358,353,239,114
BAHCELIEVLER,COBANCESME MAH.,398,366,361,250,111
BAHCELIEVLER,COBANCESME MAH.,398,367,363,234,129
BAHCELIEVLER,COBANCESME MAH.,399,359,354,223,131
BAHCELIEVLER,COBANCESME MAH.,398,366,359,249,110
BAHCELIEVLER,COBANCESME MAH.,399,344,338,217,121
BAHCELIEVLER,COBANCESME MAH.,399,357,355,218,137
BAHCELIEVLER,COBANCESME MAH.,406,340,328,200,128
BAHCELIEVLER,COBANCESME MAH.,406,327,324,192,132
BAHCELIEVLER,COBANCESME MAH.,406,351,348,184,164
BAHCELIEVLER,COBANCESME MAH.,406,351,346,222,124
BAHCELIEVLER,COBANCESME MAH.,406,371,364,203,161
BAHCELIEVLER,COBANCESME MAH.,406,369,365,197,168
BAHCELIEVLER,COBANCESME MAH.,407,365,359,204,155
BAHCELIEVLER,COBANCESME MAH.,405,349,346,198,148
BAHCELIEVLER,COBANCESME MAH.,405,369,363,220,143
BAHCELIEVLER,COBANCESME MAH.,406,364,362,201,161
BAHCELIEVLER,COBANCESME MAH.,406,371,367,202,165
BAHCELIEVLER,COBANCESME MAH.,405,347,339,208,131
BAHCELIEVLER,COBANCESME MAH.,406,353,350,181,169
BAHCELIEVLER,COBANCESME MAH.,406,356,354,215,139
BAHCELIEVLER,COBANCESME MAH.,406,364,356,197,159
BAHCELIEVLER,COBANCESME MAH.,406,348,345,193,152
BAHCELIEVLER,COBANCESME MAH.,405,348,344,209,135
BAHCELIEVLER,COBANCESME MAH.,406,366,363,213,150
BAHCELIEVLER,COBANCESME MAH.,405,363,356,229,127
BAHCELIEVLER,COBANCESME MAH.,405,347,344,235,109
BAHCELIEVLER,COBANCESME MAH.,405,360,354,227,127
BAHCELIEVLER,COBANCESME MAH.,405,350,345,215,130
BAHCELIEVLER,COBANCESME MAH.,407,371,366,224,142
BAHCELIEVLER,COBANCESME MAH.,406,365,356,228,128
BAHCELIEVLER,COBANCESME MAH.,405,358,352,211,141
BAHCELIEVLER,COBANCESME MAH.,405,373,365,217,148
BAHCELIEVLER,COBANCESME MAH.,406,352,342,199,143
BAHCELIEVLER,FEVZI CAKMAK MAH.,410,347,338,190,148
BAHCELIEVLER,FEVZI CAKMAK MAH.,410,326,316,188,128
BAHCELIEVLER,FEVZI CAKMAK MAH.,411,358,352,184,168
BAHCELIEVLER,FEVZI CAKMAK MAH.,415,361,359,198,161
BAHCELIEVLER,FEVZI CAKMAK MAH.,410,370,367,232,135
BAHCELIEVLER,FEVZI CAKMAK MAH.,410,359,349,215,134
BAHCELIEVLER,FEVZI CAKMAK MAH.,415,367,363,220,143
BAHCELIEVLER,FEVZI CAKMAK MAH.,410,372,365,205,160
BAHCELIEVLER,FEVZI CAKMAK MAH.,411,372,371,226,145
BAHCELIEVLER,FEVZI CAKMAK MAH.,411,346,346,205,141
BAHCELIEVLER,FEVZI CAKMAK MAH.,410,358,356,218,138
BAHCELIEVLER,FEVZI CAKMAK MAH.,411,364,360,214,146
BAHCELIEVLER,FEVZI CAKMAK MAH.,411,359,353,199,154
BAHCELIEVLER,FEVZI CAKMAK MAH.,411,370,366,232,134
BAHCELIEVLER,FEVZI CAKMAK MAH.,410,372,372,210,162
BAHCELIEVLER,FEVZI CAKMAK MAH.,415,368,359,208,151
BAHCELIEVLER,FEVZI CAKMAK MAH.,409,351,345,204,141
BAHCELIEVLER,FEVZI CAKMAK MAH.,410,365,365,207,158
BAHCELIEVLER,FEVZI CAKMAK MAH.,409,359,352,194,158
BAHCELIEVLER,FEVZI CAKMAK MAH.,402,326,320,194,126
BAHCELIEVLER,FEVZI CAKMAK MAH.,403,350,343,200,143
BAHCELIEVLER,FEVZI CAKMAK MAH.,404,355,353,217,136
BAHCELIEVLER,FEVZI CAKMAK MAH.,403,353,350,210,140
BAHCELIEVLER,FEVZI CAKMAK MAH.,402,356,352,199,153
BAHCELIEVLER,FEVZI CAKMAK MAH.,401,363,355,217,138
BAHCELIEVLER,FEVZI CAKMAK MAH.,404,361,354,230,124
BAHCELIEVLER,FEVZI CAKMAK MAH.,401,362,356,219,137
BAHCELIEVLER,FEVZI CAKMAK MAH.,401,347,344,210,134
BAHCELIEVLER,FEVZI CAKMAK MAH.,404,367,362,204,158
BAHCELIEVLER,FEVZI CAKMAK MAH.,402,368,362,221,141
BAHCELIEVLER,FEVZI CAKMAK MAH.,401,366,364,200,164
BAHCELIEVLER,FEVZI CAKMAK MAH.,402,369,366,209,157
BAHCELIEVLER,FEVZI CAKMAK MAH.,402,347,342,182,160
BAHCELIEVLER,FEVZI CAKMAK MAH.,403,350,347,183,164
BAHCELIEVLER,FEVZI CAKMAK MAH.,402,345,341,226,115
BAHCELIEVLER,FEVZI CAKMAK MAH.,402,354,350,235,115
BAHCELIEVLER,FEVZI CAKMAK MAH.,403,366,354,186,168
BAHCELIEVLER,FEVZI CAKMAK MAH.,401,337,334,213,121
BAHCELIEVLER,FEVZI CAKMAK MAH.,406,341,329,181,148
BAHCELIEVLER,FEVZI CAKMAK MAH.,407,364,356,203,153
BAHCELIEVLER,FEVZI CAKMAK MAH.,406,374,369,223,146
BAHCELIEVLER,FEVZI CAKMAK MAH.,407,361,356,192,164
BAHCELIEVLER,FEVZI CAKMAK MAH.,406,358,347,171,176
BAHCELIEVLER,FEVZI CAKMAK MAH.,405,349,343,189,154
BAHCELIEVLER,FEVZI CAKMAK MAH.,406,365,359,196,163
BAHCELIEVLER,FEVZI CAKMAK MAH.,405,366,361,165,196
BAHCELIEVLER,FEVZI CAKMAK MAH.,405,350,347,204,143
BAHCELIEVLER,YENIBOSNA MERKEZ MAH.,398,339,332,179,153
BAHCELIEVLER,YENIBOSNA MERKEZ MAH.,396,354,347,169,178
BAHCELIEVLER,YENIBOSNA MERKEZ MAH.,398,367,359,197,162
BAHCELIEVLER,YENIBOSNA MERKEZ MAH.,398,356,354,191,163
BAHCELIEVLER,YENIBOSNA MERKEZ MAH.,397,365,359,223,136
BAHCELIEVLER,YENIBOSNA MERKEZ MAH.,397,364,359,186,173
BAHCELIEVLER,YENIBOSNA MERKEZ MAH.,398,371,366,225,141
BAHCELIEVLER,YENIBOSNA MERKEZ MAH.,398,352,346,198,148
BAHCELIEVLER,YENIBOSNA MERKEZ MAH.,397,357,350,206,144
BAHCELIEVLER,YENIBOSNA MERKEZ MAH.,398,365,363,209,154
BAHCELIEVLER,YENIBOSNA MERKEZ MAH.,398,373,369,204,165
BAHCELIEVLER,YENIBOSNA MERKEZ MAH.,398,362,356,191,165
BAHCELIEVLER,YENIBOSNA MERKEZ MAH.,397,370,360,209,151
BAHCELIEVLER,YENIBOSNA MERKEZ MAH.,398,362,356,180,176
BAHCELIEVLER,YENIBOSNA MERKEZ MAH.,397,367,362,194,168
BAHCELIEVLER,YENIBOSNA MERKEZ MAH.,397,371,364,201,163
BAHCELIEVLER,YENIBOSNA MERKEZ MAH.,415,322,315,124,191
BAHCELIEVLER,YENIBOSNA MERKEZ MAH.,410,334,329,125,204
BAHCELIEVLER,YENIBOSNA MERKEZ MAH.,415,364,361,153,208
BAHCELIEVLER,YENIBOSNA MERKEZ MAH.,411,369,369,152,217
BAHCELIEVLER,YENIBOSNA MERKEZ MAH.,415,375,372,136,236
BAHCELIEVLER,YENIBOSNA MERKEZ MAH.,411,364,360,153,207
BAHCELIEVLER,YENIBOSNA MERKEZ MAH.,415,365,363,162,201
BAHCELIEVLER,YENIBOSNA MERKEZ MAH.,411,368,366,147,219
BAHCELIEVLER,YENIBOSNA MERKEZ MAH.,411,363,362,157,205
BAHCELIEVLER,YENIBOSNA MERKEZ MAH.,415,381,381,144,237
BAHCELIEVLER,YENIBOSNA MERKEZ MAH.,415,384,377,148,229
BAHCELIEVLER,YENIBOSNA MERKEZ MAH.,411,375,368,166,202
BAHCELIEVLER,YENIBOSNA MERKEZ MAH.,411,373,371,154,217
BAHCELIEVLER,YENIBOSNA MERKEZ MAH.,412,377,372,168,204
BAHCELIEVLER,YENIBOSNA MERKEZ MAH.,411,377,375,168,207
BAHCELIEVLER,YENIBOSNA MERKEZ MAH.,412,368,364,137,227
BAHCELIEVLER,YENIBOSNA MERKEZ MAH.,415,369,365,175,190
BAHCELIEVLER,YENIBOSNA MERKEZ MAH.,411,375,371,145,226
BAHCELIEVLER,YENIBOSNA MERKEZ MAH.,412,385,380,155,225
BAHCELIEVLER,YENIBOSNA MERKEZ MAH.,412,372,370,166,204
BAHCELIEVLER,YENIBOSNA MERKEZ MAH.,401,338,332,168,164
BAHCELIEVLER,YENIBOSNA MERKEZ MAH.,400,360,357,159,198
BAHCELIEVLER,YENIBOSNA MERKEZ MAH.,400,359,350,176,174
BAHCELIEVLER,YENIBOSNA MERKEZ MAH.,399,354,347,171,176
BAHCELIEVLER,YENIBOSNA MERKEZ MAH.,399,357,353,196,157
BAHCELIEVLER,YENIBOSNA MERKEZ MAH.,400,352,348,179,169
BAHCELIEVLER,YENIBOSNA MERKEZ MAH.,401,354,350,183,167
BAHCELIEVLER,YENIBOSNA MERKEZ MAH.,409,374,367,181,186
BAHCELIEVLER,YENIBOSNA MERKEZ MAH.,399,351,345,190,155
BAHCELIEVLER,YENIBOSNA MERKEZ MAH.,401,364,359,206,153
BAHCELIEVLER,YENIBOSNA MERKEZ MAH.,401,362,358,190,168
BAHCELIEVLER,YENIBOSNA MERKEZ MAH.,400,349,346,174,172
BAHCELIEVLER,YENIBOSNA MERKEZ MAH.,397,355,351,180,171
BAHCELIEVLER,YENIBOSNA MERKEZ MAH.,399,365,361,208,153
BAHCELIEVLER,YENIBOSNA MERKEZ MAH.,398,356,352,227,125
BAHCELIEVLER,YENIBOSNA MERKEZ MAH.,396,340,336,233,103
BAHCELIEVLER,YENIBOSNA MERKEZ MAH.,397,363,360,238,122
BAHCELIEVLER,YENIBOSNA MERKEZ MAH.,398,353,348,215,133
BAHCELIEVLER,YENIBOSNA MERKEZ MAH.,396,359,352,200,152
BAHCELIEVLER,YENIBOSNA MERKEZ MAH.,396,340,336,183,153
BAHCELIEVLER,YENIBOSNA MERKEZ MAH.,397,357,351,213,138
BAHCELIEVLER,YENIBOSNA MERKEZ MAH.,397,359,357,208,149
BAHCELIEVLER,YENIBOSNA MERKEZ MAH.,397,347,337,191,146
BAHCELIEVLER,YENIBOSNA MERKEZ MAH.,396,369,365,244,121
BAHCELIEVLER,ZAFER MAH.,408,346,340,215,125
BAHCELIEVLER,ZAFER MAH.,408,361,355,198,157
BAHCELIEVLER,ZAFER MAH.,415,367,360,212,148
BAHCELIEVLER,ZAFER MAH.,410,377,372,241,131
BAHCELIEVLER,ZAFER MAH.,409,367,360,216,144
BAHCELIEVLER,ZAFER MAH.,408,370,365,200,165
BAHCELIEVLER,ZAFER MAH.,410,357,353,181,172
BAHCELIEVLER,ZAFER MAH.,410,358,355,193,162
BAHCELIEVLER,ZAFER MAH.,410,362,356,203,153
BAHCELIEVLER,ZAFER MAH.,409,349,346,194,152
BAHCELIEVLER,ZAFER MAH.,410,365,359,218,141
BAHCELIEVLER,ZAFER MAH.,410,364,360,182,178
BAHCELIEVLER,ZAFER MAH.,409,365,362,196,166
BAHCELIEVLER,ZAFER MAH.,410,371,365,186,179
BAHCELIEVLER,ZAFER MAH.,410,356,351,171,180
BAHCELIEVLER,ZAFER MAH.,410,349,348,195,153
BAHCELIEVLER,ZAFER MAH.,406,323,318,180,138
BAHCELIEVLER,ZAFER MAH.,407,347,343,229,114
BAHCELIEVLER,ZAFER MAH.,407,331,329,204,125
BAHCELIEVLER,ZAFER MAH.,407,364,359,214,145
BAHCELIEVLER,ZAFER MAH.,408,367,360,203,157
BAHCELIEVLER,ZAFER MAH.,405,373,368,194,174
BAHCELIEVLER,ZAFER MAH.,407,345,337,207,130
BAHCELIEVLER,ZAFER MAH.,406,364,358,184,174
BAHCELIEVLER,ZAFER MAH.,407,356,348,210,138
BAHCELIEVLER,ZAFER MAH.,406,368,365,226,139
BAHCELIEVLER,ZAFER MAH.,407,357,352,191,161
BAHCELIEVLER,ZAFER MAH.,406,363,361,201,160
BAHCELIEVLER,ZAFER MAH.,408,357,349,205,144
BAHCELIEVLER,ZAFER MAH.,407,350,343,182,161
BAHCELIEVLER,ZAFER MAH.,407,349,347,194,153
BAHCELIEVLER,ZAFER MAH.,406,340,337,207,130
BAHCELIEVLER,ZAFER MAH.,407,356,349,207,142
BAHCELIEVLER,ZAFER MAH.,405,347,337,182,155
BAHCELIEVLER,ZAFER MAH.,407,354,350,205,145
BAHCELIEVLER,ZAFER MAH.,406,363,360,210,150
BAHCELIEVLER,ZAFER MAH.,407,369,362,195,167
BAHCELIEVLER,ZAFER MAH.,406,356,352,200,152
BAHCELIEVLER,ZAFER MAH.,407,364,361,213,148
BAHCELIEVLER,ZAFER MAH.,407,342,341,214,127
BAHCELIEVLER,ZAFER MAH.,407,354,348,206,142
BAHCELIEVLER,ZAFER MAH.,407,348,343,188,155
BAHCELIEVLER,ZAFER MAH.,407,368,364,232,132
BAHCELIEVLER,ZAFER MAH.,406,377,368,236,132
BAHCELIEVLER,ZAFER MAH.,406,366,363,239,124
BAHCELIEVLER,ZAFER MAH.,406,360,354,235,119
BAHCELIEVLER,ZAFER MAH.,407,358,350,219,131
BAHCELIEVLER,ZAFER MAH.,410,347,342,238,104
BAHCELIEVLER,ZAFER MAH.,411,325,313,157,156
BAHCELIEVLER,ZAFER MAH.,410,350,343,198,145
BAHCELIEVLER,ZAFER MAH.,409,363,357,186,171
BAHCELIEVLER,ZAFER MAH.,408,364,358,209,149
BAHCELIEVLER,ZAFER MAH.,415,383,379,210,169
BAHCELIEVLER,ZAFER MAH.,409,376,373,211,162
BAHCELIEVLER,ZAFER MAH.,409,354,350,187,163
BAHCELIEVLER,ZAFER MAH.,410,357,351,196,155
BAHCELIEVLER,ZAFER MAH.,409,360,357,187,170
BAHCELIEVLER,ZAFER MAH.,410,374,370,228,142
BAHCELIEVLER,ZAFER MAH.,409,369,366,203,163
BAHCELIEVLER,ZAFER MAH.,410,361,351,217,134
BAHCELIEVLER,ZAFER MAH.,408,366,361,220,141
BAHCELIEVLER,ZAFER MAH.,409,358,357,226,131
BAHCELIEVLER,ZAFER MAH.,410,358,352,217,135
BAHCELIEVLER,ZAFER MAH.,409,363,356,197,159
BAHCELIEVLER,ZAFER MAH.,408,357,354,214,140
BAHCELIEVLER,ZAFER MAH.,409,362,358,184,174
BAHCELIEVLER,ZAFER MAH.,409,361,354,208,146
BAHCELIEVLER,ZAFER MAH.,409,376,371,218,153
BAHCELIEVLER,ZAFER MAH.,411,366,359,226,133
BAHCELIEVLER,ZAFER MAH.,409,376,369,252,117
BAHCELIEVLER,ZAFER MAH.,409,367,363,213,150
BAHCELIEVLER,ZAFER MAH.,409,363,357,208,149
BAHCELIEVLER,ZAFER MAH.,411,373,369,237,132
BAHCELIEVLER,ZAFER MAH.,409,365,360,192,168
BAHCELIEVLER,ZAFER MAH.,408,353,344,222,122
BAHCELIEVLER,ZAFER MAH.,409,361,358,206,152
BAHCELIEVLER,ZAFER MAH.,408,371,364,207,157
BAHCELIEVLER,ZAFER MAH.,409,368,358,197,161
BAHCELIEVLER,ZAFER MAH.,409,362,354,193,161
BAHCELIEVLER,ZAFER MAH.,415,370,368,231,137
BAHCELIEVLER,ZAFER MAH.,408,374,366,218,148
BAHCELIEVLER,ZAFER MAH.,408,342,331,176,155
BAHCELIEVLER,ZAFER MAH.,409,377,367,195,172
BAHCELIEVLER,ZAFER MAH.,411,344,340,203,137
BAHCELIEVLER,ZAFER MAH.,415,367,357,212,145
BAHCELIEVLER,ZAFER MAH.,411,356,353,222,131
BAHCELIEVLER,ZAFER MAH.,411,361,359,227,132
BAHCELIEVLER,ZAFER MAH.,411,363,358,227,131
BAHCELIEVLER,ZAFER MAH.,415,371,366,206,160
BAHCELIEVLER,ZAFER MAH.,410,373,369,219,150
BAHCELIEVLER,ZAFER MAH.,411,365,354,218,136
BAHCELIEVLER,ZAFER MAH.,412,364,358,194,164
BAHCELIEVLER,ZAFER MAH.,411,366,362,226,136
BAHCELIEVLER,ZAFER MAH.,410,377,371,224,147
BAHCELIEVLER,ZAFER MAH.,412,376,370,205,165
BAHCELIEVLER,ZAFER MAH.,411,384,373,250,123
BAHCELIEVLER,ZAFER MAH.,412,364,358,226,132
BAHCELIEVLER,ZAFER MAH.,411,362,351,194,157
BAHCELIEVLER,ZAFER MAH.,411,360,358,231,127
BAHCELIEVLER,ZAFER MAH.,412,375,370,223,147
BAHCELIEVLER,ZAFER MAH.,403,350,343,178,165
BAHCELIEVLER,ZAFER MAH.,403,354,346,179,167
BAHCELIEVLER,ZAFER MAH.,404,366,359,203,156
BAHCELIEVLER,ZAFER MAH.,403,363,356,180,176
BAHCELIEVLER,ZAFER MAH.,407,372,360,219,141
BAHCELIEVLER,ZAFER MAH.,404,348,342,194,148
BAHCELIEVLER,ZAFER MAH.,403,362,357,241,116
BAHCELIEVLER,ZAFER MAH.,404,374,368,225,143
BAHCELIEVLER,ZAFER MAH.,404,348,345,200,145
BAHCELIEVLER,ZAFER MAH.,403,364,358,188,170
BAHCELIEVLER,ZAFER MAH.,404,365,358,178,180
BAHCELIEVLER,ZAFER MAH.,403,355,350,200,150
BAHCELIEVLER,ZAFER MAH.,404,342,332,197,135
BAHCELIEVLER,ZAFER MAH.,404,350,349,182,167
BAHCELIEVLER,ZAFER MAH.,403,362,354,202,152
BAHCELIEVLER,ZAFER MAH.,403,365,360,171,189
BAHCELIEVLER,ZAFER MAH.,403,355,352,186,166
BAHCELIEVLER,ZAFER MAH.,403,365,356,211,145
BAHCELIEVLER,ZAFER MAH.,404,370,368,199,169
BAHCELIEVLER,ZAFER MAH.,404,358,356,218,138
BAHCELIEVLER,ZAFER MAH.,404,363,358,207,151
BAHCELIEVLER,ZAFER MAH.,406,362,354,214,140
BAHCELIEVLER,ZAFER MAH.,410,337,334,154,180
BAHCELIEVLER,ZAFER MAH.,409,320,310,165,145
BAHCELIEVLER,ZAFER MAH.,410,350,349,198,151
BAHCELIEVLER,ZAFER MAH.,410,353,350,200,150
BAHCELIEVLER,ZAFER MAH.,409,364,363,224,139
BAHCELIEVLER,ZAFER MAH.,410,356,355,192,163
BAHCELIEVLER,ZAFER MAH.,410,355,348,197,151
BAHCELIEVLER,ZAFER MAH.,410,359,354,201,153
BAHCELIEVLER,ZAFER MAH.,410,366,355,197,158
BAHCELIEVLER,ZAFER MAH.,409,346,340,184,156
BAHCELIEVLER,ZAFER MAH.,410,359,355,195,160
BAHCELIEVLER,ZAFER MAH.,411,352,349,202,147
BAHCELIEVLER,ZAFER MAH.,410,359,354,174,180
BAHCELIEVLER,ZAFER MAH.,411,372,366,207,159
BAHCELIEVLER,ZAFER MAH.,410,349,343,181,162
BAHCELIEVLER,ZAFER MAH.,409,356,354,195,159
BAHCELIEVLER,ZAFER MAH.,409,355,350,196,154
BAHCELIEVLER,ZAFER MAH.,409,355,349,195,154
BAHCELIEVLER,ZAFER MAH.,410,358,355,215,140
BAHCELIEVLER,ZAFER MAH.,409,358,349,197,152
BAHCELIEVLER,ZAFER MAH.,409,356,352,224,128
BAHCELIEVLER,ZAFER MAH.,409,347,340,177,163
BAHCELIEVLER,ZAFER MAH.,409,356,355,223,132
BAHCELIEVLER,ZAFER MAH.,409,349,347,193,154
SULTANBEYLI,ABDURRAHMANGAZI MAH.,411,351,345,290,55
SULTANBEYLI,ABDURRAHMANGAZI MAH.,410,356,350,258,92
SULTANBEYLI,ABDURRAHMANGAZI MAH.,410,354,348,251,97
SULTANBEYLI,ABDURRAHMANGAZI MAH.,415,374,368,309,59
SULTANBEYLI,ABDURRAHMANGAZI MAH.,410,374,370,277,93
SULTANBEYLI,ABDURRAHMANGAZI MAH.,415,368,359,281,78
SULTANBEYLI,ABDURRAHMANGAZI MAH.,414,371,366,273,93
SULTANBEYLI,ABDURRAHMANGAZI MAH.,410,365,360,289,71
SULTANBEYLI,ABDURRAHMANGAZI MAH.,411,369,355,288,67
SULTANBEYLI,ABDURRAHMANGAZI MAH.,410,365,361,287,74
SULTANBEYLI,ABDURRAHMANGAZI MAH.,411,379,370,303,67
SULTANBEYLI,ABDURRAHMANGAZI MAH.,411,381,378,296,82
SULTANBEYLI,ABDURRAHMANGAZI MAH.,410,362,355,267,88
SULTANBEYLI,ABDURRAHMANGAZI MAH.,409,351,347,268,79
SULTANBEYLI,ABDURRAHMANGAZI MAH.,411,361,359,284,75
SULTANBEYLI,ABDURRAHMANGAZI MAH.,410,362,357,298,59
SULTANBEYLI,ABDURRAHMANGAZI MAH.,410,353,351,281,70
SULTANBEYLI,ABDURRAHMANGAZI MAH.,411,378,376,314,62
SULTANBEYLI,ABDURRAHMANGAZI MAH.,410,376,371,306,65
SULTANBEYLI,ABDURRAHMANGAZI MAH.,411,364,353,262,91
SULTANBEYLI,ABDURRAHMANGAZI MAH.,410,372,366,293,73
SULTANBEYLI,ABDURRAHMANGAZI MAH.,411,369,364,258,106
SULTANBEYLI,ABDURRAHMANGAZI MAH.,410,369,366,296,70
SULTANBEYLI,ABDURRAHMANGAZI MAH.,410,365,358,273,85
SULTANBEYLI,ABDURRAHMANGAZI MAH.,410,350,337,271,66
SULTANBEYLI,ABDURRAHMANGAZI MAH.,411,373,367,276,91
SULTANBEYLI,ABDURRAHMANGAZI MAH.,410,375,370,274,96
SULTANBEYLI,ABDURRAHMANGAZI MAH.,410,366,357,264,93
SULTANBEYLI,ABDURRAHMANGAZI MAH.,410,367,365,295,70
SULTANBEYLI,ABDURRAHMANGAZI MAH.,410,380,373,289,84
SULTANBEYLI,ABDURRAHMANGAZI MAH.,399,357,350,292,58
SULTANBEYLI,ABDURRAHMANGAZI MAH.,399,348,343,301,42
SULTANBEYLI,ABDURRAHMANGAZI MAH.,399,363,358,301,57
SULTANBEYLI,ABDURRAHMANGAZI MAH.,399,373,367,314,53
SULTANBEYLI,ABDURRAHMANGAZI MAH.,398,357,352,299,53
SULTANBEYLI,ABDURRAHMANGAZI MAH.,399,350,347,297,50
SULTANBEYLI,ABDURRAHMANGAZI MAH.,399,355,350,300,50
SULTANBEYLI,ABDURRAHMANGAZI MAH.,400,360,355,297,58
SULTANBEYLI,ABDURRAHMANGAZI MAH.,399,379,376,325,51
SULTANBEYLI,ABDURRAHMANGAZI MAH.,403,359,348,295,53
SULTANBEYLI,ABDURRAHMANGAZI MAH.,398,369,364,296,68
SULTANBEYLI,ABDURRAHMANGAZI MAH.,399,372,364,304,60
SULTANBEYLI,ABDURRAHMANGAZI MAH.,398,372,367,307,60
SULTANBEYLI,ABDURRAHMANGAZI MAH.,398,370,364,306,58
SULTANBEYLI,ABDURRAHMANGAZI MAH.,398,359,351,298,53
SULTANBEYLI,ABDURRAHMANGAZI MAH.,400,361,358,296,62
SULTANBEYLI,ABDURRAHMANGAZI MAH.,399,371,363,316,47
SULTANBEYLI,ABDURRAHMANGAZI MAH.,398,370,362,307,55
SULTANBEYLI,AKSEMSETTIN MAH.,408,359,351,241,110
SULTANBEYLI,AKSEMSETTIN MAH.,404,347,343,252,91
SULTANBEYLI,AKSEMSETTIN MAH.,403,362,355,192,163
SULTANBEYLI,AKSEMSETTIN MAH.,408,370,357,247,110
SULTANBEYLI,AKSEMSETTIN MAH.,405,368,361,242,119
SULTANBEYLI,AKSEMSETTIN MAH.,403,370,364,244,120
SULTANBEYLI,AKSEMSETTIN MAH.,404,362,359,260,99
SULTANBEYLI,AKSEMSETTIN MAH.,406,367,356,236,120
SULTANBEYLI,AKSEMSETTIN MAH.,404,367,360,235,125
SULTANBEYLI,AKSEMSETTIN MAH.,404,365,356,219,137
SULTANBEYLI,AKSEMSETTIN MAH.,403,367,362,230,132
SULTANBEYLI,AKSEMSETTIN MAH.,406,370,361,258,103
SULTANBEYLI,AKSEMSETTIN MAH.,405,364,360,249,111
SULTANBEYLI,AKSEMSETTIN MAH.,403,362,354,214,140
SULTANBEYLI,AKSEMSETTIN MAH.,403,360,354,251,103
SULTANBEYLI,AKSEMSETTIN MAH.,404,363,357,248,109
SULTANBEYLI,AKSEMSETTIN MAH.,403,364,359,245,114
SULTANBEYLI,AKSEMSETTIN MAH.,403,372,367,249,118
SULTANBEYLI,AKSEMSETTIN MAH.,403,367,362,247,115
SULTANBEYLI,AKSEMSETTIN MAH.,407,366,360,213,147
SULTANBEYLI,FATIH  MAH.,410,337,328,223,105
SULTANBEYLI,FATIH  MAH.,415,351,343,234,109
SULTANBEYLI,FATIH  MAH.,410,365,361,221,140
SULTANBEYLI,FATIH  MAH.,415,371,369,265,104
SULTANBEYLI,FATIH  MAH.,412,373,365,249,116
SULTANBEYLI,FATIH  MAH.,414,365,361,253,108
SULTANBEYLI,FATIH  MAH.,414,366,355,242,113
SULTANBEYLI,FATIH  MAH.,415,365,362,262,100
SULTANBEYLI,FATIH  MAH.,412,367,356,225,131
SULTANBEYLI,FATIH  MAH.,414,374,370,252,118
SULTANBEYLI,FATIH  MAH.,415,367,360,209,151
SULTANBEYLI,FATIH  MAH.,414,361,354,221,133
SULTANBEYLI,FATIH  MAH.,415,367,360,244,116
SULTANBEYLI,FATIH  MAH.,415,372,364,246,118
SULTANBEYLI,FATIH  MAH.,415,375,371,230,141
SULTANBEYLI,FATIH  MAH.,414,367,360,242,118
SULTANBEYLI,FATIH  MAH.,415,373,363,237,126
SULTANBEYLI,FATIH  MAH.,414,372,366,277,89
SULTANBEYLI,FATIH  MAH.,410,352,348,278,70
SULTANBEYLI,FATIH  MAH.,410,349,340,256,84
SULTANBEYLI,FATIH  MAH.,410,369,362,281,81
SULTANBEYLI,FATIH  MAH.,410,361,356,276,80
SULTANBEYLI,FATIH  MAH.,411,370,360,280,80
SULTANBEYLI,FATIH  MAH.,410,359,345,271,74
SULTANBEYLI,FATIH  MAH.,411,361,355,261,94
SULTANBEYLI,FATIH  MAH.,415,378,373,248,125
SULTANBEYLI,FATIH  MAH.,410,362,355,257,98
SULTANBEYLI,FATIH  MAH.,411,371,363,283,80
SULTANBEYLI,FATIH  MAH.,410,369,358,263,95
SULTANBEYLI,FATIH  MAH.,410,380,372,289,83
SULTANBEYLI,FATIH  MAH.,415,378,370,290,80
SULTANBEYLI,FATIH  MAH.,411,393,384,292,92
SULTANBEYLI,FATIH  MAH.,410,370,367,268,99
SULTANBEYLI,FATIH  MAH.,415,369,360,268,92
SULTANBEYLI,HAMIDIYE MAH.,402,364,360,201,159
SULTANBEYLI,HAMIDIYE MAH.,401,350,341,241,100
SULTANBEYLI,HAMIDIYE MAH.,402,346,335,219,116
SULTANBEYLI,HAMIDIYE MAH.,402,366,359,214,145
SULTANBEYLI,HAMIDIYE MAH.,403,365,355,247,108
SULTANBEYLI,HAMIDIYE MAH.,403,343,328,200,128
SULTANBEYLI,HAMIDIYE MAH.,402,368,363,224,139
SULTANBEYLI,HAMIDIYE MAH.,402,362,360,226,134
SULTANBEYLI,HAMIDIYE MAH.,406,366,361,245,116
SULTANBEYLI,HAMIDIYE MAH.,401,364,349,201,148
SULTANBEYLI,HAMIDIYE MAH.,403,362,355,223,132
SULTANBEYLI,HAMIDIYE MAH.,401,368,361,209,152
SULTANBEYLI,HAMIDIYE MAH.,402,363,357,239,118
SULTANBEYLI,HAMIDIYE MAH.,401,349,348,211,137
SULTANBEYLI,HAMIDIYE MAH.,401,360,354,230,124
SULTANBEYLI,HAMIDIYE MAH.,402,368,361,258,103
SULTANBEYLI,HAMIDIYE MAH.,402,368,360,216,144
SULTANBEYLI,HAMIDIYE MAH.,402,366,361,229,132
SULTANBEYLI,HAMIDIYE MAH.,406,359,351,210,141
SULTANBEYLI,HAMIDIYE MAH.,406,333,319,186,133
SULTANBEYLI,HAMIDIYE MAH.,404,366,360,228,132
SULTANBEYLI,HAMIDIYE MAH.,404,359,347,225,122
SULTANBEYLI,HAMIDIYE MAH.,404,363,359,234,125
SULTANBEYLI,HAMIDIYE MAH.,403,373,366,220,146
SULTANBEYLI,HAMIDIYE MAH.,403,356,349,207,142
SULTANBEYLI,HAMIDIYE MAH.,403,357,347,211,136
SULTANBEYLI,HAMIDIYE MAH.,405,361,357,222,135
SULTANBEYLI,HAMIDIYE MAH.,404,360,352,229,123
SULTANBEYLI,HAMIDIYE MAH.,403,357,351,227,124
SULTANBEYLI,HAMIDIYE MAH.,406,374,351,245,106
SULTANBEYLI,HAMIDIYE MAH.,406,357,349,241,108
SULTANBEYLI,HAMIDIYE MAH.,404,365,356,211,145
SULTANBEYLI,HAMIDIYE MAH.,403,360,350,221,129
SULTANBEYLI,HAMIDIYE MAH.,403,362,352,220,132
SULTANBEYLI,HAMIDIYE MAH.,404,358,355,214,141
SULTANBEYLI,HAMIDIYE MAH.,415,370,362,257,105
SULTANBEYLI,HAMIDIYE MAH.,404,364,358,221,137
SULTANBEYLI,HAMIDIYE MAH.,403,354,349,205,144
SULTANBEYLI,HAMIDIYE MAH.,404,357,347,246,101
SULTANBEYLI,HAMIDIYE MAH.,404,363,362,222,140
SULTANBEYLI,HAMIDIYE MAH.,403,369,362,227,135
SULTANBEYLI,HAMIDIYE MAH.,403,360,355,211,144
SULTANBEYLI,HASANPASA MAH.,409,358,348,271,77
SULTANBEYLI,HASANPASA MAH.,407,368,364,276,88
SULTANBEYLI,HASANPASA MAH.,410,370,369,276,93
SULTANBEYLI,HASANPASA MAH.,408,370,366,270,96
SULTANBEYLI,HASANPASA MAH.,408,372,361,257,104
SULTANBEYLI,HASANPASA MAH.,409,365,359,255,104
SULTANBEYLI,HASANPASA MAH.,408,367,362,252,110
SULTANBEYLI,HASANPASA MAH.,407,368,363,279,84
SULTANBEYLI,HASANPASA MAH.,408,370,360,279,81
SULTANBEYLI,HASANPASA MAH.,408,360,358,240,118
SULTANBEYLI,HASANPASA MAH.,408,372,367,274,93
SULTANBEYLI,HASANPASA MAH.,406,350,344,250,94
SULTANBEYLI,HASANPASA MAH.,408,381,379,299,80
SULTANBEYLI,HASANPASA MAH.,407,377,375,264,111
SULTANBEYLI,HASANPASA MAH.,408,350,338,255,83
SULTANBEYLI,HASANPASA MAH.,408,354,346,269,77
SULTANBEYLI,HASANPASA MAH.,415,333,331,246,85
SULTANBEYLI,HASANPASA MAH.,415,373,366,276,90
SULTANBEYLI,HASANPASA MAH.,415,371,363,288,75
SULTANBEYLI,HASANPASA MAH.,415,376,368,279,89
SULTANBEYLI,HASANPASA MAH.,413,368,365,281,84
SULTANBEYLI,HASANPASA MAH.,415,371,369,286,83
SULTANBEYLI,HASANPASA MAH.,412,382,377,285,92
SULTANBEYLI,HASANPASA MAH.,410,384,375,267,108
SULTANBEYLI,HASANPASA MAH.,413,353,344,266,78
SULTANBEYLI,HASANPASA MAH.,410,366,361,268,93
SULTANBEYLI,HASANPASA MAH.,412,374,370,290,80
SULTANBEYLI,HASANPASA MAH.,412,368,362,277,85
SULTANBEYLI,MEHMET AKIF MAH.,410,352,347,276,71
SULTANBEYLI,MEHMET AKIF MAH.,408,328,320,240,80
SULTANBEYLI,MEHMET AKIF MAH.,408,353,346,254,92
SULTANBEYLI,MEHMET AKIF MAH.,409,360,353,266,87
SULTANBEYLI,MEHMET AKIF MAH.,410,352,345,265,80
SULTANBEYLI,MEHMET AKIF MAH.,409,356,352,259,93
SULTANBEYLI,MEHMET AKIF MAH.,408,357,351,255,96
SULTANBEYLI,MEHMET AKIF MAH.,408,356,351,238,113
SULTANBEYLI,MEHMET AKIF MAH.,408,359,355,258,97
SULTANBEYLI,MEHMET AKIF MAH.,407,356,347,252,95
SULTANBEYLI,MEHMET AKIF MAH.,409,370,363,274,89
SULTANBEYLI,MEHMET AKIF MAH.,408,353,351,252,99
SULTANBEYLI,MEHMET AKIF MAH.,409,360,353,284,69
SULTANBEYLI,MEHMET AKIF MAH.,408,357,350,261,89
SULTANBEYLI,MEHMET AKIF MAH.,408,364,355,265,90
SULTANBEYLI,MEHMET AKIF MAH.,408,354,348,270,78
SULTANBEYLI,MEHMET AKIF MAH.,408,335,333,247,86
SULTANBEYLI,MEHMET AKIF MAH.,408,353,349,257,92
SULTANBEYLI,MEHMET AKIF MAH.,409,356,344,271,73
SULTANBEYLI,MEHMET AKIF MAH.,409,359,351,272,79
SULTANBEYLI,MEHMET AKIF MAH.,408,346,343,269,74
SULTANBEYLI,MEHMET AKIF MAH.,409,354,348,283,65
SULTANBEYLI,MEHMET AKIF MAH.,409,344,335,259,76
SULTANBEYLI,MEHMET AKIF MAH.,408,365,360,283,77
SULTANBEYLI,MEHMET AKIF MAH.,410,357,351,270,81
SULTANBEYLI,MEHMET AKIF MAH.,409,372,367,290,77
SULTANBEYLI,MEHMET AKIF MAH.,401,327,319,238,81
SULTANBEYLI,MEHMET AKIF MAH.,399,340,321,243,78
SULTANBEYLI,MEHMET AKIF MAH.,399,339,331,236,95
SULTANBEYLI,MEHMET AKIF MAH.,401,350,341,267,74
SULTANBEYLI,MEHMET AKIF MAH.,400,341,333,249,84
SULTANBEYLI,MEHMET AKIF MAH.,399,345,343,234,109
SULTANBEYLI,MEHMET AKIF MAH.,399,368,357,260,97
SULTANBEYLI,MEHMET AKIF MAH.,399,351,346,252,94
SULTANBEYLI,MEHMET AKIF MAH.,402,352,346,242,104
SULTANBEYLI,MEHMET AKIF MAH.,399,346,341,253,88
SULTANBEYLI,MEHMET AKIF MAH.,399,352,341,245,96
SULTANBEYLI,MEHMET AKIF MAH.,399,345,339,258,81
SULTANBEYLI,MEHMET AKIF MAH.,398,354,347,254,93
SULTANBEYLI,MEHMET AKIF MAH.,399,339,335,257,78
SULTANBEYLI,MEHMET AKIF MAH.,398,362,357,281,76
SULTANBEYLI,MEHMET AKIF MAH.,398,356,354,269,85
SULTANBEYLI,MEHMET AKIF MAH.,399,359,353,252,101
SULTANBEYLI,MEHMET AKIF MAH.,398,352,349,260,89
SULTANBEYLI,MEHMET AKIF MAH.,399,348,338,254,84
SULTANBEYLI,NECIP FAZIL MAH.,414,348,343,232,111
SULTANBEYLI,NECIP FAZIL MAH.,414,354,347,217,130
SULTANBEYLI,NECIP FAZIL MAH.,415,372,358,240,118
SULTANBEYLI,NECIP FAZIL MAH.,415,365,353,232,121
SULTANBEYLI,NECIP FAZIL MAH.,415,355,346,269,77
SULTANBEYLI,NECIP FAZIL MAH.,415,366,357,253,104
SULTANBEYLI,NECIP FAZIL MAH.,414,380,371,247,124
SULTANBEYLI,NECIP FAZIL MAH.,414,367,359,222,137
SULTANBEYLI,NECIP FAZIL MAH.,415,366,357,210,147
SULTANBEYLI,NECIP FAZIL MAH.,414,364,360,222,138
SULTANBEYLI,NECIP FAZIL MAH.,412,382,376,253,123
SULTANBEYLI,NECIP FAZIL MAH.,415,364,350,224,126
SULTANBEYLI,NECIP FAZIL MAH.,415,376,371,253,118
SULTANBEYLI,NECIP FAZIL MAH.,415,364,358,231,127
SULTANBEYLI,NECIP FAZIL MAH.,415,365,359,242,117
SULTANBEYLI,NECIP FAZIL MAH.,414,389,385,289,96
SULTANBEYLI,NECIP FAZIL MAH.,413,375,368,273,95
SULTANBEYLI,NECIP FAZIL MAH.,415,371,367,230,137
SULTANBEYLI,NECIP FAZIL MAH.,412,362,347,224,123
SULTANBEYLI,NECIP FAZIL MAH.,413,374,365,256,109
SULTANBEYLI,NECIP FAZIL MAH.,413,371,365,252,113
SULTANBEYLI,NECIP FAZIL MAH.,414,361,351,227,124
SULTANBEYLI,NECIP FAZIL MAH.,414,387,377,270,107
SULTANBEYLI,NECIP FAZIL MAH.,413,381,369,264,105
SULTANBEYLI,ORHANGAZI MAH.,402,343,331,179,152
SULTANBEYLI,ORHANGAZI MAH.,402,346,335,177,158
SULTANBEYLI,ORHANGAZI MAH.,402,358,354,190,164
SULTANBEYLI,ORHANGAZI MAH.,403,363,353,201,152
SULTANBEYLI,ORHANGAZI MAH.,402,363,355,216,139
SULTANBEYLI,ORHANGAZI MAH.,402,347,336,197,139
SULTANBEYLI,ORHANGAZI MAH.,403,336,331,167,164
SULTANBEYLI,ORHANGAZI MAH.,403,357,345,206,139
SULTANBEYLI,ORHANGAZI MAH.,401,344,332,173,159
SULTANBEYLI,ORHANGAZI MAH.,402,342,336,206,130
SULTANBEYLI,ORHANGAZI MAH.,403,364,359,243,116
SULTANBEYLI,ORHANGAZI MAH.,403,361,354,186,168
SULTANBEYLI,ORHANGAZI MAH.,403,343,339,187,152
SULTANBEYLI,ORHANGAZI MAH.,402,361,354,202,152
SULTANBEYLI,ORHANGAZI MAH.,402,360,353,211,142
SULTANBEYLI,ORHANGAZI MAH.,405,367,356,168,188
SULTANBEYLI,ORHANGAZI MAH.,403,353,346,179,167
SULTANBEYLI,ORHANGAZI MAH.,402,349,343,222,121
SULTANBEYLI,ORHANGAZI MAH.,402,372,366,194,172
SULTANBEYLI,ORHANGAZI MAH.,402,355,347,196,151
SULTANBEYLI,ORHANGAZI MAH.,401,356,351,203,148
SULTANBEYLI,ORHANGAZI MAH.,402,360,353,193,160
SULTANBEYLI,ORHANGAZI MAH.,408,357,351,208,143
SULTANBEYLI,ORHANGAZI MAH.,403,368,354,209,145
SULTANBEYLI,YAVUZ SELIM MAH.,410,359,351,181,170
SULTANBEYLI,YAVUZ SELIM MAH.,415,364,353,156,197
SULTANBEYLI,YAVUZ SELIM MAH.,409,356,350,225,125
SULTANBEYLI,YAVUZ SELIM MAH.,415,378,376,200,176
SULTANBEYLI,YAVUZ SELIM MAH.,409,361,355,206,149
SULTANBEYLI,YAVUZ SELIM MAH.,408,363,357,205,152
SULTANBEYLI,YAVUZ SELIM MAH.,410,354,348,192,156
SULTANBEYLI,YAVUZ SELIM MAH.,409,375,362,201,161
SULTANBEYLI,YAVUZ SELIM MAH.,410,369,357,203,154
SULTANBEYLI,YAVUZ SELIM MAH.,412,376,369,203,166
SULTANBEYLI,YAVUZ SELIM MAH.,409,360,355,206,149
SULTANBEYLI,YAVUZ SELIM MAH.,410,368,361,181,180
SULTANBEYLI,YAVUZ SELIM MAH.,410,359,353,188,165
SULTANBEYLI,YAVUZ SELIM MAH.,410,379,367,206,161
SULTANBEYLI,YAVUZ SELIM MAH.,410,372,364,180,184
SULTANBEYLI,YAVUZ SELIM MAH.,410,374,368,183,185
SULTANBEYLI,YAVUZ SELIM MAH.,410,370,363,192,171
SULTANBEYLI,YAVUZ SELIM MAH.,409,367,360,181,179
SULTANBEYLI,YAVUZ SELIM MAH.,408,370,362,232,130
SULTANBEYLI,YAVUZ SELIM MAH.,409,362,355,176,179
SULTANBEYLI,YAVUZ SELIM MAH.,410,372,361,163,198
SULTANBEYLI,YAVUZ SELIM MAH.,409,368,360,191,169
SULTANBEYLI,YAVUZ SELIM MAH.,409,349,341,186,155
SULTANBEYLI,YAVUZ SELIM MAH.,409,382,376,210,166
SULTANBEYLI,YAVUZ SELIM MAH.,409,365,357,220,137
SULTANBEYLI,YAVUZ SELIM MAH.,409,368,354,200,154
SULTANBEYLI,YAVUZ SELIM MAH.,409,367,360,191,169
SULTANBEYLI,YAVUZ SELIM MAH.,409,382,376,204,172
SULTANBEYLI,YAVUZ SELIM MAH.,408,374,366,201,165
SULTANBEYLI,YAVUZ SELIM MAH.,410,371,361,199,162
SULTANBEYLI,YAVUZ SELIM MAH.,409,361,352,178,174
SULTANBEYLI,ADIL MAH.,410,351,345,266,79
SULTANBEYLI,ADIL MAH.,411,351,337,281,56
SULTANBEYLI,ADIL MAH.,409,381,374,285,89
SULTANBEYLI,ADIL MAH.,415,380,379,284,95
SULTANBEYLI,ADIL MAH.,412,372,361,271,90
SULTANBEYLI,ADIL MAH.,412,358,358,265,93
SULTANBEYLI,ADIL MAH.,412,357,357,256,101
SULTANBEYLI,ADIL MAH.,410,366,358,250,108
SULTANBEYLI,ADIL MAH.,412,371,363,275,88
SULTANBEYLI,ADIL MAH.,415,376,369,269,100
SULTANBEYLI,ADIL MAH.,412,378,369,276,93
SULTANBEYLI,ADIL MAH.,412,377,370,292,78
SULTANBEYLI,ADIL MAH.,410,371,362,280,82
SULTANBEYLI,ADIL MAH.,412,382,377,283,94
SULTANBEYLI,ADIL MAH.,412,372,362,274,88
SULTANBEYLI,ADIL MAH.,415,377,370,268,102
SULTANBEYLI,ADIL MAH.,412,375,370,268,102
SULTANBEYLI,ADIL MAH.,411,372,367,285,82
SULTANBEYLI,ADIL MAH.,411,368,363,271,92
SULTANBEYLI,ADIL MAH.,409,373,364,245,119
SULTANBEYLI,ADIL MAH.,412,359,353,247,106
SULTANBEYLI,ADIL MAH.,412,373,364,262,102
SULTANBEYLI,ADIL MAH.,412,370,360,250,110
SULTANBEYLI,ADIL MAH.,411,357,348,246,102
SULTANBEYLI,ADIL MAH.,411,366,358,249,109
SULTANBEYLI,ADIL MAH.,411,388,383,263,120
SULTANBEYLI,ADIL MAH.,411,375,364,263,101
SULTANBEYLI,ADIL MAH.,411,375,365,265,100
SULTANBEYLI,AHMET YESEVI MAH.,415,335,328,241,87
SULTANBEYLI,AHMET YESEVI MAH.,411,346,335,232,103
SULTANBEYLI,AHMET YESEVI MAH.,411,354,345,267,78
SULTANBEYLI,AHMET YESEVI MAH.,415,381,378,277,101
SULTANBEYLI,AHMET YESEVI MAH.,411,345,338,231,107
SULTANBEYLI,AHMET YESEVI MAH.,411,366,363,261,102
SULTANBEYLI,AHMET YESEVI MAH.,411,346,335,235,100
SULTANBEYLI,AHMET YESEVI MAH.,412,366,359,278,81
SULTANBEYLI,AHMET YESEVI MAH.,410,361,354,254,100
SULTANBEYLI,AHMET YESEVI MAH.,412,378,374,292,82
SULTANBEYLI,AHMET YESEVI MAH.,411,370,365,275,90
SULTANBEYLI,AHMET YESEVI MAH.,410,353,349,267,82
SULTANBEYLI,AHMET YESEVI MAH.,411,347,341,270,71
SULTANBEYLI,AHMET YESEVI MAH.,411,352,349,273,76
SULTANBEYLI,AHMET YESEVI MAH.,410,355,340,295,45
SULTANBEYLI,AHMET YESEVI MAH.,410,365,356,282,74
SULTANBEYLI,AHMET YESEVI MAH.,411,350,346,265,81
SULTANBEYLI,AHMET YESEVI MAH.,410,372,371,305,66
SULTANBEYLI,AHMET YESEVI MAH.,410,369,362,287,75
SULTANBEYLI,AHMET YESEVI MAH.,410,367,357,275,82
SULTANBEYLI,AHMET YESEVI MAH.,411,379,374,289,85
SULTANBEYLI,AHMET YESEVI MAH.,411,358,350,288,62
SULTANBEYLI,AHMET YESEVI MAH.,410,360,344,272,72
SULTANBEYLI,AHMET YESEVI MAH.,411,371,364,256,108
SULTANBEYLI,AHMET YESEVI MAH.,403,329,319,199,120
SULTANBEYLI,AHMET YESEVI MAH.,406,324,315,183,132
SULTANBEYLI,AHMET YESEVI MAH.,405,354,344,225,119
SULTANBEYLI,AHMET YESEVI MAH.,402,356,352,212,140
SULTANBEYLI,AHMET YESEVI MAH.,403,356,348,218,130
SULTANBEYLI,AHMET YESEVI MAH.,403,363,360,231,129
SULTANBEYLI,AHMET YESEVI MAH.,403,359,350,228,122
SULTANBEYLI,AHMET YESEVI MAH.,406,370,365,213,152
SULTANBEYLI,AHMET YESEVI MAH.,402,374,352,244,108
SULTANBEYLI,AHMET YESEVI MAH.,403,358,351,211,140
SULTANBEYLI,AHMET YESEVI MAH.,404,372,369,235,134
SULTANBEYLI,AHMET YESEVI MAH.,406,365,353,239,114
SULTANBEYLI,AHMET YESEVI MAH.,404,347,341,206,135
SULTANBEYLI,AHMET YESEVI MAH.,402,376,367,262,105
SULTANBEYLI,AHMET YESEVI MAH.,402,370,366,244,122
SULTANBEYLI,AHMET YESEVI MAH.,403,361,353,231,122
SULTANBEYLI,AHMET YESEVI MAH.,403,376,373,268,105
SULTANBEYLI,AHMET YESEVI MAH.,403,367,360,250,110
SULTANBEYLI,AHMET YESEVI MAH.,402,348,343,229,114
SULTANBEYLI,AHMET YESEVI MAH.,402,352,345,222,123
SULTANBEYLI,AHMET YESEVI MAH.,402,349,341,202,139
SULTANBEYLI,AHMET YESEVI MAH.,403,364,362,231,131
SULTANBEYLI,AHMET YESEVI MAH.,403,370,363,235,128
SULTANBEYLI,BATTALGAZI MAH.,403,332,316,259,57
SULTANBEYLI,BATTALGAZI MAH.,406,331,319,263,56
SULTANBEYLI,BATTALGAZI MAH.,403,341,337,266,71
SULTANBEYLI,BATTALGAZI MAH.,403,339,331,270,61
SULTANBEYLI,BATTALGAZI MAH.,404,356,346,262,84
SULTANBEYLI,BATTALGAZI MAH.,403,353,348,249,99
SULTANBEYLI,BATTALGAZI MAH.,403,343,334,264,70
SULTANBEYLI,BATTALGAZI MAH.,404,346,341,247,94
SULTANBEYLI,BATTALGAZI MAH.,403,354,348,251,97
SULTANBEYLI,BATTALGAZI MAH.,405,360,350,253,97
SULTANBEYLI,BATTALGAZI MAH.,404,345,336,233,103
SULTANBEYLI,BATTALGAZI MAH.,404,358,352,275,77
SULTANBEYLI,BATTALGAZI MAH.,403,340,335,272,63
SULTANBEYLI,BATTALGAZI MAH.,404,360,355,260,95
SULTANBEYLI,BATTALGAZI MAH.,403,356,354,259,95
SULTANBEYLI,BATTALGAZI MAH.,407,361,357,272,85
SULTANBEYLI,BATTALGAZI MAH.,404,353,347,273,74
SULTANBEYLI,BATTALGAZI MAH.,403,368,360,278,82
SULTANBEYLI,BATTALGAZI MAH.,403,341,337,273,64
SULTANBEYLI,BATTALGAZI MAH.,403,369,364,291,73
SULTANBEYLI,BATTALGAZI MAH.,404,358,352,268,84
SULTANBEYLI,BATTALGAZI MAH.,404,366,357,278,79
SULTANBEYLI,BATTALGAZI MAH.,403,357,353,282,71
SULTANBEYLI,BATTALGAZI MAH.,406,357,350,262,88
SULTANBEYLI,BATTALGAZI MAH.,403,364,362,267,95
SULTANBEYLI,BATTALGAZI MAH.,402,377,370,249,121
SULTANBEYLI,BATTALGAZI MAH.,404,351,348,266,82
SULTANBEYLI,BATTALGAZI MAH.,402,352,347,251,96
SULTANBEYLI,BATTALGAZI MAH.,404,365,356,248,108
SULTANBEYLI,BATTALGAZI MAH.,413,354,343,246,97
SULTANBEYLI,BATTALGAZI MAH.,411,359,341,261,80
SULTANBEYLI,BATTALGAZI MAH.,410,376,374,274,100
SULTANBEYLI,BATTALGAZI MAH.,411,369,363,263,100
SULTANBEYLI,BATTALGAZI MAH.,415,376,370,294,76
SULTANBEYLI,BATTALGAZI MAH.,411,362,353,270,83
SULTANBEYLI,BATTALGAZI MAH.,415,360,346,259,87
SULTANBEYLI,BATTALGAZI MAH.,411,348,342,268,74
SULTANBEYLI,BATTALGAZI MAH.,411,362,356,265,91
SULTANBEYLI,BATTALGAZI MAH.,411,360,353,267,86
SULTANBEYLI,BATTALGAZI MAH.,411,376,373,286,87
SULTANBEYLI,BATTALGAZI MAH.,411,370,360,286,74
SULTANBEYLI,BATTALGAZI MAH.,415,370,362,269,93
SULTANBEYLI,BATTALGAZI MAH.,410,356,345,267,78
SULTANBEYLI,BATTALGAZI MAH.,410,357,348,280,68
SULTANBEYLI,BATTALGAZI MAH.,410,369,367,276,91
SULTANBEYLI,BATTALGAZI MAH.,411,362,351,257,94
SULTANBEYLI,BATTALGAZI MAH.,410,364,362,255,107
SULTANBEYLI,BATTALGAZI MAH.,411,365,355,254,101
SULTANBEYLI,BATTALGAZI MAH.,410,376,367,282,85
SULTANBEYLI,BATTALGAZI MAH.,411,364,362,275,87
SULTANBEYLI,MECIDIYE MAH.,386,334,328,220,108
SULTANBEYLI,MECIDIYE MAH.,385,350,348,258,90
SULTANBEYLI,MECIDIYE MAH.,387,340,328,243,85
SULTANBEYLI,MECIDIYE MAH.,388,348,342,245,97
SULTANBEYLI,MECIDIYE MAH.,386,345,344,231,113
SULTANBEYLI,MECIDIYE MAH.,384,352,344,232,112
SULTANBEYLI,MECIDIYE MAH.,385,345,340,217,123
SULTANBEYLI,MECIDIYE MAH.,385,345,341,253,88
SULTANBEYLI,MECIDIYE MAH.,384,352,348,238,110
SULTANBEYLI,MECIDIYE MAH.,386,353,349,260,89
SULTANBEYLI,MECIDIYE MAH.,385,334,330,227,103
SULTANBEYLI,MECIDIYE MAH.,386,344,342,265,77
SULTANBEYLI,MECIDIYE MAH.,406,355,347,226,121
SULTANBEYLI,MECIDIYE MAH.,406,347,326,274,52
SULTANBEYLI,MECIDIYE MAH.,406,373,366,273,93
SULTANBEYLI,MECIDIYE MAH.,406,358,351,243,108
SULTANBEYLI,MECIDIYE MAH.,407,373,365,292,73
SULTANBEYLI,MECIDIYE MAH.,408,367,363,263,100
SULTANBEYLI,MECIDIYE MAH.,409,376,371,272,99
SULTANBEYLI,MECIDIYE MAH.,408,359,359,259,100
SULTANBEYLI,MECIDIYE MAH.,405,370,363,236,127
SULTANBEYLI,MECIDIYE MAH.,406,362,357,246,111
SULTANBEYLI,MECIDIYE MAH.,405,365,356,240,116
SULTANBEYLI,MECIDIYE MAH.,405,363,363,241,122
SULTANBEYLI,MECIDIYE MAH.,405,376,372,264,108
SULTANBEYLI,MECIDIYE MAH.,410,374,366,270,96
SULTANBEYLI,MECIDIYE MAH.,405,367,359,234,125
SULTANBEYLI,MECIDIYE MAH.,406,358,351,256,95
SULTANBEYLI,MECIDIYE MAH.,405,365,356,250,106
SULTANBEYLI,MECIDIYE MAH.,405,361,353,254,99
SULTANBEYLI,MECIDIYE MAH.,406,373,366,241,125
SULTANBEYLI,MECIDIYE MAH.,406,355,349,234,115
SULTANBEYLI,MECIDIYE MAH.,406,365,357,260,97
SULTANBEYLI,MECIDIYE MAH.,406,371,364,266,98
SULTANBEYLI,MECIDIYE MAH.,406,366,357,274,83
SULTANBEYLI,MECIDIYE MAH.,406,371,368,283,85
SULTANBEYLI,MECIDIYE MAH.,406,365,352,260,92
SULTANBEYLI,MIMAR SINAN MAH.,401,343,336,248,88
SULTANBEYLI,MIMAR SINAN MAH.,401,326,321,243,78
SULTANBEYLI,MIMAR SINAN MAH.,402,360,357,243,114
SULTANBEYLI,MIMAR SINAN MAH.,401,353,351,240,111
SULTANBEYLI,MIMAR SINAN MAH.,401,342,332,228,104
SULTANBEYLI,MIMAR SINAN MAH.,401,360,352,255,97
SULTANBEYLI,MIMAR SINAN MAH.,401,361,352,258,94
SULTANBEYLI,MIMAR SINAN MAH.,402,367,363,255,108
SULTANBEYLI,MIMAR SINAN MAH.,400,374,369,259,110
SULTANBEYLI,MIMAR SINAN MAH.,401,362,358,259,99
SULTANBEYLI,MIMAR SINAN MAH.,400,357,347,241,106
SULTANBEYLI,MIMAR SINAN MAH.,401,369,361,251,110
SULTANBEYLI,MIMAR SINAN MAH.,401,362,355,219,136
SULTANBEYLI,MIMAR SINAN MAH.,401,371,358,258,100
SULTANBEYLI,MIMAR SINAN MAH.,400,349,342,216,126
SULTANBEYLI,MIMAR SINAN MAH.,401,370,364,255,109
SULTANBEYLI,MIMAR SINAN MAH.,400,347,342,246,96
SULTANBEYLI,MIMAR SINAN MAH.,401,360,355,251,104
SULTANBEYLI,MIMAR SINAN MAH.,401,360,356,240,116
SULTANBEYLI,MIMAR SINAN MAH.,400,341,338,230,108
SULTANBEYLI,MIMAR SINAN MAH.,400,363,361,256,105
SULTANBEYLI,MIMAR SINAN MAH.,401,366,361,241,120
SULTANBEYLI,MIMAR SINAN MAH.,401,353,343,241,102
SULTANBEYLI,MIMAR SINAN MAH.,400,362,355,239,116
SULTANBEYLI,MIMAR SINAN MAH.,400,367,360,242,118
SULTANBEYLI,MIMAR SINAN MAH.,401,347,344,241,103
SULTANBEYLI,MIMAR SINAN MAH.,401,362,353,263,90
SULTANBEYLI,MIMAR SINAN MAH.,400,362,354,260,94
SULTANBEYLI,TURGUT REIS MAH.,412,340,328,240,88
SULTANBEYLI,TURGUT REIS MAH.,411,365,358,251,107
SULTANBEYLI,TURGUT REIS MAH.,415,359,349,260,89
SULTANBEYLI,TURGUT REIS MAH.,411,366,363,256,107
SULTANBEYLI,TURGUT REIS MAH.,412,367,365,251,114
SULTANBEYLI,TURGUT REIS MAH.,411,365,361,277,84
SULTANBEYLI,TURGUT REIS MAH.,411,371,365,275,90
SULTANBEYLI,TURGUT REIS MAH.,412,363,356,281,75
SULTANBEYLI,TURGUT REIS MAH.,412,375,372,289,83
SULTANBEYLI,TURGUT REIS MAH.,411,371,367,257,110
SULTANBEYLI,TURGUT REIS MAH.,412,365,362,271,91
SULTANBEYLI,TURGUT REIS MAH.,412,375,363,265,98
SULTANBEYLI,TURGUT REIS MAH.,411,371,365,275,90
SULTANBEYLI,TURGUT REIS MAH.,411,372,368,283,85
SULTANBEYLI,TURGUT REIS MAH.,412,366,357,264,93
SULTANBEYLI,TURGUT REIS MAH.,394,343,337,261,76
SULTANBEYLI,TURGUT REIS MAH.,396,347,342,246,96
SULTANBEYLI,TURGUT REIS MAH.,393,337,333,240,93
SULTANBEYLI,TURGUT REIS MAH.,392,348,346,238,108
SULTANBEYLI,TURGUT REIS MAH.,394,348,342,226,116
SULTANBEYLI,TURGUT REIS MAH.,393,349,341,239,102
SULTANBEYLI,TURGUT REIS MAH.,392,347,336,247,89
SULTANBEYLI,TURGUT REIS MAH.,394,355,349,229,120
SULTANBEYLI,TURGUT REIS MAH.,393,354,350,266,84
SULTANBEYLI,TURGUT REIS MAH.,392,351,343,261,82
SULTANBEYLI,TURGUT REIS MAH.,393,353,348,256,92
SULTANBEYLI,TURGUT REIS MAH.,392,358,352,274,78
SULTANBEYLI,TURGUT REIS MAH.,393,342,337,248,89
SULTANBEYLI,TURGUT REIS MAH.,397,361,356,260,96
SULTANBEYLI,TURGUT REIS MAH.,393,351,345,264,81
SULTANBEYLI,TURGUT REIS MAH.,393,339,335,257,78
SULTANBEYLI,TURGUT REIS MAH.,393,361,359,258,101
SULTANBEYLI,TURGUT REIS MAH.,393,347,340,247,93
CATALCA,AKALAN MAH.,307,270,267,59,208
CATALCA,AKALAN MAH.,309,294,284,64,220
CATALCA,AKALAN MAH.,308,290,289,59,230
CATALCA,ATATURK MAH.,336,308,300,113,187
CATALCA,ATATURK MAH.,336,315,305,132,173
CATALCA,ATATURK MAH.,336,320,316,147,169
CATALCA,AYDINLAR MAH.,360,329,315,232,83
CATALCA,AYDINLAR MAH.,360,334,320,226,94
CATALCA,BAHSAYIS MAH.,288,278,272,134,138
CATALCA,BASAK MAH.,319,298,292,68,224
CATALCA,BELGRAT MAH.,303,273,272,95,177
CATALCA,CELEPKOY MAH.,207,191,190,92,98
CATALCA,CAKIL MAH.,379,330,318,120,198
CATALCA,CAKIL MAH.,377,342,338,111,227
CATALCA,CAKIL MAH.,377,343,335,132,203
CATALCA,CAKIL MAH.,377,348,343,133,210
CATALCA,CAKIL MAH.,377,357,353,149,204
CATALCA,CANAKCA MAH.,408,371,357,193,164
CATALCA,CANAKCA MAH.,408,380,371,155,216
CATALCA,CANAKCA MAH.,408,384,369,198,171
CATALCA,CANAKCA MAH.,408,383,372,188,184
CATALCA,CANAKCA MAH.,408,382,376,172,204
CATALCA,CIFTLIKKOY MAH.,387,343,339,46,293
CATALCA,CIFTLIKKOY MAH.,388,360,356,52,304
CATALCA,CIFTLIKKOY MAH.,387,360,356,51,305
CATALCA,CIFTLIKKOY MAH.,388,359,357,42,315
CATALCA,DAGYENICE MAH.,299,291,287,67,220
CATALCA,DAGYENICE MAH.,299,291,288,104,184
CATALCA,ELBASAN MAH.,246,215,201,49,152
CATALCA,ELBASAN MAH.,246,221,211,57,154
CATALCA,FATIH MAH.,372,344,338,184,154
CATALCA,FATIH MAH.,372,351,342,184,158
CATALCA,FATIH MAH.,373,355,351,182,169
CATALCA,FERHATPASA MAH.,382,316,313,118,195
CATALCA,FERHATPASA MAH.,383,355,353,98,255
CATALCA,FERHATPASA MAH.,384,350,340,136,204
CATALCA,FERHATPASA MAH.,382,355,348,117,231
CATALCA,FERHATPASA MAH.,383,354,347,126,221
CATALCA,FERHATPASA MAH.,381,349,344,130,214
CATALCA,FERHATPASA MAH.,384,363,361,118,243
CATALCA,FERHATPASA MAH.,382,341,337,106,231
CATALCA,FERHATPASA MAH.,382,355,350,119,231
CATALCA,FERHATPASA MAH.,383,361,355,111,244
CATALCA,FERHATPASA MAH.,381,341,338,126,212
CATALCA,FERHATPASA MAH.,381,326,323,136,187
CATALCA,FERHATPASA MAH.,390,311,303,132,171
CATALCA,FERHATPASA MAH.,392,363,360,159,201
CATALCA,FERHATPASA MAH.,391,337,334,177,157
CATALCA,FERHATPASA MAH.,391,351,343,139,204
CATALCA,FERHATPASA MAH.,391,355,337,155,182
CATALCA,FERHATPASA MAH.,391,349,342,155,187
CATALCA,FERHATPASA MAH.,393,354,347,164,183
CATALCA,FERHATPASA MAH.,393,357,349,159,190
CATALCA,FERHATPASA MAH.,392,346,335,151,184
CATALCA,FERHATPASA MAH.,391,354,348,176,172
CATALCA,FERHATPASA MAH.,390,340,335,159,176
CATALCA,FERHATPASA MAH.,391,348,342,161,181
CATALCA,FERHATPASA MAH.,391,351,348,146,202
CATALCA,FERHATPASA MAH.,390,357,352,153,199
CATALCA,FERHATPASA MAH.,390,314,311,83,228
CATALCA,FERHATPASA MAH.,390,351,344,129,215
CATALCA,FERHATPASA MAH.,390,348,342,107,235
CATALCA,FERHATPASA MAH.,390,345,345,137,208
CATALCA,FERHATPASA MAH.,390,357,353,153,200
CATALCA,FERHATPASA MAH.,389,355,351,124,227
CATALCA,FERHATPASA MAH.,389,349,344,115,229
CATALCA,FERHATPASA MAH.,390,346,342,100,242
CATALCA,FERHATPASA MAH.,390,360,352,139,213
CATALCA,FERHATPASA MAH.,389,345,342,124,218
CATALCA,FERHATPASA MAH.,389,354,348,110,238
CATALCA,FERHATPASA MAH.,390,364,358,117,241
CATALCA,FERHATPASA MAH.,389,345,342,107,235
CATALCA,GOKCEALI MAH.,322,293,283,125,158
CATALCA,GOKCEALI MAH.,322,294,286,124,162
CATALCA,GOKCEALI MAH.,322,296,291,93,198
CATALCA,GOKCEALI MAH.,323,309,304,129,175
CATALCA,GUMUSPINAR MAH.,361,324,320,127,193
CATALCA,GUMUSPINAR MAH.,362,328,323,112,211
CATALCA,HALLACLI MAH.,332,296,291,128,163
CATALCA,HALLACLI MAH.,332,309,300,105,195
CATALCA,HALLACLI MAH.,332,304,301,86,215
CATALCA,HISARBEYLI MAH.,313,274,269,112,157
CATALCA,IHSANIYE MAH.,344,306,300,56,244
CATALCA,IHSANIYE MAH.,344,327,324,64,260
CATALCA,IHSANIYE MAH.,344,332,331,56,275
CATALCA,IHSANIYE MAH.,343,330,327,68,259
CATALCA,INCEGIZ MAH.,312,263,254,143,111
CATALCA,INCEGIZ MAH.,314,283,273,135,138
CATALCA,IZZETTIN MAH.,399,360,352,163,189
CATALCA,IZZETTIN MAH.,399,358,356,153,203
CATALCA,KABAKCA MAH.,330,297,292,145,147
CATALCA,KABAKCA MAH.,332,312,301,135,166
CATALCA,KABAKCA MAH.,330,304,300,151,149
CATALCA,KABAKCA MAH.,329,304,302,142,160
CATALCA,KALEICI MAH.,415,369,364,138,226
CATALCA,KALEICI MAH.,415,374,366,162,204
CATALCA,KALEICI MAH.,415,380,379,176,203
CATALCA,KALEICI MAH.,415,381,374,158,216
CATALCA,KALEICI MAH.,416,370,361,164,197
CATALCA,KALEICI MAH.,383,320,307,98,209
CATALCA,KALEICI MAH.,383,347,339,155,184
CATALCA,KALEICI MAH.,387,339,335,150,185
CATALCA,KALEICI MAH.,383,340,339,140,199
CATALCA,KALEICI MAH.,383,341,335,152,183
CATALCA,KALEICI MAH.,383,337,332,150,182
CATALCA,KALEICI MAH.,382,354,350,160,190
CATALCA,KALEICI MAH.,382,341,337,136,201
CATALCA,KALFA MAH.,318,289,283,77,206
CATALCA,KALFA MAH.,318,293,287,69,218
CATALCA,KARACAKOY MERKEZ MAH.,383,333,322,160,162
CATALCA,KARACAKOY MERKEZ MAH.,383,352,345,187,158
CATALCA,KARACAKOY MERKEZ MAH.,382,348,343,171,172
CATALCA,KARACAKOY MERKEZ MAH.,383,344,337,183,154
CATALCA,KARACAKOY MERKEZ MAH.,383,354,341,196,145
CATALCA,KARAMANDERE MAH.,225,208,207,88,119
CATALCA,KARAMANDERE MAH.,226,192,189,77,112
CATALCA,KESTANELIK MAH.,348,304,299,112,187
CATALCA,KESTANELIK MAH.,346,307,298,132,166
CATALCA,KESTANELIK MAH.,347,318,314,139,175
CATALCA,KESTANELIK MAH.,345,313,312,122,190
CATALCA,KESTANELIK MAH.,348,308,305,92,213
CATALCA,KIZILCAALI MAH.,186,174,171,39,132
CATALCA,MURATBEY MERKEZ MAH.,367,332,325,90,235
CATALCA,MURATBEY MERKEZ MAH.,367,347,341,125,216
CATALCA,MURATBEY MERKEZ MAH.,368,349,346,120,226
CATALCA,NAKKAS MAH.,332,303,296,78,218
CATALCA,NAKKAS MAH.,332,313,311,94,217
CATALCA,OKLALI MAH.,325,292,287,174,113
CATALCA,OKLALI MAH.,324,288,278,181,97
CATALCA,OKLALI MAH.,326,286,283,173,110
CATALCA,ORMANLI MAH.,290,233,226,129,97
CATALCA,ORMANLI MAH.,290,260,259,143,116
CATALCA,ORMANLI MAH.,290,275,273,166,107
CATALCA,OVAYENICE MAH.,310,266,259,72,187
CATALCA,OVAYENICE MAH.,311,286,282,90,192
CATALCA,OVAYENICE MAH.,310,287,286,79,207
CATALCA,ORCUNLU MAH.,332,315,314,110,204
CATALCA,ORENCIK MAH.,330,296,287,173,114
CATALCA,ORENCIK MAH.,330,295,289,172,117
CATALCA,SUBASI MAH.,385,341,329,132,197
CATALCA,SUBASI MAH.,387,371,361,161,200
CATALCA,SUBASI MAH.,384,362,352,134,218
CATALCA,YALIKOY MAH.,407,357,346,99,247
CATALCA,YALIKOY MAH.,407,367,364,106,258
CATALCA,YALIKOY MAH.,411,382,375,130,245
CATALCA,YAYLACIK MAH.,56,60,60,3,57
CATALCA,YAZLIK MAH.,303,280,267,127,140
KADIKOY,ACIBADEM MAH.,411,343,338,63,275
KADIKOY,ACIBADEM MAH.,415,382,379,99,280
KADIKOY,ACIBADEM MAH.,415,387,384,66,318
KADIKOY,ACIBADEM MAH.,411,383,379,62,317
KADIKOY,ACIBADEM MAH.,411,390,386,68,318
KADIKOY,ACIBADEM MAH.,411,378,374,69,305
KADIKOY,ACIBADEM MAH.,410,375,366,81,285
KADIKOY,ACIBADEM MAH.,411,387,383,75,308
KADIKOY,ACIBADEM MAH.,412,398,395,79,316
KADIKOY,ACIBADEM MAH.,415,393,392,80,312
KADIKOY,ACIBADEM MAH.,410,340,331,62,269
KADIKOY,ACIBADEM MAH.,410,365,362,71,291
KADIKOY,ACIBADEM MAH.,410,381,373,57,316
KADIKOY,ACIBADEM MAH.,410,397,394,75,319
KADIKOY,ACIBADEM MAH.,415,393,389,62,327
KADIKOY,ACIBADEM MAH.,409,393,388,69,319
KADIKOY,ACIBADEM MAH.,409,371,364,80,284
KADIKOY,ACIBADEM MAH.,409,380,373,72,301
KADIKOY,ACIBADEM MAH.,410,374,370,57,313
KADIKOY,ACIBADEM MAH.,410,375,370,72,298
KADIKOY,ACIBADEM MAH.,388,310,299,69,230
KADIKOY,ACIBADEM MAH.,388,328,314,66,248
KADIKOY,ACIBADEM MAH.,388,350,347,77,270
KADIKOY,ACIBADEM MAH.,388,358,356,76,280
KADIKOY,ACIBADEM MAH.,388,367,364,71,293
KADIKOY,ACIBADEM MAH.,388,349,344,84,260
KADIKOY,ACIBADEM MAH.,389,347,341,83,258
KADIKOY,ACIBADEM MAH.,387,350,345,86,259
KADIKOY,ACIBADEM MAH.,387,357,357,91,266
KADIKOY,ACIBADEM MAH.,387,356,355,86,269
KADIKOY,ACIBADEM MAH.,388,343,339,93,246
KADIKOY,ACIBADEM MAH.,389,334,333,74,259
KADIKOY,ACIBADEM MAH.,391,331,325,57,268
KADIKOY,ACIBADEM MAH.,389,333,329,58,271
KADIKOY,ACIBADEM MAH.,387,366,364,63,301
KADIKOY,ACIBADEM MAH.,388,361,357,63,294
KADIKOY,ACIBADEM MAH.,388,354,348,84,264
KADIKOY,ACIBADEM MAH.,387,359,359,89,270
KADIKOY,ACIBADEM MAH.,388,365,360,84,276
KADIKOY,ACIBADEM MAH.,388,357,350,81,269
KADIKOY,ACIBADEM MAH.,388,351,348,93,255
KADIKOY,ACIBADEM MAH.,388,356,353,48,305
KADIKOY,ACIBADEM MAH.,387,352,347,64,283
KADIKOY,ACIBADEM MAH.,387,366,362,62,300
KADIKOY,ACIBADEM MAH.,381,309,303,66,237
KADIKOY,ACIBADEM MAH.,381,322,315,51,264
KADIKOY,ACIBADEM MAH.,381,354,348,74,274
KADIKOY,ACIBADEM MAH.,381,365,361,76,285
KADIKOY,ACIBADEM MAH.,380,354,347,66,281
KADIKOY,ACIBADEM MAH.,381,352,351,58,293
KADIKOY,ACIBADEM MAH.,380,348,345,51,294
KADIKOY,ACIBADEM MAH.,381,357,356,68,288
KADIKOY,ACIBADEM MAH.,380,348,344,75,269
KADIKOY,ACIBADEM MAH.,381,361,356,62,294
KADIKOY,ACIBADEM MAH.,387,330,325,61,264
KADIKOY,ACIBADEM MAH.,388,346,345,58,287
KADIKOY,ACIBADEM MAH.,388,356,356,53,303
KADIKOY,ACIBADEM MAH.,388,356,353,71,282
KADIKOY,ACIBADEM MAH.,386,371,369,62,307
KADIKOY,ACIBADEM MAH.,387,372,370,63,307
KADIKOY,ACIBADEM MAH.,387,362,357,62,295
KADIKOY,ACIBADEM MAH.,387,351,347,60,287
KADIKOY,ACIBADEM MAH.,387,359,355,78,277
KADIKOY,ACIBADEM MAH.,387,366,358,69,289
KADIKOY,CAFERAGA MAH.,400,335,325,49,276
KADIKOY,CAFERAGA MAH.,399,320,313,37,276
KADIKOY,CAFERAGA MAH.,399,315,312,40,272
KADIKOY,CAFERAGA MAH.,399,378,378,31,347
KADIKOY,CAFERAGA MAH.,399,382,380,39,341
KADIKOY,CAFERAGA MAH.,399,366,360,40,320
KADIKOY,CAFERAGA MAH.,399,368,367,40,327
KADIKOY,CAFERAGA MAH.,399,349,341,23,318
KADIKOY,CAFERAGA MAH.,399,363,361,33,328
KADIKOY,CAFERAGA MAH.,401,368,365,46,319
KADIKOY,CAFERAGA MAH.,399,364,361,37,324
KADIKOY,CAFERAGA MAH.,398,364,360,40,320
KADIKOY,CAFERAGA MAH.,398,367,361,38,323
KADIKOY,CAFERAGA MAH.,399,356,348,51,297
KADIKOY,CAFERAGA MAH.,398,359,354,33,321
KADIKOY,CAFERAGA MAH.,415,335,332,49,283
KADIKOY,CAFERAGA MAH.,415,331,326,33,293
KADIKOY,CAFERAGA MAH.,415,373,367,40,327
KADIKOY,CAFERAGA MAH.,415,377,372,49,323
KADIKOY,CAFERAGA MAH.,415,367,357,47,310
KADIKOY,CAFERAGA MAH.,414,369,363,56,307
KADIKOY,CAFERAGA MAH.,415,372,368,52,316
KADIKOY,CAFERAGA MAH.,415,359,358,49,309
KADIKOY,CAFERAGA MAH.,415,390,385,51,334
KADIKOY,CAFERAGA MAH.,405,317,313,25,288
KADIKOY,CAFERAGA MAH.,406,337,334,29,305
KADIKOY,CAFERAGA MAH.,405,313,311,24,287
KADIKOY,CAFERAGA MAH.,405,324,319,47,272
KADIKOY,CAFERAGA MAH.,405,353,347,44,303
KADIKOY,CAFERAGA MAH.,405,356,352,46,306
KADIKOY,CAFERAGA MAH.,409,372,366,32,334
KADIKOY,CAFERAGA MAH.,405,368,361,34,327
KADIKOY,CAFERAGA MAH.,406,359,348,34,314
KADIKOY,CAFERAGA MAH.,405,365,364,43,321
KADIKOY,CAFERAGA MAH.,406,352,345,37,308
KADIKOY,CAFERAGA MAH.,405,357,355,50,305
KADIKOY,CAFERAGA MAH.,407,382,380,55,325
KADIKOY,CAFERAGA MAH.,405,357,351,42,309
KADIKOY,CAFERAGA MAH.,405,367,361,37,324
KADIKOY,CAFERAGA MAH.,405,371,364,19,345
KADIKOY,CAFERAGA MAH.,405,355,351,30,321
KADIKOY,CAFERAGA MAH.,405,361,354,40,314
KADIKOY,CAFERAGA MAH.,405,365,361,41,320
KADIKOY,CAFERAGA MAH.,408,336,332,31,301
KADIKOY,CAFERAGA MAH.,408,339,336,42,294
KADIKOY,CAFERAGA MAH.,408,375,374,57,317
KADIKOY,CAFERAGA MAH.,409,375,374,26,348
KADIKOY,CAFERAGA MAH.,408,364,359,47,312
KADIKOY,CAFERAGA MAH.,408,372,369,38,331
KADIKOY,CAFERAGA MAH.,408,381,377,37,340
KADIKOY,DUMLUPINAR MAH.,379,332,327,118,209
KADIKOY,DUMLUPINAR MAH.,378,340,335,164,171
KADIKOY,DUMLUPINAR MAH.,376,351,348,132,216
KADIKOY,DUMLUPINAR MAH.,378,344,342,142,200
KADIKOY,DUMLUPINAR MAH.,372,316,311,142,169
KADIKOY,DUMLUPINAR MAH.,369,323,319,165,154
KADIKOY,DUMLUPINAR MAH.,369,338,332,186,146
KADIKOY,DUMLUPINAR MAH.,369,332,325,181,144
KADIKOY,DUMLUPINAR MAH.,368,318,315,150,165
KADIKOY,DUMLUPINAR MAH.,369,328,324,189,135
KADIKOY,DUMLUPINAR MAH.,369,328,324,158,166
KADIKOY,DUMLUPINAR MAH.,369,324,311,175,136
KADIKOY,DUMLUPINAR MAH.,394,325,320,152,168
KADIKOY,DUMLUPINAR MAH.,394,334,329,171,158
KADIKOY,DUMLUPINAR MAH.,395,344,338,193,145
KADIKOY,DUMLUPINAR MAH.,394,333,330,151,179
KADIKOY,DUMLUPINAR MAH.,393,345,336,169,167
KADIKOY,DUMLUPINAR MAH.,393,334,328,193,135
KADIKOY,DUMLUPINAR MAH.,393,341,339,173,166
KADIKOY,DUMLUPINAR MAH.,395,359,355,201,154
KADIKOY,DUMLUPINAR MAH.,394,338,333,158,175
KADIKOY,EGITIM MAH.,387,325,320,65,255
KADIKOY,EGITIM MAH.,387,322,313,84,229
KADIKOY,EGITIM MAH.,387,346,342,108,234
KADIKOY,EGITIM MAH.,388,361,353,77,276
KADIKOY,EGITIM MAH.,387,352,350,76,274
KADIKOY,EGITIM MAH.,387,362,359,88,271
KADIKOY,EGITIM MAH.,387,352,348,107,241
KADIKOY,EGITIM MAH.,387,348,344,92,252
KADIKOY,EGITIM MAH.,386,348,344,86,258
KADIKOY,EGITIM MAH.,386,344,339,98,241
KADIKOY,EGITIM MAH.,386,350,344,96,248
KADIKOY,EGITIM MAH.,389,364,360,103,257
KADIKOY,EGITIM MAH.,415,350,342,152,190
KADIKOY,EGITIM MAH.,415,345,339,144,195
KADIKOY,EGITIM MAH.,415,354,351,179,172
KADIKOY,EGITIM MAH.,415,364,362,143,219
KADIKOY,EGITIM MAH.,412,367,364,139,225
KADIKOY,EGITIM MAH.,415,368,363,128,235
KADIKOY,EGITIM MAH.,415,354,347,157,190
KADIKOY,EGITIM MAH.,415,340,336,142,194
KADIKOY,EGITIM MAH.,415,377,375,167,208
KADIKOY,EGITIM MAH.,415,366,359,159,200
KADIKOY,EGITIM MAH.,415,362,358,163,195
KADIKOY,EGITIM MAH.,415,360,352,162,190
KADIKOY,EGITIM MAH.,415,352,350,144,206
KADIKOY,EGITIM MAH.,415,372,369,177,192
KADIKOY,FIKIRTEPE MAH.,367,271,259,146,113
KADIKOY,FIKIRTEPE MAH.,366,276,274,130,144
KADIKOY,FIKIRTEPE MAH.,369,304,298,155,143
KADIKOY,FIKIRTEPE MAH.,367,297,296,176,120
KADIKOY,FIKIRTEPE MAH.,367,315,313,169,144
KADIKOY,FIKIRTEPE MAH.,367,294,291,165,126
KADIKOY,FIKIRTEPE MAH.,369,299,293,159,134
KADIKOY,FIKIRTEPE MAH.,366,286,282,160,122
KADIKOY,FIKIRTEPE MAH.,404,338,328,210,118
KADIKOY,FIKIRTEPE MAH.,404,352,340,168,172
KADIKOY,FIKIRTEPE MAH.,404,351,347,190,157
KADIKOY,FIKIRTEPE MAH.,404,362,358,187,171
KADIKOY,FIKIRTEPE MAH.,405,339,335,171,164
KADIKOY,FIKIRTEPE MAH.,404,329,326,185,141
KADIKOY,FIKIRTEPE MAH.,403,332,326,161,165
KADIKOY,FIKIRTEPE MAH.,405,342,334,179,155
KADIKOY,FIKIRTEPE MAH.,404,349,344,197,147
KADIKOY,FIKIRTEPE MAH.,404,333,329,187,142
KADIKOY,HASANPASA MAH.,404,331,322,116,206
KADIKOY,HASANPASA MAH.,404,335,328,119,209
KADIKOY,HASANPASA MAH.,404,354,350,98,252
KADIKOY,HASANPASA MAH.,405,355,352,114,238
KADIKOY,HASANPASA MAH.,405,367,363,126,237
KADIKOY,HASANPASA MAH.,405,358,355,134,221
KADIKOY,HASANPASA MAH.,404,359,358,122,236
KADIKOY,HASANPASA MAH.,405,368,365,112,253
KADIKOY,HASANPASA MAH.,405,380,377,110,267
KADIKOY,HASANPASA MAH.,404,359,356,126,230
KADIKOY,HASANPASA MAH.,404,366,363,108,255
KADIKOY,HASANPASA MAH.,405,368,366,100,266
KADIKOY,HASANPASA MAH.,406,362,357,98,259
KADIKOY,HASANPASA MAH.,405,365,365,113,252
KADIKOY,HASANPASA MAH.,392,324,315,103,212
KADIKOY,HASANPASA MAH.,391,335,330,92,238
KADIKOY,HASANPASA MAH.,390,351,350,115,235
KADIKOY,HASANPASA MAH.,391,361,358,116,242
KADIKOY,HASANPASA MAH.,392,350,346,89,257
KADIKOY,HASANPASA MAH.,391,331,323,102,221
KADIKOY,HASANPASA MAH.,391,347,341,101,240
KADIKOY,HASANPASA MAH.,391,348,346,116,230
KADIKOY,HASANPASA MAH.,391,347,343,94,249
KADIKOY,HASANPASA MAH.,391,365,360,103,257
KADIKOY,HASANPASA MAH.,390,348,342,130,212
KADIKOY,HASANPASA MAH.,406,335,326,137,189
KADIKOY,HASANPASA MAH.,408,341,341,109,232
KADIKOY,HASANPASA MAH.,407,345,339,114,225
KADIKOY,HASANPASA MAH.,407,349,345,87,258
KADIKOY,HASANPASA MAH.,407,354,348,85,263
KADIKOY,HASANPASA MAH.,406,354,351,103,248
KADIKOY,HASANPASA MAH.,406,347,342,122,220
KADIKOY,KOSUYOLU MAH.,398,346,341,76,265
KADIKOY,KOSUYOLU MAH.,400,331,327,77,250
KADIKOY,KOSUYOLU MAH.,400,349,343,76,267
KADIKOY,KOSUYOLU MAH.,400,365,359,72,287
KADIKOY,KOSUYOLU MAH.,398,370,365,64,301
KADIKOY,KOSUYOLU MAH.,399,370,365,86,279
KADIKOY,KOSUYOLU MAH.,401,361,358,68,290
KADIKOY,KOSUYOLU MAH.,401,369,366,80,286
KADIKOY,KOSUYOLU MAH.,399,373,369,70,299
KADIKOY,KOSUYOLU MAH.,399,376,372,79,293
KADIKOY,KOSUYOLU MAH.,398,382,378,73,305
KADIKOY,KOSUYOLU MAH.,399,376,376,91,285
KADIKOY,KOSUYOLU MAH.,398,368,363,77,286
KADIKOY,KOSUYOLU MAH.,399,365,363,79,284
KADIKOY,KOSUYOLU MAH.,400,374,369,60,309
KADIKOY,KOSUYOLU MAH.,399,372,368,72,296
KADIKOY,OSMANAGA MAH.,391,286,284,47,237
KADIKOY,OSMANAGA MAH.,391,319,315,50,265
KADIKOY,OSMANAGA MAH.,391,315,315,54,261
KADIKOY,OSMANAGA MAH.,391,332,328,47,281
KADIKOY,OSMANAGA MAH.,392,332,329,47,282
KADIKOY,OSMANAGA MAH.,391,327,325,35,290
KADIKOY,OSMANAGA MAH.,391,327,325,38,287
KADIKOY,OSMANAGA MAH.,402,327,325,47,278
KADIKOY,OSMANAGA MAH.,400,339,332,43,289
KADIKOY,OSMANAGA MAH.,400,360,358,49,309
KADIKOY,OSMANAGA MAH.,400,344,340,47,293
KADIKOY,OSMANAGA MAH.,401,371,364,62,302
KADIKOY,OSMANAGA MAH.,400,358,358,48,310
KADIKOY,OSMANAGA MAH.,401,352,351,53,298
KADIKOY,OSMANAGA MAH.,401,360,353,35,318
KADIKOY,OSMANAGA MAH.,400,346,342,47,295
KADIKOY,OSMANAGA MAH.,401,355,349,49,300
KADIKOY,RASIMPASA MAH.,394,309,304,73,231
KADIKOY,RASIMPASA MAH.,395,324,322,69,253
KADIKOY,RASIMPASA MAH.,395,332,330,64,266
KADIKOY,RASIMPASA MAH.,394,352,349,67,282
KADIKOY,RASIMPASA MAH.,394,346,342,63,279
KADIKOY,RASIMPASA MAH.,393,357,351,74,277
KADIKOY,RASIMPASA MAH.,393,346,341,53,288
KADIKOY,RASIMPASA MAH.,408,335,332,88,244
KADIKOY,RASIMPASA MAH.,408,341,335,94,241
KADIKOY,RASIMPASA MAH.,408,357,351,81,270
KADIKOY,RASIMPASA MAH.,408,363,358,65,293
KADIKOY,RASIMPASA MAH.,407,348,348,72,276
KADIKOY,RASIMPASA MAH.,406,360,356,58,298
KADIKOY,RASIMPASA MAH.,407,357,352,79,273
KADIKOY,RASIMPASA MAH.,408,362,357,67,290
KADIKOY,RASIMPASA MAH.,408,366,364,79,285
KADIKOY,RASIMPASA MAH.,408,367,366,101,265
KADIKOY,RASIMPASA MAH.,408,357,350,75,275
KADIKOY,RASIMPASA MAH.,408,357,354,79,275
KADIKOY,RASIMPASA MAH.,406,369,365,77,288
KADIKOY,RASIMPASA MAH.,382,313,305,77,228
KADIKOY,RASIMPASA MAH.,382,309,307,62,245
KADIKOY,RASIMPASA MAH.,381,329,328,89,239
KADIKOY,RASIMPASA MAH.,381,319,318,76,242
KADIKOY,RASIMPASA MAH.,381,329,322,56,266
KADIKOY,RASIMPASA MAH.,381,325,325,79,246
KADIKOY,RASIMPASA MAH.,383,334,328,79,249
KADIKOY,RASIMPASA MAH.,381,326,322,67,255
KADIKOY,RASIMPASA MAH.,381,306,304,62,242
KADIKOY,ERENKOY MAH.,404,355,354,70,284
KADIKOY,ERENKOY MAH.,403,348,342,90,252
KADIKOY,ERENKOY MAH.,404,351,345,57,288
KADIKOY,ERENKOY MAH.,404,383,382,78,304
KADIKOY,ERENKOY MAH.,404,355,352,81,271
KADIKOY,ERENKOY MAH.,404,376,370,94,276
KADIKOY,ERENKOY MAH.,404,370,369,67,302
KADIKOY,ERENKOY MAH.,405,387,382,75,307
KADIKOY,ERENKOY MAH.,404,377,370,72,298
KADIKOY,ERENKOY MAH.,403,380,376,105,271
KADIKOY,ERENKOY MAH.,403,379,377,80,297
KADIKOY,ERENKOY MAH.,403,381,376,99,277
KADIKOY,ERENKOY MAH.,407,377,373,91,282
KADIKOY,ERENKOY MAH.,403,384,379,101,278
KADIKOY,ERENKOY MAH.,393,344,343,64,279
KADIKOY,ERENKOY MAH.,393,338,335,51,284
KADIKOY,ERENKOY MAH.,394,334,331,73,258
KADIKOY,ERENKOY MAH.,393,359,353,75,278
KADIKOY,ERENKOY MAH.,395,372,366,61,305
KADIKOY,ERENKOY MAH.,393,373,368,84,284
KADIKOY,ERENKOY MAH.,392,369,365,75,290
KADIKOY,ERENKOY MAH.,393,368,366,58,308
KADIKOY,ERENKOY MAH.,393,363,361,66,295
KADIKOY,ERENKOY MAH.,392,356,355,97,258
KADIKOY,ERENKOY MAH.,392,368,363,75,288
KADIKOY,ERENKOY MAH.,393,371,368,74,294
KADIKOY,ERENKOY MAH.,393,358,355,77,278
KADIKOY,ERENKOY MAH.,360,306,305,34,271
KADIKOY,ERENKOY MAH.,359,320,312,59,253
KADIKOY,ERENKOY MAH.,359,332,329,69,260
KADIKOY,ERENKOY MAH.,359,335,334,67,267
KADIKOY,ERENKOY MAH.,359,333,330,68,262
KADIKOY,ERENKOY MAH.,359,337,335,71,264
KADIKOY,ERENKOY MAH.,391,341,336,34,302
KADIKOY,ERENKOY MAH.,390,341,341,24,317
KADIKOY,ERENKOY MAH.,392,337,329,31,298
KADIKOY,ERENKOY MAH.,391,362,357,58,299
KADIKOY,ERENKOY MAH.,390,354,351,63,288
KADIKOY,ERENKOY MAH.,389,367,365,40,325
KADIKOY,ERENKOY MAH.,390,366,362,40,322
KADIKOY,ERENKOY MAH.,391,357,354,44,310
KADIKOY,ERENKOY MAH.,391,374,372,48,324
KADIKOY,ERENKOY MAH.,391,367,364,48,316
KADIKOY,ERENKOY MAH.,390,370,368,55,313
KADIKOY,ERENKOY MAH.,391,355,351,45,306
KADIKOY,ERENKOY MAH.,391,364,361,43,318
KADIKOY,ERENKOY MAH.,391,358,347,41,306
KADIKOY,ERENKOY MAH.,395,341,330,90,240
KADIKOY,ERENKOY MAH.,393,340,332,96,236
KADIKOY,ERENKOY MAH.,395,336,326,81,245
KADIKOY,ERENKOY MAH.,395,346,343,81,262
KADIKOY,ERENKOY MAH.,394,375,373,91,282
KADIKOY,ERENKOY MAH.,394,366,363,113,250
KADIKOY,ERENKOY MAH.,394,374,371,108,263
KADIKOY,ERENKOY MAH.,394,377,375,103,272
KADIKOY,ERENKOY MAH.,393,367,361,98,263
KADIKOY,ERENKOY MAH.,394,376,374,104,270
KADIKOY,ERENKOY MAH.,394,367,365,82,283
KADIKOY,ERENKOY MAH.,394,371,368,114,254
KADIKOY,ERENKOY MAH.,394,375,370,100,270
KADIKOY,ERENKOY MAH.,395,368,367,106,261
KADIKOY,ERENKOY MAH.,393,376,373,120,253
KADIKOY,ERENKOY MAH.,393,376,371,91,280
KADIKOY,ERENKOY MAH.,394,376,372,92,280
KADIKOY,FENERBAHCE MAH.,386,319,312,28,284
KADIKOY,FENERBAHCE MAH.,386,335,332,35,297
KADIKOY,FENERBAHCE MAH.,387,330,324,26,298
KADIKOY,FENERBAHCE MAH.,386,329,326,43,283
KADIKOY,FENERBAHCE MAH.,386,342,339,31,308
KADIKOY,FENERBAHCE MAH.,385,353,349,39,310
KADIKOY,FENERBAHCE MAH.,386,363,361,29,332
KADIKOY,FENERBAHCE MAH.,385,350,348,38,310
KADIKOY,FENERBAHCE MAH.,386,361,359,36,323
KADIKOY,FENERBAHCE MAH.,386,353,351,42,309
KADIKOY,FENERBAHCE MAH.,386,353,350,38,312
KADIKOY,FENERBAHCE MAH.,385,350,348,49,299
KADIKOY,FENERBAHCE MAH.,385,361,360,39,321
KADIKOY,FENERBAHCE MAH.,387,360,359,44,315
KADIKOY,FENERBAHCE MAH.,375,325,321,25,296
KADIKOY,FENERBAHCE MAH.,375,315,309,20,289
KADIKOY,FENERBAHCE MAH.,375,351,345,48,297
KADIKOY,FENERBAHCE MAH.,375,352,349,49,300
KADIKOY,FENERBAHCE MAH.,374,355,350,45,305
KADIKOY,FENERBAHCE MAH.,376,351,347,54,293
KADIKOY,FENERBAHCE MAH.,374,337,332,47,285
KADIKOY,FENERBAHCE MAH.,397,336,329,29,300
KADIKOY,FENERBAHCE MAH.,396,331,327,24,303
KADIKOY,FENERBAHCE MAH.,397,343,341,14,327
KADIKOY,FENERBAHCE MAH.,397,326,324,36,288
KADIKOY,FENERBAHCE MAH.,397,360,358,35,323
KADIKOY,FENERBAHCE MAH.,397,364,359,49,310
KADIKOY,FENERBAHCE MAH.,396,366,362,36,326
KADIKOY,FENERBAHCE MAH.,397,350,346,47,299
KADIKOY,FENERBAHCE MAH.,397,361,358,35,323
KADIKOY,FENERBAHCE MAH.,397,367,363,44,319
KADIKOY,FENERBAHCE MAH.,397,369,366,34,332
KADIKOY,FENERBAHCE MAH.,396,361,359,43,316
KADIKOY,FENERBAHCE MAH.,397,371,367,42,325
KADIKOY,FENERBAHCE MAH.,396,372,371,37,334
KADIKOY,FENERBAHCE MAH.,397,364,358,34,324
KADIKOY,FENERYOLU MAH.,366,292,290,23,267
KADIKOY,FENERYOLU MAH.,367,329,323,35,288
KADIKOY,FENERYOLU MAH.,366,331,328,38,290
KADIKOY,FENERYOLU MAH.,368,348,345,33,312
KADIKOY,FENERYOLU MAH.,366,337,332,36,296
KADIKOY,FENERYOLU MAH.,366,349,344,42,302
KADIKOY,FENERYOLU MAH.,366,335,329,27,302
KADIKOY,FENERYOLU MAH.,368,343,342,53,289
KADIKOY,FENERYOLU MAH.,406,355,351,50,301
KADIKOY,FENERYOLU MAH.,406,352,346,27,319
KADIKOY,FENERYOLU MAH.,407,353,347,41,306
KADIKOY,FENERYOLU MAH.,406,380,375,32,343
KADIKOY,FENERYOLU MAH.,406,389,384,56,328
KADIKOY,FENERYOLU MAH.,406,384,382,35,347
KADIKOY,FENERYOLU MAH.,406,381,380,42,338
KADIKOY,FENERYOLU MAH.,407,377,373,55,318
KADIKOY,FENERYOLU MAH.,406,377,367,30,337
KADIKOY,FENERYOLU MAH.,406,379,375,44,331
KADIKOY,FENERYOLU MAH.,407,388,383,34,349
KADIKOY,FENERYOLU MAH.,406,384,382,40,342
KADIKOY,FENERYOLU MAH.,406,377,371,37,334
KADIKOY,FENERYOLU MAH.,406,384,383,40,343
KADIKOY,FENERYOLU MAH.,408,347,346,36,310
KADIKOY,FENERYOLU MAH.,409,354,351,29,322
KADIKOY,FENERYOLU MAH.,409,348,343,34,309
KADIKOY,FENERYOLU MAH.,409,364,362,27,335
KADIKOY,FENERYOLU MAH.,411,387,386,57,329
KADIKOY,FENERYOLU MAH.,409,369,363,56,307
KADIKOY,FENERYOLU MAH.,409,379,371,65,306
KADIKOY,FENERYOLU MAH.,408,391,384,50,334
KADIKOY,FENERYOLU MAH.,409,384,377,62,315
KADIKOY,FENERYOLU MAH.,407,383,382,43,339
KADIKOY,FENERYOLU MAH.,409,388,385,50,335
KADIKOY,FENERYOLU MAH.,408,389,385,47,338
KADIKOY,FENERYOLU MAH.,407,389,387,51,336
KADIKOY,FENERYOLU MAH.,405,339,332,26,306
KADIKOY,FENERYOLU MAH.,408,358,353,39,314
KADIKOY,FENERYOLU MAH.,405,331,325,37,288
KADIKOY,FENERYOLU MAH.,405,341,336,49,287
KADIKOY,FENERYOLU MAH.,405,376,374,74,300
KADIKOY,FENERYOLU MAH.,405,380,374,68,306
KADIKOY,FENERYOLU MAH.,406,369,368,57,311
KADIKOY,FENERYOLU MAH.,405,370,364,71,293
KADIKOY,FENERYOLU MAH.,408,371,368,76,292
KADIKOY,FENERYOLU MAH.,405,370,367,43,324
KADIKOY,FENERYOLU MAH.,405,383,380,68,312
KADIKOY,FENERYOLU MAH.,405,376,372,60,312
KADIKOY,FENERYOLU MAH.,405,380,380,65,315
KADIKOY,FENERYOLU MAH.,405,387,382,48,334
KADIKOY,FENERYOLU MAH.,407,381,375,64,311
KADIKOY,FENERYOLU MAH.,404,379,372,44,328
KADIKOY,FENERYOLU MAH.,405,371,366,62,304
KADIKOY,GOZTEPE MAH.,415,356,351,31,320
KADIKOY,GOZTEPE MAH.,415,363,359,46,313
KADIKOY,GOZTEPE MAH.,415,366,364,30,334
KADIKOY,GOZTEPE MAH.,415,385,381,40,341
KADIKOY,GOZTEPE MAH.,414,397,395,45,350
KADIKOY,GOZTEPE MAH.,414,387,382,49,333
KADIKOY,GOZTEPE MAH.,412,388,386,28,358
KADIKOY,GOZTEPE MAH.,415,390,386,45,341
KADIKOY,GOZTEPE MAH.,414,382,377,47,330
KADIKOY,GOZTEPE MAH.,414,390,389,36,353
KADIKOY,GOZTEPE MAH.,413,383,380,37,343
KADIKOY,GOZTEPE MAH.,412,382,376,43,333
KADIKOY,GOZTEPE MAH.,414,389,387,42,345
KADIKOY,GOZTEPE MAH.,411,340,328,34,294
KADIKOY,GOZTEPE MAH.,410,358,351,29,322
KADIKOY,GOZTEPE MAH.,408,354,350,56,294
KADIKOY,GOZTEPE MAH.,409,394,391,41,350
KADIKOY,GOZTEPE MAH.,409,377,377,52,325
KADIKOY,GOZTEPE MAH.,409,382,379,47,332
KADIKOY,GOZTEPE MAH.,408,385,382,51,331
KADIKOY,GOZTEPE MAH.,409,380,372,51,321
KADIKOY,GOZTEPE MAH.,410,388,384,45,339
KADIKOY,GOZTEPE MAH.,409,386,381,55,326
KADIKOY,GOZTEPE MAH.,409,378,372,52,320
KADIKOY,GOZTEPE MAH.,390,341,337,45,292
KADIKOY,GOZTEPE MAH.,391,347,346,50,296
KADIKOY,GOZTEPE MAH.,391,345,342,39,303
KADIKOY,GOZTEPE MAH.,391,338,336,40,296
KADIKOY,GOZTEPE MAH.,389,357,351,39,312
KADIKOY,GOZTEPE MAH.,389,365,358,53,305
KADIKOY,GOZTEPE MAH.,391,353,348,53,295
KADIKOY,GOZTEPE MAH.,391,363,358,46,312
KADIKOY,GOZTEPE MAH.,391,359,355,54,301
KADIKOY,GOZTEPE MAH.,391,366,366,57,309
KADIKOY,GOZTEPE MAH.,391,349,344,71,273
KADIKOY,GOZTEPE MAH.,391,376,370,47,323
KADIKOY,GOZTEPE MAH.,390,371,369,44,325
KADIKOY,GOZTEPE MAH.,391,376,372,58,314
KADIKOY,GOZTEPE MAH.,391,368,364,51,313
KADIKOY,GOZTEPE MAH.,407,344,333,42,291
KADIKOY,GOZTEPE MAH.,404,341,338,42,296
KADIKOY,GOZTEPE MAH.,406,366,364,47,317
KADIKOY,GOZTEPE MAH.,406,389,384,50,334
KADIKOY,GOZTEPE MAH.,406,373,365,59,306
KADIKOY,GOZTEPE MAH.,406,385,380,36,344
KADIKOY,GOZTEPE MAH.,405,385,379,50,329
KADIKOY,GOZTEPE MAH.,404,373,368,33,335
KADIKOY,GOZTEPE MAH.,399,345,340,50,290
KADIKOY,GOZTEPE MAH.,399,344,340,44,296
KADIKOY,GOZTEPE MAH.,399,346,340,38,302
KADIKOY,GOZTEPE MAH.,401,370,366,45,321
KADIKOY,GOZTEPE MAH.,399,375,369,39,330
KADIKOY,GOZTEPE MAH.,399,383,379,65,314
KADIKOY,GOZTEPE MAH.,399,371,367,56,311
KADIKOY,GOZTEPE MAH.,399,373,372,60,312
KADIKOY,GOZTEPE MAH.,401,370,367,54,313
KADIKOY,GOZTEPE MAH.,398,384,380,69,311
KADIKOY,GOZTEPE MAH.,398,376,375,41,334
KADIKOY,GOZTEPE MAH.,399,378,375,51,324
KADIKOY,GOZTEPE MAH.,398,374,369,53,316
KADIKOY,GOZTEPE MAH.,398,380,379,45,334
KADIKOY,GOZTEPE MAH.,376,328,323,29,294
KADIKOY,GOZTEPE MAH.,376,312,310,23,287
KADIKOY,GOZTEPE MAH.,376,345,342,22,320
KADIKOY,GOZTEPE MAH.,375,350,348,35,313
KADIKOY,GOZTEPE MAH.,375,358,353,42,311
KADIKOY,GOZTEPE MAH.,375,347,344,36,308
KADIKOY,GOZTEPE MAH.,375,349,345,27,318
KADIKOY,GOZTEPE MAH.,377,365,363,33,330
KADIKOY,GOZTEPE MAH.,375,353,350,30,320
KADIKOY,GOZTEPE MAH.,374,351,349,48,301
KADIKOY,MERDIVENKOY MAH.,404,348,345,101,244
KADIKOY,MERDIVENKOY MAH.,404,351,344,90,254
KADIKOY,MERDIVENKOY MAH.,403,350,346,77,269
KADIKOY,MERDIVENKOY MAH.,404,376,372,120,252
KADIKOY,MERDIVENKOY MAH.,404,374,371,119,252
KADIKOY,MERDIVENKOY MAH.,403,369,365,108,257
KADIKOY,MERDIVENKOY MAH.,405,378,374,111,263
KADIKOY,MERDIVENKOY MAH.,406,370,366,126,240
KADIKOY,MERDIVENKOY MAH.,406,370,368,96,272
KADIKOY,MERDIVENKOY MAH.,403,368,367,99,268
KADIKOY,MERDIVENKOY MAH.,404,365,361,121,240
KADIKOY,MERDIVENKOY MAH.,404,382,373,143,230
KADIKOY,MERDIVENKOY MAH.,404,361,354,88,266
KADIKOY,MERDIVENKOY MAH.,404,378,371,132,239
KADIKOY,MERDIVENKOY MAH.,403,361,358,129,229
KADIKOY,MERDIVENKOY MAH.,404,365,364,126,238
KADIKOY,MERDIVENKOY MAH.,370,304,297,87,210
KADIKOY,MERDIVENKOY MAH.,371,354,350,101,249
KADIKOY,MERDIVENKOY MAH.,371,349,348,88,260
KADIKOY,MERDIVENKOY MAH.,372,351,348,103,245
KADIKOY,MERDIVENKOY MAH.,369,335,332,102,230
KADIKOY,MERDIVENKOY MAH.,369,347,341,78,263
KADIKOY,MERDIVENKOY MAH.,370,332,329,86,243
KADIKOY,MERDIVENKOY MAH.,411,330,324,62,262
KADIKOY,MERDIVENKOY MAH.,411,342,337,67,270
KADIKOY,MERDIVENKOY MAH.,411,349,342,72,270
KADIKOY,MERDIVENKOY MAH.,411,356,352,77,275
KADIKOY,MERDIVENKOY MAH.,411,387,384,76,308
KADIKOY,MERDIVENKOY MAH.,411,388,385,84,301
KADIKOY,MERDIVENKOY MAH.,410,390,389,84,305
KADIKOY,MERDIVENKOY MAH.,410,397,393,59,334
KADIKOY,MERDIVENKOY MAH.,410,387,381,67,314
KADIKOY,MERDIVENKOY MAH.,411,388,384,108,276
KADIKOY,MERDIVENKOY MAH.,411,387,383,77,306
KADIKOY,MERDIVENKOY MAH.,410,382,379,74,305
KADIKOY,MERDIVENKOY MAH.,411,389,381,62,319
KADIKOY,MERDIVENKOY MAH.,411,390,387,84,303
KADIKOY,MERDIVENKOY MAH.,411,383,379,76,303
KADIKOY,MERDIVENKOY MAH.,410,383,378,56,322
KADIKOY,MERDIVENKOY MAH.,410,396,395,80,315
KADIKOY,MERDIVENKOY MAH.,410,345,341,120,221
KADIKOY,MERDIVENKOY MAH.,415,340,330,121,209
KADIKOY,MERDIVENKOY MAH.,415,372,364,160,204
KADIKOY,MERDIVENKOY MAH.,410,366,362,161,201
KADIKOY,MERDIVENKOY MAH.,411,369,362,145,217
KADIKOY,MERDIVENKOY MAH.,415,380,373,157,216
KADIKOY,MERDIVENKOY MAH.,411,383,379,153,226
KADIKOY,MERDIVENKOY MAH.,410,378,375,140,235
KADIKOY,MERDIVENKOY MAH.,410,375,373,145,228
KADIKOY,MERDIVENKOY MAH.,411,366,358,133,225
KADIKOY,MERDIVENKOY MAH.,410,361,356,148,208
KADIKOY,MERDIVENKOY MAH.,411,370,367,132,235
KADIKOY,MERDIVENKOY MAH.,411,371,367,146,221
KADIKOY,MERDIVENKOY MAH.,410,363,356,149,207
KADIKOY,MERDIVENKOY MAH.,408,338,328,60,268
KADIKOY,MERDIVENKOY MAH.,409,343,334,65,269
KADIKOY,MERDIVENKOY MAH.,409,347,345,73,272
KADIKOY,MERDIVENKOY MAH.,409,388,380,76,304
KADIKOY,MERDIVENKOY MAH.,408,380,378,99,279
KADIKOY,MERDIVENKOY MAH.,409,380,376,63,313
KADIKOY,MERDIVENKOY MAH.,409,381,377,60,317
KADIKOY,MERDIVENKOY MAH.,409,380,375,62,313
KADIKOY,MERDIVENKOY MAH.,409,379,375,54,321
KADIKOY,MERDIVENKOY MAH.,409,384,378,80,298
KADIKOY,MERDIVENKOY MAH.,408,372,367,68,299
KADIKOY,MERDIVENKOY MAH.,408,371,364,64,300
KADIKOY,MERDIVENKOY MAH.,408,375,370,84,286
KADIKOY,ZUHTUPASA MAH.,388,329,328,39,289
KADIKOY,ZUHTUPASA MAH.,388,337,334,35,299
KADIKOY,ZUHTUPASA MAH.,387,330,328,24,304
KADIKOY,ZUHTUPASA MAH.,388,352,350,46,304
KADIKOY,ZUHTUPASA MAH.,387,358,355,56,299
KADIKOY,ZUHTUPASA MAH.,387,360,358,45,313
KADIKOY,ZUHTUPASA MAH.,388,361,357,63,294
KADIKOY,ZUHTUPASA MAH.,388,358,352,51,301
KADIKOY,ZUHTUPASA MAH.,388,360,357,53,304
KADIKOY,ZUHTUPASA MAH.,388,354,353,51,302
KADIKOY,ZUHTUPASA MAH.,386,353,346,28,318
KADIKOY,ZUHTUPASA MAH.,388,338,337,52,285
KADIKOY,ZUHTUPASA MAH.,387,357,352,47,305
KADIKOY,ZUHTUPASA MAH.,357,306,304,39,265
KADIKOY,ZUHTUPASA MAH.,357,312,310,23,287
KADIKOY,ZUHTUPASA MAH.,357,328,325,30,295
KADIKOY,ZUHTUPASA MAH.,357,329,329,36,293
KADIKOY,ZUHTUPASA MAH.,357,332,330,32,298
KADIKOY,BOSTANCI MAH.,399,340,335,33,302
KADIKOY,BOSTANCI MAH.,400,352,346,22,324
KADIKOY,BOSTANCI MAH.,401,331,325,28,297
KADIKOY,BOSTANCI MAH.,399,328,326,47,279
KADIKOY,BOSTANCI MAH.,400,360,356,59,297
KADIKOY,BOSTANCI MAH.,399,361,351,62,289
KADIKOY,BOSTANCI MAH.,399,375,374,51,323
KADIKOY,BOSTANCI MAH.,399,377,374,54,320
KADIKOY,BOSTANCI MAH.,398,344,342,50,292
KADIKOY,BOSTANCI MAH.,399,369,366,52,314
KADIKOY,BOSTANCI MAH.,398,364,359,47,312
KADIKOY,BOSTANCI MAH.,398,366,363,52,311
KADIKOY,BOSTANCI MAH.,399,362,355,65,290
KADIKOY,BOSTANCI MAH.,398,372,367,47,320
KADIKOY,BOSTANCI MAH.,399,370,367,47,320
KADIKOY,BOSTANCI MAH.,398,376,373,65,308
KADIKOY,BOSTANCI MAH.,398,360,354,44,310
KADIKOY,BOSTANCI MAH.,399,370,365,38,327
KADIKOY,BOSTANCI MAH.,412,350,338,54,284
KADIKOY,BOSTANCI MAH.,415,356,349,44,305
KADIKOY,BOSTANCI MAH.,415,357,351,48,303
KADIKOY,BOSTANCI MAH.,412,380,375,60,315
KADIKOY,BOSTANCI MAH.,413,385,383,42,341
KADIKOY,BOSTANCI MAH.,413,376,373,46,327
KADIKOY,BOSTANCI MAH.,413,381,375,47,328
KADIKOY,BOSTANCI MAH.,413,390,388,59,329
KADIKOY,BOSTANCI MAH.,413,389,389,56,333
KADIKOY,BOSTANCI MAH.,413,391,388,67,321
KADIKOY,BOSTANCI MAH.,413,383,381,58,323
KADIKOY,BOSTANCI MAH.,413,391,386,39,347
KADIKOY,BOSTANCI MAH.,412,377,374,54,320
KADIKOY,BOSTANCI MAH.,394,337,332,43,289
KADIKOY,BOSTANCI MAH.,395,337,333,51,282
KADIKOY,BOSTANCI MAH.,395,337,331,40,291
KADIKOY,BOSTANCI MAH.,395,345,345,45,300
KADIKOY,BOSTANCI MAH.,395,384,382,64,318
KADIKOY,BOSTANCI MAH.,397,368,363,64,299
KADIKOY,BOSTANCI MAH.,395,379,375,61,314
KADIKOY,BOSTANCI MAH.,395,348,343,47,296
KADIKOY,BOSTANCI MAH.,395,351,349,50,299
KADIKOY,BOSTANCI MAH.,395,373,371,51,320
KADIKOY,BOSTANCI MAH.,398,372,369,62,307
KADIKOY,BOSTANCI MAH.,395,357,355,53,302
KADIKOY,BOSTANCI MAH.,394,373,372,68,304
KADIKOY,BOSTANCI MAH.,395,365,362,56,306
KADIKOY,BOSTANCI MAH.,394,363,363,70,293
KADIKOY,BOSTANCI MAH.,394,369,366,69,297
KADIKOY,BOSTANCI MAH.,406,365,360,54,306
KADIKOY,BOSTANCI MAH.,406,349,343,65,278
KADIKOY,BOSTANCI MAH.,407,359,354,75,279
KADIKOY,BOSTANCI MAH.,409,385,379,83,296
KADIKOY,BOSTANCI MAH.,407,374,372,76,296
KADIKOY,BOSTANCI MAH.,406,373,365,77,288
KADIKOY,BOSTANCI MAH.,405,377,374,75,299
KADIKOY,BOSTANCI MAH.,406,365,362,58,304
KADIKOY,BOSTANCI MAH.,407,393,389,52,337
KADIKOY,BOSTANCI MAH.,407,373,366,64,302
KADIKOY,BOSTANCI MAH.,405,390,387,68,319
KADIKOY,BOSTANCI MAH.,406,374,369,79,290
KADIKOY,BOSTANCI MAH.,407,357,352,57,295
KADIKOY,BOSTANCI MAH.,407,380,377,64,313
KADIKOY,BOSTANCI MAH.,407,371,366,93,273
KADIKOY,BOSTANCI MAH.,407,375,369,61,308
KADIKOY,BOSTANCI MAH.,407,381,374,80,294
KADIKOY,CADDEBOSTAN MAH.,383,327,324,18,306
KADIKOY,CADDEBOSTAN MAH.,383,305,300,28,272
KADIKOY,CADDEBOSTAN MAH.,383,312,309,23,286
KADIKOY,CADDEBOSTAN MAH.,385,353,352,32,320
KADIKOY,CADDEBOSTAN MAH.,383,344,341,48,293
KADIKOY,CADDEBOSTAN MAH.,383,346,340,41,299
KADIKOY,CADDEBOSTAN MAH.,386,347,343,36,307
KADIKOY,CADDEBOSTAN MAH.,383,357,355,44,311
KADIKOY,CADDEBOSTAN MAH.,384,353,349,49,300
KADIKOY,CADDEBOSTAN MAH.,383,348,343,29,314
KADIKOY,CADDEBOSTAN MAH.,383,346,342,38,304
KADIKOY,CADDEBOSTAN MAH.,382,357,355,33,322
KADIKOY,CADDEBOSTAN MAH.,383,359,356,50,306
KADIKOY,CADDEBOSTAN MAH.,403,336,331,25,306
KADIKOY,CADDEBOSTAN MAH.,403,360,355,29,326
KADIKOY,CADDEBOSTAN MAH.,403,340,338,18,320
KADIKOY,CADDEBOSTAN MAH.,403,364,363,39,324
KADIKOY,CADDEBOSTAN MAH.,404,379,377,58,319
KADIKOY,CADDEBOSTAN MAH.,402,379,377,32,345
KADIKOY,CADDEBOSTAN MAH.,403,369,366,55,311
KADIKOY,CADDEBOSTAN MAH.,402,367,364,41,323
KADIKOY,CADDEBOSTAN MAH.,403,365,361,51,310
KADIKOY,CADDEBOSTAN MAH.,403,382,379,59,320
KADIKOY,CADDEBOSTAN MAH.,403,368,364,47,317
KADIKOY,CADDEBOSTAN MAH.,403,363,361,51,310
KADIKOY,CADDEBOSTAN MAH.,409,341,333,21,312
KADIKOY,CADDEBOSTAN MAH.,409,346,342,35,307
KADIKOY,CADDEBOSTAN MAH.,409,353,349,35,314
KADIKOY,CADDEBOSTAN MAH.,409,386,383,38,345
KADIKOY,CADDEBOSTAN MAH.,410,379,369,19,350
KADIKOY,CADDEBOSTAN MAH.,410,377,373,53,320
KADIKOY,CADDEBOSTAN MAH.,411,381,378,54,324
KADIKOY,CADDEBOSTAN MAH.,409,384,382,60,322
KADIKOY,CADDEBOSTAN MAH.,409,384,375,45,330
KADIKOY,CADDEBOSTAN MAH.,410,385,380,39,341
KADIKOY,CADDEBOSTAN MAH.,409,362,352,44,308
KADIKOY,CADDEBOSTAN MAH.,410,374,368,57,311
KADIKOY,KOZYATAGI MAH.,405,350,349,45,304
KADIKOY,KOZYATAGI MAH.,404,354,349,52,297
KADIKOY,KOZYATAGI MAH.,404,350,343,50,293
KADIKOY,KOZYATAGI MAH.,404,333,324,47,277
KADIKOY,KOZYATAGI MAH.,405,349,345,46,299
KADIKOY,KOZYATAGI MAH.,403,375,365,43,322
KADIKOY,KOZYATAGI MAH.,404,376,371,53,318
KADIKOY,KOZYATAGI MAH.,404,384,377,71,306
KADIKOY,KOZYATAGI MAH.,403,381,380,76,304
KADIKOY,KOZYATAGI MAH.,404,379,375,49,326
KADIKOY,KOZYATAGI MAH.,403,382,377,63,314
KADIKOY,KOZYATAGI MAH.,404,385,380,73,307
KADIKOY,KOZYATAGI MAH.,403,370,366,54,312
KADIKOY,KOZYATAGI MAH.,406,384,382,72,310
KADIKOY,KOZYATAGI MAH.,403,373,370,46,324
KADIKOY,KOZYATAGI MAH.,404,380,372,52,320
KADIKOY,KOZYATAGI MAH.,403,390,386,60,326
KADIKOY,KOZYATAGI MAH.,404,394,388,48,340
KADIKOY,KOZYATAGI MAH.,404,376,374,42,332
KADIKOY,KOZYATAGI MAH.,404,374,372,45,327
KADIKOY,KOZYATAGI MAH.,404,387,386,73,313
KADIKOY,KOZYATAGI MAH.,404,365,364,46,318
KADIKOY,KOZYATAGI MAH.,405,376,370,47,323
KADIKOY,KOZYATAGI MAH.,403,382,374,48,326
KADIKOY,KOZYATAGI MAH.,403,377,372,73,299
KADIKOY,KOZYATAGI MAH.,404,379,373,80,293
KADIKOY,KOZYATAGI MAH.,407,394,388,64,324
KADIKOY,KOZYATAGI MAH.,411,367,364,39,325
KADIKOY,KOZYATAGI MAH.,411,367,363,30,333
KADIKOY,KOZYATAGI MAH.,411,381,377,61,316
KADIKOY,KOZYATAGI MAH.,411,386,380,57,323
KADIKOY,KOZYATAGI MAH.,411,393,389,53,336
KADIKOY,KOZYATAGI MAH.,410,396,391,41,350
KADIKOY,KOZYATAGI MAH.,411,387,384,48,336
KADIKOY,KOZYATAGI MAH.,409,381,380,58,322
KADIKOY,KOZYATAGI MAH.,366,337,334,55,279
KADIKOY,KOZYATAGI MAH.,367,330,325,56,269
KADIKOY,KOZYATAGI MAH.,366,345,339,48,291
KADIKOY,KOZYATAGI MAH.,367,345,340,56,284
KADIKOY,KOZYATAGI MAH.,369,342,339,56,283
KADIKOY,KOZYATAGI MAH.,366,346,339,47,292
KADIKOY,KOZYATAGI MAH.,366,336,332,58,274
KADIKOY,KOZYATAGI MAH.,367,347,345,57,288
KADIKOY,KOZYATAGI MAH.,410,362,357,64,293
KADIKOY,KOZYATAGI MAH.,411,348,344,57,287
KADIKOY,KOZYATAGI MAH.,411,365,356,75,281
KADIKOY,KOZYATAGI MAH.,411,381,378,68,310
KADIKOY,KOZYATAGI MAH.,411,388,381,75,306
KADIKOY,KOZYATAGI MAH.,410,383,379,82,297
KADIKOY,KOZYATAGI MAH.,410,386,381,69,312
KADIKOY,KOZYATAGI MAH.,412,392,388,59,329
KADIKOY,KOZYATAGI MAH.,410,392,387,47,340
KADIKOY,KOZYATAGI MAH.,409,398,394,74,320
KADIKOY,KOZYATAGI MAH.,410,380,376,63,313
KADIKOY,KOZYATAGI MAH.,411,395,394,76,318
KADIKOY,KOZYATAGI MAH.,410,386,375,61,314
KADIKOY,KOZYATAGI MAH.,410,377,376,57,319
KADIKOY,KOZYATAGI MAH.,397,340,338,35,303
KADIKOY,KOZYATAGI MAH.,396,338,332,49,283
KADIKOY,KOZYATAGI MAH.,397,366,360,54,306
KADIKOY,KOZYATAGI MAH.,397,371,370,61,309
KADIKOY,KOZYATAGI MAH.,395,362,359,58,301
KADIKOY,KOZYATAGI MAH.,396,369,367,51,316
KADIKOY,KOZYATAGI MAH.,396,365,361,39,322
KADIKOY,KOZYATAGI MAH.,396,363,355,61,294
KADIKOY,KOZYATAGI MAH.,395,369,364,56,308
KADIKOY,KOZYATAGI MAH.,395,359,354,68,286
KADIKOY,KOZYATAGI MAH.,396,363,355,70,285
KADIKOY,KOZYATAGI MAH.,395,363,358,72,286
KADIKOY,SAHRAYICEDIT MAH.,410,344,340,84,256
KADIKOY,SAHRAYICEDIT MAH.,407,361,357,102,255
KADIKOY,SAHRAYICEDIT MAH.,408,377,375,132,243
KADIKOY,SAHRAYICEDIT MAH.,408,377,372,119,253
KADIKOY,SAHRAYICEDIT MAH.,407,373,371,118,253
KADIKOY,SAHRAYICEDIT MAH.,407,382,378,113,265
KADIKOY,SAHRAYICEDIT MAH.,406,375,373,118,255
KADIKOY,SAHRAYICEDIT MAH.,407,375,370,130,240
KADIKOY,SAHRAYICEDIT MAH.,407,376,372,121,251
KADIKOY,SAHRAYICEDIT MAH.,407,375,374,131,243
KADIKOY,SAHRAYICEDIT MAH.,407,372,364,122,242
KADIKOY,SAHRAYICEDIT MAH.,407,383,375,134,241
KADIKOY,SAHRAYICEDIT MAH.,402,348,344,89,255
KADIKOY,SAHRAYICEDIT MAH.,404,342,335,91,244
KADIKOY,SAHRAYICEDIT MAH.,403,360,358,75,283
KADIKOY,SAHRAYICEDIT MAH.,402,384,380,99,281
KADIKOY,SAHRAYICEDIT MAH.,401,384,381,99,282
KADIKOY,SAHRAYICEDIT MAH.,404,377,371,104,267
KADIKOY,SAHRAYICEDIT MAH.,402,386,381,119,262
KADIKOY,SAHRAYICEDIT MAH.,402,376,374,106,268
KADIKOY,SAHRAYICEDIT MAH.,401,368,364,92,272
KADIKOY,SAHRAYICEDIT MAH.,402,376,370,109,261
KADIKOY,SAHRAYICEDIT MAH.,402,370,368,84,284
KADIKOY,SAHRAYICEDIT MAH.,401,381,378,100,278
KADIKOY,SAHRAYICEDIT MAH.,401,389,383,84,299
KADIKOY,SAHRAYICEDIT MAH.,402,384,382,107,275
KADIKOY,SAHRAYICEDIT MAH.,402,377,374,79,295
KADIKOY,SAHRAYICEDIT MAH.,401,373,365,101,264
KADIKOY,SAHRAYICEDIT MAH.,401,380,373,94,279
KADIKOY,SAHRAYICEDIT MAH.,402,387,384,91,293
KADIKOY,SAHRAYICEDIT MAH.,402,362,357,104,253
KADIKOY,SAHRAYICEDIT MAH.,402,380,375,82,293
KADIKOY,SAHRAYICEDIT MAH.,402,379,376,88,288
KADIKOY,SAHRAYICEDIT MAH.,401,344,336,73,263
KADIKOY,SAHRAYICEDIT MAH.,402,333,323,86,237
KADIKOY,SAHRAYICEDIT MAH.,402,365,363,88,275
KADIKOY,SAHRAYICEDIT MAH.,401,378,373,91,282
KADIKOY,SAHRAYICEDIT MAH.,403,373,369,106,263
KADIKOY,SAHRAYICEDIT MAH.,401,363,357,98,259
KADIKOY,SAHRAYICEDIT MAH.,403,365,361,121,240
KADIKOY,SAHRAYICEDIT MAH.,402,382,379,95,284
KADIKOY,SAHRAYICEDIT MAH.,402,366,363,90,273
KADIKOY,SAHRAYICEDIT MAH.,403,385,384,81,303
KADIKOY,SAHRAYICEDIT MAH.,401,374,368,88,280
KADIKOY,SAHRAYICEDIT MAH.,402,355,349,81,268
KADIKOY,SAHRAYICEDIT MAH.,404,348,338,49,289
KADIKOY,SAHRAYICEDIT MAH.,401,342,328,72,256
KADIKOY,SAHRAYICEDIT MAH.,401,360,356,86,270
KADIKOY,SAHRAYICEDIT MAH.,404,379,377,76,301
KADIKOY,SAHRAYICEDIT MAH.,403,388,383,56,327
KADIKOY,SAHRAYICEDIT MAH.,401,368,358,74,284
KADIKOY,SAHRAYICEDIT MAH.,401,380,374,91,283
KADIKOY,SAHRAYICEDIT MAH.,401,383,379,66,313
KADIKOY,SAHRAYICEDIT MAH.,401,384,383,100,283
KADIKOY,SAHRAYICEDIT MAH.,401,378,374,68,306
KADIKOY,SAHRAYICEDIT MAH.,401,371,367,64,303
KADIKOY,SAHRAYICEDIT MAH.,401,375,372,73,299
KADIKOY,SAHRAYICEDIT MAH.,401,378,373,65,308
KADIKOY,SAHRAYICEDIT MAH.,400,374,371,94,277
KADIKOY,SAHRAYICEDIT MAH.,401,385,380,64,316
KADIKOY,SAHRAYICEDIT MAH.,401,361,358,77,281
KADIKOY,SAHRAYICEDIT MAH.,401,366,358,80,278
KADIKOY,SUADIYE MAH.,397,343,342,51,291
KADIKOY,SUADIYE MAH.,397,344,339,25,314
KADIKOY,SUADIYE MAH.,397,368,364,34,330
KADIKOY,SUADIYE MAH.,396,368,364,41,323
KADIKOY,SUADIYE MAH.,397,369,369,52,317
KADIKOY,SUADIYE MAH.,397,377,375,46,329
KADIKOY,SUADIYE MAH.,398,367,365,60,305
KADIKOY,SUADIYE MAH.,391,333,327,30,297
KADIKOY,SUADIYE MAH.,391,335,331,41,290
KADIKOY,SUADIYE MAH.,391,328,324,36,288
KADIKOY,SUADIYE MAH.,391,345,340,63,277
KADIKOY,SUADIYE MAH.,390,359,355,38,317
KADIKOY,SUADIYE MAH.,390,363,359,59,300
KADIKOY,SUADIYE MAH.,390,353,350,56,294
KADIKOY,SUADIYE MAH.,391,357,355,66,289
KADIKOY,SUADIYE MAH.,390,362,355,33,322
KADIKOY,SUADIYE MAH.,396,355,350,46,304
KADIKOY,SUADIYE MAH.,390,357,354,59,295
KADIKOY,SUADIYE MAH.,390,362,355,54,301
KADIKOY,SUADIYE MAH.,392,372,371,45,326
KADIKOY,SUADIYE MAH.,374,322,319,27,292
KADIKOY,SUADIYE MAH.,371,313,310,32,278
KADIKOY,SUADIYE MAH.,370,350,347,40,307
KADIKOY,SUADIYE MAH.,371,330,328,34,294
KADIKOY,SUADIYE MAH.,371,343,340,26,314
KADIKOY,SUADIYE MAH.,370,342,340,53,287
KADIKOY,SUADIYE MAH.,371,338,333,30,303
KADIKOY,SUADIYE MAH.,370,335,331,42,289
KADIKOY,SUADIYE MAH.,370,345,344,40,304
KADIKOY,SUADIYE MAH.,409,358,351,41,310
KADIKOY,SUADIYE MAH.,411,340,334,34,300
KADIKOY,SUADIYE MAH.,410,363,355,46,309
KADIKOY,SUADIYE MAH.,409,345,340,42,298
KADIKOY,SUADIYE MAH.,409,377,374,35,339
KADIKOY,SUADIYE MAH.,409,380,378,32,346
KADIKOY,SUADIYE MAH.,408,381,377,47,330
KADIKOY,SUADIYE MAH.,408,368,366,47,319
KADIKOY,SUADIYE MAH.,408,379,375,65,310
KADIKOY,SUADIYE MAH.,409,384,376,53,323
KADIKOY,SUADIYE MAH.,410,379,374,47,327
KADIKOY,SUADIYE MAH.,408,368,363,39,324
KADIKOY,SUADIYE MAH.,409,378,371,50,321
KADIKOY,SUADIYE MAH.,409,371,367,45,322
KADIKOY,SUADIYE MAH.,409,379,378,38,340
KADIKOY,SUADIYE MAH.,408,385,380,50,330
KADIKOY,19 MAYIS MAH.,403,353,349,48,301
KADIKOY,19 MAYIS MAH.,405,350,341,59,282
KADIKOY,19 MAYIS MAH.,404,370,368,72,296
KADIKOY,19 MAYIS MAH.,404,386,383,65,318
KADIKOY,19 MAYIS MAH.,403,386,382,61,321
KADIKOY,19 MAYIS MAH.,403,383,382,67,315
KADIKOY,19 MAYIS MAH.,405,377,371,58,313
KADIKOY,19 MAYIS MAH.,403,376,370,53,317
KADIKOY,19 MAYIS MAH.,403,380,378,65,313
KADIKOY,19 MAYIS MAH.,403,381,378,68,310
KADIKOY,19 MAYIS MAH.,402,377,373,57,316
KADIKOY,19 MAYIS MAH.,403,383,378,77,301
KADIKOY,19 MAYIS MAH.,403,379,373,55,318
KADIKOY,19 MAYIS MAH.,402,384,382,69,313
KADIKOY,19 MAYIS MAH.,404,377,373,60,313
KADIKOY,19 MAYIS MAH.,397,352,346,40,306
KADIKOY,19 MAYIS MAH.,397,339,339,80,259
KADIKOY,19 MAYIS MAH.,398,349,346,59,287
KADIKOY,19 MAYIS MAH.,397,339,332,72,260
KADIKOY,19 MAYIS MAH.,397,366,361,69,292
KADIKOY,19 MAYIS MAH.,398,377,368,66,302
KADIKOY,19 MAYIS MAH.,397,379,379,68,311
KADIKOY,19 MAYIS MAH.,397,377,370,94,276
KADIKOY,19 MAYIS MAH.,398,366,364,61,303
KADIKOY,19 MAYIS MAH.,397,365,358,54,304
KADIKOY,19 MAYIS MAH.,397,370,366,65,301
KADIKOY,19 MAYIS MAH.,397,359,354,58,296
KADIKOY,19 MAYIS MAH.,396,367,362,66,296
KADIKOY,19 MAYIS MAH.,397,366,355,63,292
KADIKOY,19 MAYIS MAH.,398,372,365,52,313
KADIKOY,19 MAYIS MAH.,398,356,352,80,272
KADIKOY,19 MAYIS MAH.,398,376,373,50,323
KADIKOY,19 MAYIS MAH.,397,366,362,71,291
KADIKOY,19 MAYIS MAH.,396,375,371,61,310
KADIKOY,19 MAYIS MAH.,396,379,377,53,324
KADIKOY,19 MAYIS MAH.,397,376,373,75,298
KADIKOY,19 MAYIS MAH.,396,359,356,47,309
KADIKOY,19 MAYIS MAH.,364,328,323,34,289
KADIKOY,19 MAYIS MAH.,363,351,349,45,304
KADIKOY,19 MAYIS MAH.,363,342,336,46,290
KADIKOY,19 MAYIS MAH.,363,343,341,51,290
KADIKOY,19 MAYIS MAH.,362,346,341,40,301
KADIKOY,19 MAYIS MAH.,389,330,328,58,270
KADIKOY,19 MAYIS MAH.,389,321,315,40,275
KADIKOY,19 MAYIS MAH.,389,348,344,51,293
KADIKOY,19 MAYIS MAH.,389,369,363,64,299
KADIKOY,19 MAYIS MAH.,389,368,367,54,313
KADIKOY,19 MAYIS MAH.,390,368,361,74,287
KADIKOY,19 MAYIS MAH.,391,370,366,47,319
KADIKOY,19 MAYIS MAH.,388,369,366,68,298
KADIKOY,19 MAYIS MAH.,389,361,357,58,299
KADIKOY,19 MAYIS MAH.,392,358,355,82,273
KADIKOY,19 MAYIS MAH.,388,357,356,49,307
KADIKOY,19 MAYIS MAH.,388,372,368,59,309
KADIKOY,19 MAYIS MAH.,390,345,331,42,289
KADIKOY,19 MAYIS MAH.,391,362,358,72,286
KADIKOY,19 MAYIS MAH.,391,372,366,66,300
KADIKOY,19 MAYIS MAH.,391,370,367,53,314
KADIKOY,19 MAYIS MAH.,391,377,372,61,311
KADIKOY,19 MAYIS MAH.,391,352,350,80,270
KADIKOY,19 MAYIS MAH.,390,364,359,59,300
KADIKOY,19 MAYIS MAH.,391,370,367,64,303
BAYRAMPASA,ALTINTEPSI MAH.,390,335,329,211,118
BAYRAMPASA,ALTINTEPSI MAH.,389,335,331,200,131
BAYRAMPASA,ALTINTEPSI MAH.,390,363,359,200,159
BAYRAMPASA,ALTINTEPSI MAH.,390,358,356,203,153
BAYRAMPASA,ALTINTEPSI MAH.,389,362,356,206,150
BAYRAMPASA,ALTINTEPSI MAH.,388,343,337,200,137
BAYRAMPASA,ALTINTEPSI MAH.,394,361,358,191,167
BAYRAMPASA,ALTINTEPSI MAH.,389,337,335,199,136
BAYRAMPASA,ALTINTEPSI MAH.,389,346,340,215,125
BAYRAMPASA,ALTINTEPSI MAH.,389,361,355,196,159
BAYRAMPASA,ALTINTEPSI MAH.,389,367,364,225,139
BAYRAMPASA,ALTINTEPSI MAH.,390,348,343,211,132
BAYRAMPASA,ALTINTEPSI MAH.,388,355,353,211,142
BAYRAMPASA,ALTINTEPSI MAH.,388,364,362,222,140
BAYRAMPASA,ALTINTEPSI MAH.,391,309,301,174,127
BAYRAMPASA,ALTINTEPSI MAH.,389,354,348,177,171
BAYRAMPASA,ALTINTEPSI MAH.,390,363,358,151,207
BAYRAMPASA,ALTINTEPSI MAH.,390,359,352,167,185
BAYRAMPASA,ALTINTEPSI MAH.,389,361,359,181,178
BAYRAMPASA,ALTINTEPSI MAH.,393,354,354,175,179
BAYRAMPASA,ALTINTEPSI MAH.,389,362,354,180,174
BAYRAMPASA,ALTINTEPSI MAH.,389,373,368,179,189
BAYRAMPASA,ALTINTEPSI MAH.,391,344,334,167,167
BAYRAMPASA,ALTINTEPSI MAH.,396,306,306,139,167
BAYRAMPASA,ALTINTEPSI MAH.,393,366,364,178,186
BAYRAMPASA,ALTINTEPSI MAH.,392,339,338,141,197
BAYRAMPASA,ALTINTEPSI MAH.,391,358,357,155,202
BAYRAMPASA,ALTINTEPSI MAH.,391,343,334,154,180
BAYRAMPASA,ALTINTEPSI MAH.,392,359,355,176,179
BAYRAMPASA,ALTINTEPSI MAH.,391,357,354,173,181
BAYRAMPASA,ALTINTEPSI MAH.,392,348,346,153,193
BAYRAMPASA,ALTINTEPSI MAH.,408,335,332,153,179
BAYRAMPASA,ALTINTEPSI MAH.,407,321,317,148,169
BAYRAMPASA,ALTINTEPSI MAH.,407,365,360,193,167
BAYRAMPASA,ALTINTEPSI MAH.,407,384,377,170,207
BAYRAMPASA,ALTINTEPSI MAH.,407,374,371,169,202
BAYRAMPASA,ALTINTEPSI MAH.,408,366,360,174,186
BAYRAMPASA,ALTINTEPSI MAH.,408,376,373,165,208
BAYRAMPASA,ALTINTEPSI MAH.,409,367,364,170,194
BAYRAMPASA,ALTINTEPSI MAH.,406,357,349,167,182
BAYRAMPASA,ALTINTEPSI MAH.,408,355,352,156,196
BAYRAMPASA,ALTINTEPSI MAH.,409,379,374,182,192
BAYRAMPASA,ALTINTEPSI MAH.,406,371,368,154,214
BAYRAMPASA,ALTINTEPSI MAH.,406,364,359,178,181
BAYRAMPASA,ALTINTEPSI MAH.,406,375,371,189,182
BAYRAMPASA,ALTINTEPSI MAH.,406,387,387,198,189
BAYRAMPASA,ALTINTEPSI MAH.,407,380,375,161,214
BAYRAMPASA,ALTINTEPSI MAH.,406,371,368,192,176
BAYRAMPASA,ALTINTEPSI MAH.,407,382,377,187,190
BAYRAMPASA,ALTINTEPSI MAH.,406,372,371,171,200
BAYRAMPASA,ALTINTEPSI MAH.,406,373,368,161,207
BAYRAMPASA,ALTINTEPSI MAH.,407,374,368,189,179
BAYRAMPASA,ISMET PASA MAH.,392,328,325,185,140
BAYRAMPASA,ISMET PASA MAH.,388,333,330,206,124
BAYRAMPASA,ISMET PASA MAH.,389,343,338,189,149
BAYRAMPASA,ISMET PASA MAH.,388,350,346,195,151
BAYRAMPASA,ISMET PASA MAH.,389,364,361,210,151
BAYRAMPASA,ISMET PASA MAH.,388,348,347,215,132
BAYRAMPASA,ISMET PASA MAH.,388,355,349,197,152
BAYRAMPASA,ISMET PASA MAH.,391,348,342,204,138
BAYRAMPASA,ISMET PASA MAH.,389,348,346,188,158
BAYRAMPASA,ISMET PASA MAH.,389,351,346,195,151
BAYRAMPASA,ISMET PASA MAH.,404,341,338,206,132
BAYRAMPASA,ISMET PASA MAH.,401,330,319,142,177
BAYRAMPASA,ISMET PASA MAH.,403,354,352,154,198
BAYRAMPASA,ISMET PASA MAH.,403,368,365,177,188
BAYRAMPASA,ISMET PASA MAH.,402,370,364,172,192
BAYRAMPASA,ISMET PASA MAH.,401,361,358,176,182
BAYRAMPASA,ISMET PASA MAH.,405,365,363,201,162
BAYRAMPASA,ISMET PASA MAH.,401,368,363,212,151
BAYRAMPASA,ISMET PASA MAH.,402,358,353,166,187
BAYRAMPASA,ISMET PASA MAH.,401,369,364,200,164
BAYRAMPASA,ISMET PASA MAH.,402,373,371,205,166
BAYRAMPASA,ISMET PASA MAH.,401,372,369,195,174
BAYRAMPASA,ISMET PASA MAH.,402,365,361,172,189
BAYRAMPASA,ISMET PASA MAH.,402,375,373,194,179
BAYRAMPASA,ISMET PASA MAH.,402,365,363,207,156
BAYRAMPASA,ISMET PASA MAH.,401,369,362,192,170
BAYRAMPASA,ISMET PASA MAH.,401,371,367,174,193
BAYRAMPASA,KOCATEPE MAH.,402,331,322,207,115
BAYRAMPASA,KOCATEPE MAH.,403,347,338,213,125
BAYRAMPASA,KOCATEPE MAH.,403,380,377,230,147
BAYRAMPASA,KOCATEPE MAH.,402,356,351,193,158
BAYRAMPASA,KOCATEPE MAH.,403,356,349,202,147
BAYRAMPASA,KOCATEPE MAH.,403,358,356,226,130
BAYRAMPASA,KOCATEPE MAH.,403,367,365,215,150
BAYRAMPASA,KOCATEPE MAH.,402,362,357,194,163
BAYRAMPASA,KOCATEPE MAH.,403,364,359,202,157
BAYRAMPASA,KOCATEPE MAH.,403,367,365,196,169
BAYRAMPASA,KOCATEPE MAH.,404,371,364,201,163
BAYRAMPASA,KOCATEPE MAH.,403,359,355,206,149
BAYRAMPASA,KOCATEPE MAH.,402,360,358,210,148
BAYRAMPASA,KOCATEPE MAH.,403,364,355,209,146
BAYRAMPASA,KOCATEPE MAH.,403,360,359,219,140
BAYRAMPASA,KOCATEPE MAH.,401,359,354,216,138
BAYRAMPASA,KOCATEPE MAH.,402,359,354,212,142
BAYRAMPASA,KOCATEPE MAH.,403,366,361,205,156
BAYRAMPASA,KOCATEPE MAH.,401,373,366,228,138
BAYRAMPASA,KOCATEPE MAH.,397,334,328,166,162
BAYRAMPASA,KOCATEPE MAH.,399,336,328,199,129
BAYRAMPASA,KOCATEPE MAH.,396,366,360,198,162
BAYRAMPASA,KOCATEPE MAH.,398,367,361,212,149
BAYRAMPASA,KOCATEPE MAH.,396,360,355,212,143
BAYRAMPASA,KOCATEPE MAH.,396,366,359,187,172
BAYRAMPASA,KOCATEPE MAH.,395,356,349,211,138
BAYRAMPASA,KOCATEPE MAH.,396,360,357,209,148
BAYRAMPASA,KOCATEPE MAH.,396,362,356,201,155
BAYRAMPASA,KOCATEPE MAH.,395,369,367,222,145
BAYRAMPASA,KOCATEPE MAH.,396,357,354,198,156
BAYRAMPASA,KOCATEPE MAH.,396,373,369,210,159
BAYRAMPASA,KOCATEPE MAH.,396,367,363,199,164
BAYRAMPASA,KOCATEPE MAH.,395,371,369,232,137
BAYRAMPASA,KOCATEPE MAH.,398,373,370,224,146
BAYRAMPASA,KOCATEPE MAH.,396,364,362,200,162
BAYRAMPASA,KOCATEPE MAH.,396,351,349,190,159
BAYRAMPASA,KOCATEPE MAH.,397,348,344,197,147
BAYRAMPASA,ORTA MAH.,404,332,326,176,150
BAYRAMPASA,ORTA MAH.,404,320,314,149,165
BAYRAMPASA,ORTA MAH.,406,342,338,171,167
BAYRAMPASA,ORTA MAH.,404,364,363,206,157
BAYRAMPASA,ORTA MAH.,405,366,356,216,140
BAYRAMPASA,ORTA MAH.,404,358,355,210,145
BAYRAMPASA,ORTA MAH.,404,367,358,188,170
BAYRAMPASA,ORTA MAH.,403,371,369,171,198
BAYRAMPASA,ORTA MAH.,405,348,341,181,160
BAYRAMPASA,ORTA MAH.,405,362,360,163,197
BAYRAMPASA,ORTA MAH.,404,354,348,187,161
BAYRAMPASA,ORTA MAH.,404,375,365,199,166
BAYRAMPASA,ORTA MAH.,404,371,362,183,179
BAYRAMPASA,ORTA MAH.,403,368,362,184,178
BAYRAMPASA,ORTA MAH.,403,359,357,176,181
BAYRAMPASA,ORTA MAH.,403,354,348,219,129
BAYRAMPASA,ORTA MAH.,403,366,363,196,167
BAYRAMPASA,ORTA MAH.,403,357,353,187,166
BAYRAMPASA,ORTA MAH.,403,360,355,213,142
BAYRAMPASA,ORTA MAH.,390,332,323,186,137
BAYRAMPASA,ORTA MAH.,391,348,341,202,139
BAYRAMPASA,ORTA MAH.,392,360,356,216,140
BAYRAMPASA,ORTA MAH.,391,346,343,223,120
BAYRAMPASA,ORTA MAH.,393,355,341,194,147
BAYRAMPASA,ORTA MAH.,391,348,344,207,137
BAYRAMPASA,ORTA MAH.,391,337,330,214,116
BAYRAMPASA,ORTA MAH.,390,343,334,201,133
BAYRAMPASA,ORTA MAH.,390,342,338,191,147
BAYRAMPASA,TERAZIDERE MAH.,415,343,339,166,173
BAYRAMPASA,TERAZIDERE MAH.,411,384,377,189,188
BAYRAMPASA,TERAZIDERE MAH.,411,357,350,177,173
BAYRAMPASA,TERAZIDERE MAH.,411,373,365,178,187
BAYRAMPASA,TERAZIDERE MAH.,411,375,372,206,166
BAYRAMPASA,TERAZIDERE MAH.,410,374,374,206,168
BAYRAMPASA,TERAZIDERE MAH.,411,373,364,174,190
BAYRAMPASA,TERAZIDERE MAH.,411,369,365,180,185
BAYRAMPASA,TERAZIDERE MAH.,409,368,366,203,163
BAYRAMPASA,TERAZIDERE MAH.,396,327,320,174,146
BAYRAMPASA,TERAZIDERE MAH.,396,322,317,131,186
BAYRAMPASA,TERAZIDERE MAH.,397,365,352,154,198
BAYRAMPASA,TERAZIDERE MAH.,396,359,355,150,205
BAYRAMPASA,TERAZIDERE MAH.,395,369,364,198,166
BAYRAMPASA,TERAZIDERE MAH.,395,359,356,191,165
BAYRAMPASA,TERAZIDERE MAH.,395,363,359,180,179
BAYRAMPASA,TERAZIDERE MAH.,397,372,368,196,172
BAYRAMPASA,TERAZIDERE MAH.,396,352,349,171,178
BAYRAMPASA,TERAZIDERE MAH.,396,366,359,158,201
BAYRAMPASA,TERAZIDERE MAH.,396,351,348,185,163
BAYRAMPASA,TERAZIDERE MAH.,396,366,362,191,171
BAYRAMPASA,TERAZIDERE MAH.,395,357,352,197,155
BAYRAMPASA,TERAZIDERE MAH.,395,366,357,194,163
BAYRAMPASA,TERAZIDERE MAH.,395,368,365,194,171
BAYRAMPASA,TERAZIDERE MAH.,395,363,356,173,183
BAYRAMPASA,TERAZIDERE MAH.,396,358,354,196,158
BAYRAMPASA,TERAZIDERE MAH.,396,351,348,147,201
BAYRAMPASA,TERAZIDERE MAH.,396,376,370,150,220
BAYRAMPASA,TERAZIDERE MAH.,395,364,361,189,172
BAYRAMPASA,VATAN MAH.,395,309,303,140,163
BAYRAMPASA,VATAN MAH.,395,313,307,171,136
BAYRAMPASA,VATAN MAH.,396,348,346,176,170
BAYRAMPASA,VATAN MAH.,399,359,357,175,182
BAYRAMPASA,VATAN MAH.,396,351,344,164,180
BAYRAMPASA,VATAN MAH.,394,359,352,203,149
BAYRAMPASA,VATAN MAH.,395,364,353,182,171
BAYRAMPASA,VATAN MAH.,394,345,332,171,161
BAYRAMPASA,VATAN MAH.,396,345,342,188,154
BAYRAMPASA,VATAN MAH.,395,360,356,171,185
BAYRAMPASA,VATAN MAH.,395,352,349,184,165
BAYRAMPASA,VATAN MAH.,395,351,345,204,141
BAYRAMPASA,VATAN MAH.,395,346,343,168,175
BAYRAMPASA,VATAN MAH.,395,347,341,158,183
BAYRAMPASA,VATAN MAH.,394,350,347,175,172
BAYRAMPASA,VATAN MAH.,395,347,344,159,185
BAYRAMPASA,VATAN MAH.,394,356,350,166,184
BAYRAMPASA,VATAN MAH.,395,354,352,160,192
BAYRAMPASA,VATAN MAH.,395,342,333,174,159
BAYRAMPASA,YENIDOGAN MAH.,400,328,322,161,161
BAYRAMPASA,YENIDOGAN MAH.,404,337,330,191,139
BAYRAMPASA,YENIDOGAN MAH.,401,352,350,187,163
BAYRAMPASA,YENIDOGAN MAH.,401,370,365,218,147
BAYRAMPASA,YENIDOGAN MAH.,401,353,349,207,142
BAYRAMPASA,YENIDOGAN MAH.,402,355,353,180,173
BAYRAMPASA,YENIDOGAN MAH.,401,366,362,197,165
BAYRAMPASA,YENIDOGAN MAH.,405,371,366,163,203
BAYRAMPASA,YENIDOGAN MAH.,401,357,351,166,185
BAYRAMPASA,YENIDOGAN MAH.,400,366,363,179,184
BAYRAMPASA,YENIDOGAN MAH.,401,353,350,167,183
BAYRAMPASA,YENIDOGAN MAH.,401,357,353,177,176
BAYRAMPASA,YENIDOGAN MAH.,402,353,348,205,143
BAYRAMPASA,YENIDOGAN MAH.,401,361,360,193,167
BAYRAMPASA,YENIDOGAN MAH.,401,351,349,179,170
BAYRAMPASA,YENIDOGAN MAH.,400,361,356,175,181
BAYRAMPASA,YENIDOGAN MAH.,410,329,324,158,166
BAYRAMPASA,YENIDOGAN MAH.,410,312,308,142,166
BAYRAMPASA,YENIDOGAN MAH.,410,362,355,169,186
BAYRAMPASA,YENIDOGAN MAH.,410,368,367,198,169
BAYRAMPASA,YENIDOGAN MAH.,415,353,345,168,177
BAYRAMPASA,YENIDOGAN MAH.,410,369,365,186,179
BAYRAMPASA,YENIDOGAN MAH.,411,363,357,175,182
BAYRAMPASA,YENIDOGAN MAH.,409,367,364,203,161
BAYRAMPASA,YENIDOGAN MAH.,411,377,373,200,173
BAYRAMPASA,YENIDOGAN MAH.,412,379,375,185,190
BAYRAMPASA,YENIDOGAN MAH.,410,376,369,219,150
BAYRAMPASA,YENIDOGAN MAH.,410,375,373,185,188
BAYRAMPASA,YENIDOGAN MAH.,409,375,367,171,196
BAYRAMPASA,YENIDOGAN MAH.,410,365,360,182,178
BAYRAMPASA,YENIDOGAN MAH.,410,371,365,197,168
BAYRAMPASA,YENIDOGAN MAH.,411,362,359,175,184
BAYRAMPASA,YENIDOGAN MAH.,410,383,378,194,184
BAYRAMPASA,YENIDOGAN MAH.,409,367,364,191,173
BAYRAMPASA,CEVATPASA MAH.,396,309,304,158,146
BAYRAMPASA,CEVATPASA MAH.,396,358,352,206,146
BAYRAMPASA,CEVATPASA MAH.,396,350,344,202,142
BAYRAMPASA,CEVATPASA MAH.,395,353,345,223,122
BAYRAMPASA,CEVATPASA MAH.,395,345,342,221,121
BAYRAMPASA,CEVATPASA MAH.,396,358,358,203,155
BAYRAMPASA,CEVATPASA MAH.,395,352,349,199,150
BAYRAMPASA,CEVATPASA MAH.,396,360,357,176,181
BAYRAMPASA,CEVATPASA MAH.,395,353,351,226,125
BAYRAMPASA,CEVATPASA MAH.,396,359,355,202,153
BAYRAMPASA,CEVATPASA MAH.,395,359,353,190,163
BAYRAMPASA,CEVATPASA MAH.,396,354,353,200,153
BAYRAMPASA,CEVATPASA MAH.,396,366,364,221,143
BAYRAMPASA,CEVATPASA MAH.,396,359,353,204,149
BAYRAMPASA,CEVATPASA MAH.,400,342,331,193,138
BAYRAMPASA,CEVATPASA MAH.,402,349,344,202,142
BAYRAMPASA,CEVATPASA MAH.,401,360,357,225,132
BAYRAMPASA,CEVATPASA MAH.,401,382,376,234,142
BAYRAMPASA,CEVATPASA MAH.,401,370,365,217,148
BAYRAMPASA,CEVATPASA MAH.,401,370,364,204,160
BAYRAMPASA,CEVATPASA MAH.,401,366,361,222,139
BAYRAMPASA,CEVATPASA MAH.,401,361,356,202,154
BAYRAMPASA,CEVATPASA MAH.,401,379,368,244,124
BAYRAMPASA,CEVATPASA MAH.,400,367,361,224,137
BAYRAMPASA,CEVATPASA MAH.,401,362,355,240,115
BAYRAMPASA,CEVATPASA MAH.,402,354,344,219,125
BAYRAMPASA,CEVATPASA MAH.,403,363,361,218,143
BAYRAMPASA,CEVATPASA MAH.,401,367,360,228,132
BAYRAMPASA,CEVATPASA MAH.,401,363,357,220,137
BAYRAMPASA,CEVATPASA MAH.,400,368,363,230,133
BAYRAMPASA,CEVATPASA MAH.,401,364,360,231,129
BAYRAMPASA,CEVATPASA MAH.,401,367,363,230,133
BAYRAMPASA,CEVATPASA MAH.,401,367,360,229,131
BAYRAMPASA,CEVATPASA MAH.,401,365,354,225,129
BAYRAMPASA,KARTALTEPE MAH.,388,315,311,171,140
BAYRAMPASA,KARTALTEPE MAH.,388,330,326,174,152
BAYRAMPASA,KARTALTEPE MAH.,388,354,351,179,172
BAYRAMPASA,KARTALTEPE MAH.,389,352,349,179,170
BAYRAMPASA,KARTALTEPE MAH.,391,363,358,200,158
BAYRAMPASA,KARTALTEPE MAH.,390,355,353,180,173
BAYRAMPASA,KARTALTEPE MAH.,389,357,354,183,171
BAYRAMPASA,KARTALTEPE MAH.,389,357,350,186,164
BAYRAMPASA,KARTALTEPE MAH.,388,361,354,153,201
BAYRAMPASA,KARTALTEPE MAH.,388,350,346,175,171
BAYRAMPASA,KARTALTEPE MAH.,388,352,348,186,162
BAYRAMPASA,KARTALTEPE MAH.,390,360,355,177,178
BAYRAMPASA,KARTALTEPE MAH.,388,352,346,153,193
BAYRAMPASA,KARTALTEPE MAH.,389,356,353,200,153
BAYRAMPASA,KARTALTEPE MAH.,389,357,355,186,169
BAYRAMPASA,KARTALTEPE MAH.,415,335,329,179,150
BAYRAMPASA,KARTALTEPE MAH.,415,353,345,204,141
BAYRAMPASA,KARTALTEPE MAH.,412,352,341,173,168
BAYRAMPASA,KARTALTEPE MAH.,415,383,369,222,147
BAYRAMPASA,KARTALTEPE MAH.,412,377,371,206,165
BAYRAMPASA,KARTALTEPE MAH.,411,375,368,192,176
BAYRAMPASA,KARTALTEPE MAH.,412,391,387,211,176
BAYRAMPASA,KARTALTEPE MAH.,412,383,382,220,162
BAYRAMPASA,KARTALTEPE MAH.,412,377,370,193,177
BAYRAMPASA,KARTALTEPE MAH.,412,380,375,193,182
BAYRAMPASA,KARTALTEPE MAH.,412,381,375,206,169
BAYRAMPASA,KARTALTEPE MAH.,410,373,359,202,157
BAYRAMPASA,KARTALTEPE MAH.,411,372,368,234,134
BAYRAMPASA,KARTALTEPE MAH.,412,380,375,215,160
BAYRAMPASA,KARTALTEPE MAH.,411,381,377,208,169
BAYRAMPASA,KARTALTEPE MAH.,411,375,373,237,136
BAYRAMPASA,KARTALTEPE MAH.,412,368,365,210,155
BAYRAMPASA,KARTALTEPE MAH.,412,373,369,188,181
BAYRAMPASA,KARTALTEPE MAH.,412,383,372,203,169
BAYRAMPASA,KARTALTEPE MAH.,411,369,364,220,144
BAYRAMPASA,KARTALTEPE MAH.,412,381,375,221,154
BAYRAMPASA,KARTALTEPE MAH.,411,382,375,229,146
BAYRAMPASA,KARTALTEPE MAH.,412,363,360,183,177
BAYRAMPASA,KARTALTEPE MAH.,411,375,375,229,146
BAYRAMPASA,KARTALTEPE MAH.,410,367,365,189,176
BAYRAMPASA,KARTALTEPE MAH.,410,366,362,187,175
BAYRAMPASA,KARTALTEPE MAH.,412,384,381,214,167
BAYRAMPASA,KARTALTEPE MAH.,411,366,362,220,142
BAYRAMPASA,KARTALTEPE MAH.,410,371,366,209,157
BAYRAMPASA,KARTALTEPE MAH.,412,373,371,227,144
BAYRAMPASA,KARTALTEPE MAH.,415,349,340,191,149
BAYRAMPASA,KARTALTEPE MAH.,412,316,311,158,153
BAYRAMPASA,KARTALTEPE MAH.,410,340,335,168,167
BAYRAMPASA,KARTALTEPE MAH.,415,337,331,174,157
BAYRAMPASA,KARTALTEPE MAH.,415,382,375,223,152
BAYRAMPASA,KARTALTEPE MAH.,415,373,369,213,156
BAYRAMPASA,KARTALTEPE MAH.,415,378,374,203,171
BAYRAMPASA,KARTALTEPE MAH.,415,380,371,195,176
BAYRAMPASA,KARTALTEPE MAH.,415,359,353,172,181
BAYRAMPASA,KARTALTEPE MAH.,414,382,376,188,188
BAYRAMPASA,KARTALTEPE MAH.,410,367,365,200,165
BAYRAMPASA,KARTALTEPE MAH.,414,365,358,187,171
BAYRAMPASA,KARTALTEPE MAH.,415,379,374,209,165
BAYRAMPASA,KARTALTEPE MAH.,414,377,372,204,168
BAYRAMPASA,KARTALTEPE MAH.,415,376,370,177,193
BAYRAMPASA,KARTALTEPE MAH.,413,362,355,157,198
BAYRAMPASA,KARTALTEPE MAH.,411,379,374,214,160
BAYRAMPASA,KARTALTEPE MAH.,414,370,361,163,198
BAYRAMPASA,KARTALTEPE MAH.,413,373,366,177,189
BAYRAMPASA,KARTALTEPE MAH.,413,376,369,198,171
BAYRAMPASA,KARTALTEPE MAH.,414,371,367,176,191
BAYRAMPASA,KARTALTEPE MAH.,413,373,373,204,169
BAYRAMPASA,KARTALTEPE MAH.,413,376,372,220,152
BAYRAMPASA,KARTALTEPE MAH.,414,366,366,185,181
BAYRAMPASA,KARTALTEPE MAH.,414,378,369,177,192
BAYRAMPASA,KARTALTEPE MAH.,413,377,376,193,183
BAYRAMPASA,KARTALTEPE MAH.,414,376,373,205,168
BAYRAMPASA,KARTALTEPE MAH.,414,360,356,197,159
BAYRAMPASA,KARTALTEPE MAH.,412,370,365,213,152
BAYRAMPASA,KARTALTEPE MAH.,413,370,364,217,147
BAYRAMPASA,KARTALTEPE MAH.,414,365,362,195,167
BAYRAMPASA,KARTALTEPE MAH.,412,374,368,210,158
BAYRAMPASA,KARTALTEPE MAH.,413,377,373,210,163
BAYRAMPASA,KARTALTEPE MAH.,413,384,380,191,189
BAYRAMPASA,KARTALTEPE MAH.,414,372,365,199,166
BAYRAMPASA,MURATPASA MAH.,407,337,333,179,154
BAYRAMPASA,MURATPASA MAH.,404,322,316,179,137
BAYRAMPASA,MURATPASA MAH.,405,350,341,198,143
BAYRAMPASA,MURATPASA MAH.,407,358,356,230,126
BAYRAMPASA,MURATPASA MAH.,405,376,373,232,141
BAYRAMPASA,MURATPASA MAH.,404,366,365,211,154
BAYRAMPASA,MURATPASA MAH.,404,374,371,215,156
BAYRAMPASA,MURATPASA MAH.,404,387,385,228,157
BAYRAMPASA,MURATPASA MAH.,404,373,367,218,149
BAYRAMPASA,MURATPASA MAH.,404,375,374,212,162
BAYRAMPASA,MURATPASA MAH.,404,364,360,194,166
BAYRAMPASA,MURATPASA MAH.,404,370,366,200,166
BAYRAMPASA,MURATPASA MAH.,404,365,360,183,177
BAYRAMPASA,MURATPASA MAH.,404,368,363,196,167
BAYRAMPASA,MURATPASA MAH.,403,377,374,232,142
BAYRAMPASA,MURATPASA MAH.,403,368,361,205,156
BAYRAMPASA,MURATPASA MAH.,405,371,370,216,154
BAYRAMPASA,MURATPASA MAH.,404,382,380,225,155
BAYRAMPASA,MURATPASA MAH.,403,373,366,219,147
BAYRAMPASA,MURATPASA MAH.,404,365,361,180,181
BAYRAMPASA,MURATPASA MAH.,404,360,353,203,150
BAYRAMPASA,MURATPASA MAH.,403,356,353,220,133
BAYRAMPASA,MURATPASA MAH.,404,364,357,203,154
BAYRAMPASA,MURATPASA MAH.,404,368,361,213,148
BAYRAMPASA,MURATPASA MAH.,407,363,358,205,153
BAYRAMPASA,MURATPASA MAH.,403,363,360,212,148
BAYRAMPASA,MURATPASA MAH.,403,355,347,190,157
BAYRAMPASA,MURATPASA MAH.,404,378,377,232,145
BAYRAMPASA,MURATPASA MAH.,403,325,319,191,128
BAYRAMPASA,MURATPASA MAH.,404,332,329,180,149
BAYRAMPASA,MURATPASA MAH.,405,361,355,230,125
BAYRAMPASA,MURATPASA MAH.,404,372,369,206,163
BAYRAMPASA,MURATPASA MAH.,404,371,370,236,134
BAYRAMPASA,MURATPASA MAH.,405,366,360,211,149
BAYRAMPASA,MURATPASA MAH.,405,366,358,205,153
BAYRAMPASA,MURATPASA MAH.,405,361,359,228,131
BAYRAMPASA,MURATPASA MAH.,404,368,361,232,129
BAYRAMPASA,MURATPASA MAH.,405,362,359,231,128
BAYRAMPASA,MURATPASA MAH.,403,364,357,210,147
BAYRAMPASA,MURATPASA MAH.,405,360,354,225,129
BAYRAMPASA,MURATPASA MAH.,404,350,348,225,123
BAYRAMPASA,MURATPASA MAH.,405,369,361,204,157
BAYRAMPASA,MURATPASA MAH.,404,359,356,216,140
BAYRAMPASA,MURATPASA MAH.,406,368,357,221,136
BAYRAMPASA,MURATPASA MAH.,404,368,364,208,156
BAYRAMPASA,MURATPASA MAH.,405,369,361,217,144
BAYRAMPASA,MURATPASA MAH.,403,376,372,206,166
BAYRAMPASA,MURATPASA MAH.,404,374,368,216,152
BAYRAMPASA,MURATPASA MAH.,404,360,359,217,142
BAYRAMPASA,MURATPASA MAH.,414,327,317,202,115
BAYRAMPASA,MURATPASA MAH.,414,339,335,224,111
BAYRAMPASA,MURATPASA MAH.,415,377,373,237,136
BAYRAMPASA,MURATPASA MAH.,413,374,370,227,143
BAYRAMPASA,MURATPASA MAH.,413,377,373,229,144
BAYRAMPASA,MURATPASA MAH.,413,375,369,215,154
BAYRAMPASA,MURATPASA MAH.,413,376,371,207,164
BAYRAMPASA,MURATPASA MAH.,413,368,364,215,149
BAYRAMPASA,MURATPASA MAH.,413,382,376,225,151
BAYRAMPASA,MURATPASA MAH.,414,378,369,230,139
BAYRAMPASA,MURATPASA MAH.,414,385,380,215,165
BAYRAMPASA,MURATPASA MAH.,414,374,370,230,140
BAYRAMPASA,MURATPASA MAH.,413,374,369,227,142
BAYRAMPASA,MURATPASA MAH.,413,362,355,211,144
BAYRAMPASA,YILDIRIM MAH.,388,317,314,96,218
BAYRAMPASA,YILDIRIM MAH.,387,317,310,114,196
BAYRAMPASA,YILDIRIM MAH.,388,355,352,125,227
BAYRAMPASA,YILDIRIM MAH.,387,361,356,140,216
BAYRAMPASA,YILDIRIM MAH.,388,346,344,127,217
BAYRAMPASA,YILDIRIM MAH.,388,368,366,152,214
BAYRAMPASA,YILDIRIM MAH.,387,343,338,128,210
BAYRAMPASA,YILDIRIM MAH.,388,355,347,106,241
BAYRAMPASA,YILDIRIM MAH.,388,363,359,147,212
BAYRAMPASA,YILDIRIM MAH.,387,357,352,131,221
BAYRAMPASA,YILDIRIM MAH.,388,360,356,145,211
BAYRAMPASA,YILDIRIM MAH.,388,368,364,103,261
BAYRAMPASA,YILDIRIM MAH.,387,355,353,138,215
BAYRAMPASA,YILDIRIM MAH.,387,349,346,133,213
BAYRAMPASA,YILDIRIM MAH.,396,329,326,140,186
BAYRAMPASA,YILDIRIM MAH.,395,330,329,100,229
BAYRAMPASA,YILDIRIM MAH.,398,356,353,162,191
BAYRAMPASA,YILDIRIM MAH.,395,367,365,155,210
BAYRAMPASA,YILDIRIM MAH.,394,358,352,130,222
BAYRAMPASA,YILDIRIM MAH.,394,363,360,141,219
BAYRAMPASA,YILDIRIM MAH.,395,355,353,148,205
BAYRAMPASA,YILDIRIM MAH.,394,364,364,153,211
BAYRAMPASA,YILDIRIM MAH.,395,348,338,150,188
BAYRAMPASA,YILDIRIM MAH.,395,359,355,133,222
BAYRAMPASA,YILDIRIM MAH.,394,358,354,135,219
BAYRAMPASA,YILDIRIM MAH.,394,369,366,127,239
BAYRAMPASA,YILDIRIM MAH.,395,356,351,131,220
BAYRAMPASA,YILDIRIM MAH.,397,360,357,148,209
BAYRAMPASA,YILDIRIM MAH.,402,341,333,183,150
BAYRAMPASA,YILDIRIM MAH.,403,330,326,184,142
BAYRAMPASA,YILDIRIM MAH.,403,362,357,178,179
BAYRAMPASA,YILDIRIM MAH.,404,368,361,170,191
BAYRAMPASA,YILDIRIM MAH.,403,374,366,200,166
BAYRAMPASA,YILDIRIM MAH.,402,365,358,220,138
BAYRAMPASA,YILDIRIM MAH.,403,375,367,198,169
BAYRAMPASA,YILDIRIM MAH.,402,368,364,215,149
BAYRAMPASA,YILDIRIM MAH.,403,371,367,198,169
BAYRAMPASA,YILDIRIM MAH.,402,369,367,202,165
BAYRAMPASA,YILDIRIM MAH.,402,369,367,206,161
BAYRAMPASA,YILDIRIM MAH.,404,376,374,205,169
BAYRAMPASA,YILDIRIM MAH.,403,371,368,210,158
BAYRAMPASA,YILDIRIM MAH.,403,372,368,206,162
BAYRAMPASA,YILDIRIM MAH.,404,355,349,207,142
BAYRAMPASA,YILDIRIM MAH.,403,365,360,193,167
BAYRAMPASA,YILDIRIM MAH.,402,365,361,200,161
BAYRAMPASA,YILDIRIM MAH.,405,362,356,216,140
BAYRAMPASA,YILDIRIM MAH.,403,376,375,198,177
BAYRAMPASA,YILDIRIM MAH.,403,353,345,176,169
BAYRAMPASA,YILDIRIM MAH.,403,371,365,213,152
BAYRAMPASA,YILDIRIM MAH.,406,336,329,132,197
BAYRAMPASA,YILDIRIM MAH.,405,337,335,139,196
BAYRAMPASA,YILDIRIM MAH.,405,352,347,125,222
BAYRAMPASA,YILDIRIM MAH.,405,377,375,159,216
BAYRAMPASA,YILDIRIM MAH.,406,365,361,146,215
BAYRAMPASA,YILDIRIM MAH.,405,370,369,159,210
BAYRAMPASA,YILDIRIM MAH.,409,375,369,160,209
BAYRAMPASA,YILDIRIM MAH.,406,377,366,148,218
BAYRAMPASA,YILDIRIM MAH.,405,371,366,170,196
BAYRAMPASA,YILDIRIM MAH.,404,364,362,163,199
BAYRAMPASA,YILDIRIM MAH.,405,369,368,157,211
BAYRAMPASA,YILDIRIM MAH.,405,379,377,152,225
BAYRAMPASA,YILDIRIM MAH.,404,373,369,148,221
BAYRAMPASA,YILDIRIM MAH.,404,371,366,173,193
BAYRAMPASA,YILDIRIM MAH.,404,365,365,136,229
BAYRAMPASA,YILDIRIM MAH.,405,368,366,165,201
BAYRAMPASA,YILDIRIM MAH.,395,326,316,111,205
BAYRAMPASA,YILDIRIM MAH.,394,347,339,119,220
BAYRAMPASA,YILDIRIM MAH.,395,352,349,150,199
BAYRAMPASA,YILDIRIM MAH.,395,355,349,161,188
BAYRAMPASA,YILDIRIM MAH.,395,353,347,148,199
BAYRAMPASA,YILDIRIM MAH.,394,361,359,146,213
BAYRAMPASA,YILDIRIM MAH.,395,351,339,150,189
BAYRAMPASA,YILDIRIM MAH.,393,357,355,176,179
BAYRAMPASA,YILDIRIM MAH.,395,353,351,146,205
BAYRAMPASA,YILDIRIM MAH.,395,349,343,131,212
BAYRAMPASA,YILDIRIM MAH.,396,349,346,141,205
BAYRAMPASA,YILDIRIM MAH.,393,361,359,159,200
BAYRAMPASA,YILDIRIM MAH.,395,364,359,162,197
BAYRAMPASA,YILDIRIM MAH.,395,329,326,159,167
BAYRAMPASA,YILDIRIM MAH.,393,347,343,167,176
BAYRAMPASA,YILDIRIM MAH.,394,355,351,196,155
BAYRAMPASA,YILDIRIM MAH.,393,356,355,178,177
BAYRAMPASA,YILDIRIM MAH.,393,362,353,178,175
BAYRAMPASA,YILDIRIM MAH.,394,366,359,193,166
BAYRAMPASA,YILDIRIM MAH.,393,360,354,198,156
BAYRAMPASA,YILDIRIM MAH.,394,361,359,188,171
BAYRAMPASA,YILDIRIM MAH.,394,365,364,175,189
BAYRAMPASA,YILDIRIM MAH.,393,357,347,194,153
BAYRAMPASA,YILDIRIM MAH.,395,360,344,170,174
BAYRAMPASA,YILDIRIM MAH.,393,368,365,212,153
BAYRAMPASA,YILDIRIM MAH.,394,367,365,172,193
BAYRAMPASA,YILDIRIM MAH.,394,359,358,190,168
BAYRAMPASA,YILDIRIM MAH.,395,364,362,196,166
BAYRAMPASA,YILDIRIM MAH.,393,352,345,181,164
BAYRAMPASA,YILDIRIM MAH.,394,353,346,208,138
BAYRAMPASA,YILDIRIM MAH.,398,367,362,194,168
CEKMEKOY,ALEMDAG MAH.,392,323,315,168,147
CEKMEKOY,ALEMDAG MAH.,394,349,346,163,183
CEKMEKOY,ALEMDAG MAH.,391,349,344,166,178
CEKMEKOY,ALEMDAG MAH.,391,349,346,177,169
CEKMEKOY,ALEMDAG MAH.,391,347,342,159,183
CEKMEKOY,ALEMDAG MAH.,391,356,345,167,178
CEKMEKOY,ALEMDAG MAH.,392,363,356,199,157
CEKMEKOY,ALEMDAG MAH.,392,348,345,197,148
CEKMEKOY,ALEMDAG MAH.,392,354,350,171,179
CEKMEKOY,ALEMDAG MAH.,392,362,357,176,181
CEKMEKOY,AYDINLAR MAH.,411,356,347,110,237
CEKMEKOY,AYDINLAR MAH.,411,360,355,168,187
CEKMEKOY,AYDINLAR MAH.,411,366,365,162,203
CEKMEKOY,AYDINLAR MAH.,411,380,375,159,216
CEKMEKOY,AYDINLAR MAH.,415,368,364,134,230
CEKMEKOY,AYDINLAR MAH.,411,385,384,171,213
CEKMEKOY,AYDINLAR MAH.,415,380,378,166,212
CEKMEKOY,AYDINLAR MAH.,411,369,367,157,210
CEKMEKOY,AYDINLAR MAH.,411,360,351,164,187
CEKMEKOY,AYDINLAR MAH.,411,381,377,143,234
CEKMEKOY,AYDINLAR MAH.,411,362,362,161,201
CEKMEKOY,AYDINLAR MAH.,415,379,376,169,207
CEKMEKOY,AYDINLAR MAH.,411,372,361,158,203
CEKMEKOY,AYDINLAR MAH.,411,369,366,164,202
CEKMEKOY,AYDINLAR MAH.,412,383,377,162,215
CEKMEKOY,AYDINLAR MAH.,412,363,356,149,207
CEKMEKOY,AYDINLAR MAH.,411,375,366,144,222
CEKMEKOY,AYDINLAR MAH.,410,376,374,183,191
CEKMEKOY,AYDINLAR MAH.,411,381,372,168,204
CEKMEKOY,AYDINLAR MAH.,411,378,373,165,208
CEKMEKOY,AYDINLAR MAH.,410,369,364,183,181
CEKMEKOY,AYDINLAR MAH.,410,378,368,163,205
CEKMEKOY,AYDINLAR MAH.,410,364,360,160,200
CEKMEKOY,AYDINLAR MAH.,410,370,358,185,173
CEKMEKOY,AYDINLAR MAH.,410,360,355,163,192
CEKMEKOY,AYDINLAR MAH.,411,365,358,177,181
CEKMEKOY,CUMHURIYET MAH.,399,350,344,175,169
CEKMEKOY,CUMHURIYET MAH.,399,357,349,201,148
CEKMEKOY,CUMHURIYET MAH.,398,364,355,177,178
CEKMEKOY,CUMHURIYET MAH.,401,369,361,192,169
CEKMEKOY,CUMHURIYET MAH.,399,350,344,189,155
CEKMEKOY,CUMHURIYET MAH.,399,351,347,188,159
CEKMEKOY,CUMHURIYET MAH.,398,349,347,181,166
CEKMEKOY,CUMHURIYET MAH.,403,354,345,165,180
CEKMEKOY,CUMHURIYET MAH.,401,363,358,208,150
CEKMEKOY,CUMHURIYET MAH.,405,357,352,197,155
CEKMEKOY,CUMHURIYET MAH.,400,367,360,169,191
CEKMEKOY,CUMHURIYET MAH.,400,358,351,206,145
CEKMEKOY,CUMHURIYET MAH.,401,347,339,179,160
CEKMEKOY,CUMHURIYET MAH.,402,352,345,177,168
CEKMEKOY,CUMHURIYET MAH.,401,366,358,208,150
CEKMEKOY,CUMHURIYET MAH.,401,344,336,176,160
CEKMEKOY,CUMHURIYET MAH.,401,340,332,190,142
CEKMEKOY,CUMHURIYET MAH.,399,351,346,198,148
CEKMEKOY,CUMHURIYET MAH.,399,362,353,188,165
CEKMEKOY,CUMHURIYET MAH.,400,364,358,191,167
CEKMEKOY,CAMLIK MAH.,382,331,323,166,157
CEKMEKOY,CAMLIK MAH.,386,340,337,174,163
CEKMEKOY,CAMLIK MAH.,386,358,352,199,153
CEKMEKOY,CAMLIK MAH.,383,358,348,185,163
CEKMEKOY,CAMLIK MAH.,386,362,359,174,185
CEKMEKOY,CAMLIK MAH.,382,358,354,156,198
CEKMEKOY,CAMLIK MAH.,385,353,349,176,173
CEKMEKOY,CAMLIK MAH.,382,344,342,183,159
CEKMEKOY,CAMLIK MAH.,382,361,359,210,149
CEKMEKOY,CAMLIK MAH.,382,346,343,191,152
CEKMEKOY,CAMLIK MAH.,383,342,341,200,141
CEKMEKOY,CAMLIK MAH.,382,338,336,201,135
CEKMEKOY,CAMLIK MAH.,415,359,355,180,175
CEKMEKOY,CAMLIK MAH.,414,361,354,202,152
CEKMEKOY,CAMLIK MAH.,415,375,364,214,150
CEKMEKOY,CAMLIK MAH.,415,390,382,197,185
CEKMEKOY,CAMLIK MAH.,415,379,375,173,202
CEKMEKOY,CAMLIK MAH.,415,379,377,191,186
CEKMEKOY,CAMLIK MAH.,414,381,375,200,175
CEKMEKOY,CAMLIK MAH.,411,372,369,204,165
CEKMEKOY,CAMLIK MAH.,415,368,365,195,170
CEKMEKOY,CAMLIK MAH.,415,383,374,220,154
CEKMEKOY,CAMLIK MAH.,411,382,377,200,177
CEKMEKOY,CAMLIK MAH.,414,374,370,187,183
CEKMEKOY,CAMLIK MAH.,415,371,366,189,177
CEKMEKOY,CAMLIK MAH.,415,356,353,172,181
CEKMEKOY,CAMLIK MAH.,415,380,377,211,166
CEKMEKOY,CAMLIK MAH.,415,370,363,160,203
CEKMEKOY,CAMLIK MAH.,414,373,365,199,166
CEKMEKOY,CAMLIK MAH.,413,372,366,187,179
CEKMEKOY,CAMLIK MAH.,411,366,363,201,162
CEKMEKOY,CAMLIK MAH.,414,379,370,189,181
CEKMEKOY,CAMLIK MAH.,414,374,367,193,174
CEKMEKOY,CAMLIK MAH.,413,361,359,190,169
CEKMEKOY,CAMLIK MAH.,413,375,371,212,159
CEKMEKOY,CAMLIK MAH.,414,384,372,171,201
CEKMEKOY,CATALMESE MAH.,401,337,329,215,114
CEKMEKOY,CATALMESE MAH.,402,364,358,230,128
CEKMEKOY,CATALMESE MAH.,403,372,365,215,150
CEKMEKOY,CATALMESE MAH.,401,374,365,220,145
CEKMEKOY,CATALMESE MAH.,401,363,355,234,121
CEKMEKOY,CATALMESE MAH.,401,369,367,239,128
CEKMEKOY,CATALMESE MAH.,401,370,365,225,140
CEKMEKOY,CATALMESE MAH.,401,359,355,215,140
CEKMEKOY,CATALMESE MAH.,401,354,350,209,141
CEKMEKOY,CATALMESE MAH.,401,355,346,210,136
CEKMEKOY,CATALMESE MAH.,402,363,361,238,123
CEKMEKOY,CATALMESE MAH.,401,366,362,224,138
CEKMEKOY,CATALMESE MAH.,401,355,348,230,118
CEKMEKOY,EKSIOGLU MAH.,387,329,323,238,85
CEKMEKOY,EKSIOGLU MAH.,387,352,348,237,111
CEKMEKOY,EKSIOGLU MAH.,387,355,351,270,81
CEKMEKOY,EKSIOGLU MAH.,388,351,341,232,109
CEKMEKOY,EKSIOGLU MAH.,386,336,336,231,105
CEKMEKOY,EKSIOGLU MAH.,387,355,350,252,98
CEKMEKOY,EKSIOGLU MAH.,386,356,349,257,92
CEKMEKOY,EKSIOGLU MAH.,387,350,346,233,113
CEKMEKOY,EKSIOGLU MAH.,388,338,333,226,107
CEKMEKOY,EKSIOGLU MAH.,387,331,327,222,105
CEKMEKOY,EKSIOGLU MAH.,389,344,337,202,135
CEKMEKOY,EKSIOGLU MAH.,388,345,339,234,105
CEKMEKOY,EKSIOGLU MAH.,386,339,332,244,88
CEKMEKOY,GUNGOREN MAH.,375,333,322,180,142
CEKMEKOY,GUNGOREN MAH.,375,328,324,202,122
CEKMEKOY,GUNGOREN MAH.,374,350,343,206,137
CEKMEKOY,GUNGOREN MAH.,375,340,336,202,134
CEKMEKOY,GUNGOREN MAH.,375,348,339,184,155
CEKMEKOY,GUNGOREN MAH.,374,338,336,185,151
CEKMEKOY,GUNGOREN MAH.,374,332,331,214,117
CEKMEKOY,GUNGOREN MAH.,380,346,345,216,129
CEKMEKOY,GUNGOREN MAH.,375,344,336,222,114
CEKMEKOY,GUNGOREN MAH.,394,353,347,232,115
CEKMEKOY,GUNGOREN MAH.,394,351,345,232,113
CEKMEKOY,GUNGOREN MAH.,394,345,334,227,107
CEKMEKOY,GUNGOREN MAH.,395,366,362,241,121
CEKMEKOY,GUNGOREN MAH.,396,357,350,214,136
CEKMEKOY,HAMIDIYE MAH.,408,346,340,128,212
CEKMEKOY,HAMIDIYE MAH.,409,379,369,170,199
CEKMEKOY,HAMIDIYE MAH.,408,378,374,158,216
CEKMEKOY,HAMIDIYE MAH.,409,386,382,170,212
CEKMEKOY,HAMIDIYE MAH.,407,376,372,163,209
CEKMEKOY,HAMIDIYE MAH.,407,381,378,158,220
CEKMEKOY,HAMIDIYE MAH.,407,375,367,148,219
CEKMEKOY,HAMIDIYE MAH.,407,364,363,175,188
CEKMEKOY,HAMIDIYE MAH.,408,383,381,144,237
CEKMEKOY,HAMIDIYE MAH.,407,361,356,159,197
CEKMEKOY,HAMIDIYE MAH.,408,375,369,170,199
CEKMEKOY,HAMIDIYE MAH.,408,375,370,169,201
CEKMEKOY,HAMIDIYE MAH.,407,369,362,190,172
CEKMEKOY,HAMIDIYE MAH.,400,341,337,148,189
CEKMEKOY,HAMIDIYE MAH.,401,344,336,144,192
CEKMEKOY,HAMIDIYE MAH.,400,373,367,173,194
CEKMEKOY,HAMIDIYE MAH.,401,370,361,181,180
CEKMEKOY,HAMIDIYE MAH.,400,367,359,168,191
CEKMEKOY,HAMIDIYE MAH.,400,368,359,191,168
CEKMEKOY,HAMIDIYE MAH.,404,362,359,180,179
CEKMEKOY,HAMIDIYE MAH.,401,371,368,201,167
CEKMEKOY,HAMIDIYE MAH.,401,375,371,199,172
CEKMEKOY,HAMIDIYE MAH.,400,355,345,143,202
CEKMEKOY,HAMIDIYE MAH.,399,361,351,185,166
CEKMEKOY,HAMIDIYE MAH.,400,363,360,170,190
CEKMEKOY,HAMIDIYE MAH.,399,362,362,172,190
CEKMEKOY,HAMIDIYE MAH.,399,374,367,192,175
CEKMEKOY,HAMIDIYE MAH.,400,368,365,182,183
CEKMEKOY,HAMIDIYE MAH.,401,364,358,191,167
CEKMEKOY,HAMIDIYE MAH.,399,366,365,159,206
CEKMEKOY,HAMIDIYE MAH.,400,368,361,180,181
CEKMEKOY,HAMIDIYE MAH.,399,379,377,175,202
CEKMEKOY,HAMIDIYE MAH.,400,366,365,176,189
CEKMEKOY,HAMIDIYE MAH.,399,369,365,192,173
CEKMEKOY,HAMIDIYE MAH.,399,365,355,162,193
CEKMEKOY,HAMIDIYE MAH.,399,372,369,156,213
CEKMEKOY,HAMIDIYE MAH.,399,361,358,168,190
CEKMEKOY,HAMIDIYE MAH.,398,343,332,153,179
CEKMEKOY,HAMIDIYE MAH.,401,356,353,199,154
CEKMEKOY,HAMIDIYE MAH.,401,377,375,221,154
CEKMEKOY,HAMIDIYE MAH.,397,369,367,194,173
CEKMEKOY,HAMIDIYE MAH.,398,357,353,209,144
CEKMEKOY,HAMIDIYE MAH.,398,361,353,204,149
CEKMEKOY,HAMIDIYE MAH.,397,368,363,178,185
CEKMEKOY,HAMIDIYE MAH.,398,367,362,194,168
CEKMEKOY,HAMIDIYE MAH.,398,357,351,173,178
CEKMEKOY,HAMIDIYE MAH.,398,361,355,191,164
CEKMEKOY,HAMIDIYE MAH.,397,344,341,186,155
CEKMEKOY,HAMIDIYE MAH.,397,358,354,183,171
CEKMEKOY,HAMIDIYE MAH.,398,356,352,201,151
CEKMEKOY,HAMIDIYE MAH.,397,370,363,230,133
CEKMEKOY,HUSEYINLI MAH.,285,257,247,148,99
CEKMEKOY,HUSEYINLI MAH.,289,270,260,164,96
CEKMEKOY,KIRAZLIDERE MAH.,394,347,341,173,168
CEKMEKOY,KIRAZLIDERE MAH.,393,372,369,175,194
CEKMEKOY,KIRAZLIDERE MAH.,394,355,354,184,170
CEKMEKOY,KIRAZLIDERE MAH.,394,372,369,165,204
CEKMEKOY,KIRAZLIDERE MAH.,394,364,362,159,203
CEKMEKOY,KIRAZLIDERE MAH.,394,364,361,183,178
CEKMEKOY,KIRAZLIDERE MAH.,395,366,365,196,169
CEKMEKOY,KIRAZLIDERE MAH.,394,374,368,201,167
CEKMEKOY,KIRAZLIDERE MAH.,395,358,358,182,176
CEKMEKOY,KIRAZLIDERE MAH.,395,359,355,171,184
CEKMEKOY,KIRAZLIDERE MAH.,395,363,358,200,158
CEKMEKOY,KIRAZLIDERE MAH.,394,365,363,190,173
CEKMEKOY,KIRAZLIDERE MAH.,394,364,361,163,198
CEKMEKOY,KIRAZLIDERE MAH.,396,373,367,173,194
CEKMEKOY,KOCULLU MAH.,305,278,271,212,59
CEKMEKOY,KOCULLU MAH.,305,282,273,216,57
CEKMEKOY,KOCULLU MAH.,303,287,279,214,65
CEKMEKOY,MEHMET AKIF MAH.,407,338,333,136,197
CEKMEKOY,MEHMET AKIF MAH.,409,382,373,205,168
CEKMEKOY,MEHMET AKIF MAH.,408,371,365,180,185
CEKMEKOY,MEHMET AKIF MAH.,409,365,359,200,159
CEKMEKOY,MEHMET AKIF MAH.,408,380,376,189,187
CEKMEKOY,MEHMET AKIF MAH.,408,373,366,195,171
CEKMEKOY,MEHMET AKIF MAH.,409,370,361,204,157
CEKMEKOY,MEHMET AKIF MAH.,408,377,370,183,187
CEKMEKOY,MEHMET AKIF MAH.,409,372,369,171,198
CEKMEKOY,MEHMET AKIF MAH.,409,375,365,203,162
CEKMEKOY,MEHMET AKIF MAH.,410,372,370,212,158
CEKMEKOY,MEHMET AKIF MAH.,409,389,382,196,186
CEKMEKOY,MEHMET AKIF MAH.,408,379,373,211,162
CEKMEKOY,MEHMET AKIF MAH.,409,382,377,215,162
CEKMEKOY,MEHMET AKIF MAH.,408,369,367,197,170
CEKMEKOY,MEHMET AKIF MAH.,409,378,372,218,154
CEKMEKOY,MEHMET AKIF MAH.,409,364,361,204,157
CEKMEKOY,MEHMET AKIF MAH.,409,373,364,172,192
CEKMEKOY,MEHMET AKIF MAH.,409,369,363,171,192
CEKMEKOY,MEHMET AKIF MAH.,408,358,352,209,143
CEKMEKOY,MEHMET AKIF MAH.,401,340,333,165,168
CEKMEKOY,MEHMET AKIF MAH.,401,362,349,209,140
CEKMEKOY,MEHMET AKIF MAH.,401,365,359,189,170
CEKMEKOY,MEHMET AKIF MAH.,400,368,363,197,166
CEKMEKOY,MEHMET AKIF MAH.,401,354,350,178,172
CEKMEKOY,MEHMET AKIF MAH.,400,366,359,233,126
CEKMEKOY,MEHMET AKIF MAH.,401,361,354,208,146
CEKMEKOY,MEHMET AKIF MAH.,401,348,338,205,133
CEKMEKOY,MEHMET AKIF MAH.,401,362,360,213,147
CEKMEKOY,MEHMET AKIF MAH.,401,362,357,191,166
CEKMEKOY,MEHMET AKIF MAH.,401,352,350,182,168
CEKMEKOY,MEHMET AKIF MAH.,400,350,345,196,149
CEKMEKOY,MEHMET AKIF MAH.,401,351,348,201,147
CEKMEKOY,MEHMET AKIF MAH.,401,367,361,208,153
CEKMEKOY,MEHMET AKIF MAH.,402,368,364,234,130
CEKMEKOY,MEHMET AKIF MAH.,401,355,351,208,143
CEKMEKOY,MEHMET AKIF MAH.,401,362,358,222,136
CEKMEKOY,MEHMET AKIF MAH.,400,360,359,200,159
CEKMEKOY,MEHMET AKIF MAH.,401,344,342,218,124
CEKMEKOY,MEHMET AKIF MAH.,400,359,354,226,128
CEKMEKOY,MEHMET AKIF MAH.,400,369,363,217,146
CEKMEKOY,MEHMET AKIF MAH.,400,348,343,204,139
CEKMEKOY,MEHMET AKIF MAH.,401,355,352,180,172
CEKMEKOY,MEHMET AKIF MAH.,393,340,334,179,155
CEKMEKOY,MEHMET AKIF MAH.,390,362,357,155,202
CEKMEKOY,MEHMET AKIF MAH.,388,347,342,198,144
CEKMEKOY,MEHMET AKIF MAH.,390,357,353,202,151
CEKMEKOY,MEHMET AKIF MAH.,390,336,324,176,148
CEKMEKOY,MEHMET AKIF MAH.,389,352,345,175,170
CEKMEKOY,MEHMET AKIF MAH.,390,348,345,170,175
CEKMEKOY,MEHMET AKIF MAH.,390,352,345,208,137
CEKMEKOY,MEHMET AKIF MAH.,390,347,342,185,157
CEKMEKOY,MEHMET AKIF MAH.,390,363,356,203,153
CEKMEKOY,MERKEZ MAH.,411,366,364,186,178
CEKMEKOY,MERKEZ MAH.,411,381,376,185,191
CEKMEKOY,MERKEZ MAH.,415,385,379,182,197
CEKMEKOY,MERKEZ MAH.,411,368,361,156,205
CEKMEKOY,MERKEZ MAH.,410,370,367,147,220
CEKMEKOY,MERKEZ MAH.,411,372,371,135,236
CEKMEKOY,MERKEZ MAH.,415,377,374,151,223
CEKMEKOY,MERKEZ MAH.,410,383,375,157,218
CEKMEKOY,MERKEZ MAH.,410,378,375,137,238
CEKMEKOY,MERKEZ MAH.,410,363,360,159,201
CEKMEKOY,MERKEZ MAH.,411,370,368,157,211
CEKMEKOY,MERKEZ MAH.,410,371,369,169,200
CEKMEKOY,MERKEZ MAH.,402,333,324,213,111
CEKMEKOY,MERKEZ MAH.,400,372,369,254,115
CEKMEKOY,MERKEZ MAH.,400,382,378,225,153
CEKMEKOY,MERKEZ MAH.,400,353,348,190,158
CEKMEKOY,MERKEZ MAH.,400,366,363,218,145
CEKMEKOY,MERKEZ MAH.,400,374,371,188,183
CEKMEKOY,MERKEZ MAH.,400,352,350,215,135
CEKMEKOY,MERKEZ MAH.,400,358,348,199,149
CEKMEKOY,MERKEZ MAH.,399,356,352,171,181
CEKMEKOY,MERKEZ MAH.,399,349,342,190,152
CEKMEKOY,MERKEZ MAH.,400,356,353,202,151
CEKMEKOY,MERKEZ MAH.,400,349,347,217,130
CEKMEKOY,MERKEZ MAH.,415,362,357,227,130
CEKMEKOY,MERKEZ MAH.,417,382,375,239,136
CEKMEKOY,MERKEZ MAH.,415,385,379,232,147
CEKMEKOY,MERKEZ MAH.,417,386,383,231,152
CEKMEKOY,MERKEZ MAH.,417,377,372,235,137
CEKMEKOY,MERKEZ MAH.,415,386,385,252,133
CEKMEKOY,MERKEZ MAH.,413,365,363,240,123
CEKMEKOY,MERKEZ MAH.,413,362,358,209,149
CEKMEKOY,MERKEZ MAH.,416,396,387,230,157
CEKMEKOY,MERKEZ MAH.,415,362,354,212,142
CEKMEKOY,MERKEZ MAH.,414,372,364,214,150
CEKMEKOY,MERKEZ MAH.,414,375,371,229,142
CEKMEKOY,MERKEZ MAH.,414,377,375,227,148
CEKMEKOY,MERKEZ MAH.,413,388,379,231,148
CEKMEKOY,MERKEZ MAH.,414,381,380,224,156
CEKMEKOY,MIMAR SINAN MAH.,411,357,351,141,210
CEKMEKOY,MIMAR SINAN MAH.,411,359,356,146,210
CEKMEKOY,MIMAR SINAN MAH.,410,365,361,170,191
CEKMEKOY,MIMAR SINAN MAH.,410,382,378,164,214
CEKMEKOY,MIMAR SINAN MAH.,410,385,380,168,212
CEKMEKOY,MIMAR SINAN MAH.,410,378,372,141,231
CEKMEKOY,MIMAR SINAN MAH.,410,373,369,152,217
CEKMEKOY,MIMAR SINAN MAH.,410,384,378,125,253
CEKMEKOY,MIMAR SINAN MAH.,410,386,382,159,223
CEKMEKOY,MIMAR SINAN MAH.,410,378,372,185,187
CEKMEKOY,MIMAR SINAN MAH.,412,374,366,144,222
CEKMEKOY,MIMAR SINAN MAH.,409,376,371,135,236
CEKMEKOY,MIMAR SINAN MAH.,409,375,372,148,224
CEKMEKOY,MIMAR SINAN MAH.,411,374,368,144,224
CEKMEKOY,MIMAR SINAN MAH.,410,381,377,183,194
CEKMEKOY,MIMAR SINAN MAH.,410,384,377,174,203
CEKMEKOY,MIMAR SINAN MAH.,409,377,375,165,210
CEKMEKOY,MIMAR SINAN MAH.,410,371,369,152,217
CEKMEKOY,MIMAR SINAN MAH.,409,381,378,147,231
CEKMEKOY,MIMAR SINAN MAH.,409,360,350,189,161
CEKMEKOY,MIMAR SINAN MAH.,409,378,374,207,167
CEKMEKOY,MIMAR SINAN MAH.,413,376,371,219,152
CEKMEKOY,MIMAR SINAN MAH.,409,376,370,209,161
CEKMEKOY,MIMAR SINAN MAH.,410,382,375,214,161
CEKMEKOY,MIMAR SINAN MAH.,407,366,362,162,200
CEKMEKOY,MIMAR SINAN MAH.,391,341,338,134,204
CEKMEKOY,MIMAR SINAN MAH.,393,368,362,176,186
CEKMEKOY,MIMAR SINAN MAH.,391,370,367,165,202
CEKMEKOY,MIMAR SINAN MAH.,390,370,368,181,187
CEKMEKOY,MIMAR SINAN MAH.,390,344,340,153,187
CEKMEKOY,MIMAR SINAN MAH.,391,357,350,164,186
CEKMEKOY,MIMAR SINAN MAH.,390,363,360,168,192
CEKMEKOY,MIMAR SINAN MAH.,391,357,351,167,184
CEKMEKOY,MIMAR SINAN MAH.,390,362,361,161,200
CEKMEKOY,MIMAR SINAN MAH.,390,368,360,149,211
CEKMEKOY,MIMAR SINAN MAH.,390,366,362,149,213
CEKMEKOY,MIMAR SINAN MAH.,391,369,366,154,212
CEKMEKOY,MIMAR SINAN MAH.,390,370,369,168,201
CEKMEKOY,MIMAR SINAN MAH.,390,369,363,149,214
CEKMEKOY,MIMAR SINAN MAH.,391,359,355,171,184
CEKMEKOY,MIMAR SINAN MAH.,391,371,370,180,190
CEKMEKOY,NISANTEPE MAH.,405,333,324,193,131
CEKMEKOY,NISANTEPE MAH.,406,369,366,193,173
CEKMEKOY,NISANTEPE MAH.,405,366,360,175,185
CEKMEKOY,NISANTEPE MAH.,407,368,358,169,189
CEKMEKOY,NISANTEPE MAH.,404,343,338,181,157
CEKMEKOY,NISANTEPE MAH.,405,366,360,198,162
CEKMEKOY,NISANTEPE MAH.,404,361,356,214,142
CEKMEKOY,NISANTEPE MAH.,404,362,354,165,189
CEKMEKOY,NISANTEPE MAH.,404,360,360,192,168
CEKMEKOY,NISANTEPE MAH.,404,355,345,179,166
CEKMEKOY,NISANTEPE MAH.,408,366,355,175,180
CEKMEKOY,NISANTEPE MAH.,405,364,354,191,163
CEKMEKOY,OMERLI MAH.,410,360,347,121,226
CEKMEKOY,OMERLI MAH.,406,380,371,147,224
CEKMEKOY,OMERLI MAH.,407,372,365,155,210
CEKMEKOY,OMERLI MAH.,407,372,361,157,204
CEKMEKOY,OMERLI MAH.,407,355,348,127,221
CEKMEKOY,OMERLI MAH.,406,373,366,147,219
CEKMEKOY,OMERLI MAH.,407,387,381,153,228
CEKMEKOY,RESADIYE MAH.,404,355,353,198,155
CEKMEKOY,RESADIYE MAH.,404,375,371,204,167
CEKMEKOY,RESADIYE MAH.,404,363,360,205,155
CEKMEKOY,RESADIYE MAH.,405,377,372,200,172
CEKMEKOY,SIRAPINAR MAH.,328,306,306,142,164
CEKMEKOY,SIRAPINAR MAH.,330,312,307,117,190
CEKMEKOY,SOGUKPINAR MAH.,400,343,338,218,120
CEKMEKOY,SOGUKPINAR MAH.,400,356,354,192,162
CEKMEKOY,SOGUKPINAR MAH.,402,365,360,214,146
CEKMEKOY,SOGUKPINAR MAH.,402,358,356,213,143
CEKMEKOY,SOGUKPINAR MAH.,401,364,352,193,159
CEKMEKOY,SOGUKPINAR MAH.,399,357,355,200,155
CEKMEKOY,SOGUKPINAR MAH.,400,368,361,220,141
CEKMEKOY,SOGUKPINAR MAH.,399,367,360,231,129
CEKMEKOY,SOGUKPINAR MAH.,400,374,367,223,144
CEKMEKOY,SOGUKPINAR MAH.,399,359,358,201,157
CEKMEKOY,SOGUKPINAR MAH.,399,358,353,195,158
CEKMEKOY,SOGUKPINAR MAH.,399,349,336,192,144
CEKMEKOY,SOGUKPINAR MAH.,403,374,367,231,136
CEKMEKOY,SULTANCIFTLIGI MAH.,388,328,322,202,120
CEKMEKOY,SULTANCIFTLIGI MAH.,388,355,351,181,170
CEKMEKOY,SULTANCIFTLIGI MAH.,389,340,328,174,154
CEKMEKOY,SULTANCIFTLIGI MAH.,389,349,344,182,162
CEKMEKOY,SULTANCIFTLIGI MAH.,391,365,356,189,167
CEKMEKOY,SULTANCIFTLIGI MAH.,388,345,341,196,145
CEKMEKOY,SULTANCIFTLIGI MAH.,388,359,352,187,165
CEKMEKOY,SULTANCIFTLIGI MAH.,388,355,351,186,165
CEKMEKOY,SULTANCIFTLIGI MAH.,388,344,341,221,120
CEKMEKOY,SULTANCIFTLIGI MAH.,390,354,349,192,157
CEKMEKOY,SULTANCIFTLIGI MAH.,388,354,349,172,177
CEKMEKOY,SULTANCIFTLIGI MAH.,388,346,337,182,155
CEKMEKOY,SULTANCIFTLIGI MAH.,389,352,346,182,164
CEKMEKOY,SULTANCIFTLIGI MAH.,388,358,352,179,173
CEKMEKOY,SULTANCIFTLIGI MAH.,391,340,332,152,180
CEKMEKOY,SULTANCIFTLIGI MAH.,392,357,352,157,195
CEKMEKOY,SULTANCIFTLIGI MAH.,392,354,348,136,212
CEKMEKOY,SULTANCIFTLIGI MAH.,391,352,348,153,195
CEKMEKOY,SULTANCIFTLIGI MAH.,391,356,349,172,177
CEKMEKOY,SULTANCIFTLIGI MAH.,392,354,350,143,207
CEKMEKOY,SULTANCIFTLIGI MAH.,391,357,352,164,188
CEKMEKOY,SULTANCIFTLIGI MAH.,395,366,358,188,170
CEKMEKOY,SULTANCIFTLIGI MAH.,390,356,346,141,205
CEKMEKOY,SULTANCIFTLIGI MAH.,392,351,346,156,190
CEKMEKOY,SULTANCIFTLIGI MAH.,390,364,355,162,193
CEKMEKOY,SULTANCIFTLIGI MAH.,391,354,352,182,170
CEKMEKOY,TASDELEN MAH.,415,347,340,206,134
CEKMEKOY,TASDELEN MAH.,415,394,383,193,190
CEKMEKOY,TASDELEN MAH.,415,372,361,156,205
CEKMEKOY,TASDELEN MAH.,415,372,370,192,178
CEKMEKOY,TASDELEN MAH.,415,379,373,215,158
CEKMEKOY,TASDELEN MAH.,414,359,357,185,172
CEKMEKOY,TASDELEN MAH.,413,375,370,171,199
CEKMEKOY,TASDELEN MAH.,414,365,364,201,163
CEKMEKOY,TASDELEN MAH.,413,366,362,177,185
CEKMEKOY,TASDELEN MAH.,414,358,353,171,182
CEKMEKOY,TASDELEN MAH.,414,369,366,186,180
CEKMEKOY,TASDELEN MAH.,414,377,371,169,202
BASAKSEHIR,BASAK MAH.,415,349,343,206,137
BASAKSEHIR,BASAK MAH.,415,379,375,227,148
BASAKSEHIR,BASAK MAH.,416,378,373,235,138
BASAKSEHIR,BASAK MAH.,413,380,373,236,137
BASAKSEHIR,BASAK MAH.,416,378,370,217,153
BASAKSEHIR,BASAK MAH.,416,370,364,233,131
BASAKSEHIR,BASAK MAH.,416,380,375,232,143
BASAKSEHIR,BASAK MAH.,415,366,365,215,150
BASAKSEHIR,BASAK MAH.,416,389,386,251,135
BASAKSEHIR,BASAK MAH.,415,384,374,239,135
BASAKSEHIR,BASAK MAH.,416,381,371,245,126
BASAKSEHIR,BASAK MAH.,415,382,375,239,136
BASAKSEHIR,BASAK MAH.,414,383,381,237,144
BASAKSEHIR,BASAK MAH.,412,380,371,236,135
BASAKSEHIR,BASAK MAH.,396,323,313,226,87
BASAKSEHIR,BASAK MAH.,396,357,349,240,109
BASAKSEHIR,BASAK MAH.,396,357,346,212,134
BASAKSEHIR,BASAK MAH.,398,357,349,222,127
BASAKSEHIR,BASAK MAH.,395,360,349,231,118
BASAKSEHIR,BASAK MAH.,396,363,359,234,125
BASAKSEHIR,BASAK MAH.,395,362,358,250,108
BASAKSEHIR,BASAK MAH.,395,359,358,215,143
BASAKSEHIR,BASAK MAH.,396,351,347,233,114
BASAKSEHIR,BASAK MAH.,395,365,356,240,116
BASAKSEHIR,BASAK MAH.,395,359,349,221,128
BASAKSEHIR,BASAK MAH.,395,357,353,219,134
BASAKSEHIR,BASAK MAH.,396,365,359,216,143
BASAKSEHIR,BASAK MAH.,396,352,347,248,99
BASAKSEHIR,BASAK MAH.,395,361,357,219,138
BASAKSEHIR,BASAK MAH.,395,359,354,234,120
BASAKSEHIR,BASAK MAH.,396,366,356,214,142
BASAKSEHIR,BASAK MAH.,404,321,319,108,211
BASAKSEHIR,BASAK MAH.,404,334,330,113,217
BASAKSEHIR,BASAK MAH.,403,355,353,118,235
BASAKSEHIR,BASAK MAH.,404,333,331,125,206
BASAKSEHIR,BASAK MAH.,403,348,346,145,201
BASAKSEHIR,BASAK MAH.,404,330,326,126,200
BASAKSEHIR,BASAK MAH.,405,352,346,124,222
BASAKSEHIR,BASAK MAH.,384,363,359,259,100
BASAKSEHIR,BASAK MAH.,385,350,339,239,100
BASAKSEHIR,BASAK MAH.,386,362,359,261,98
BASAKSEHIR,BASAK MAH.,383,340,333,253,80
BASAKSEHIR,BASAK MAH.,384,363,358,270,88
BASAKSEHIR,BASAK MAH.,409,349,344,195,149
BASAKSEHIR,BASAK MAH.,406,335,331,214,117
BASAKSEHIR,BASAK MAH.,406,372,368,230,138
BASAKSEHIR,BASAK MAH.,408,364,360,228,132
BASAKSEHIR,BASAK MAH.,405,362,353,225,128
BASAKSEHIR,BASAK MAH.,408,370,363,237,126
BASAKSEHIR,BASAK MAH.,409,366,362,246,116
BASAKSEHIR,BASAK MAH.,406,351,347,208,139
BASAKSEHIR,BASAK MAH.,406,361,350,247,103
BASAKSEHIR,BASAK MAH.,406,372,368,262,106
BASAKSEHIR,BASAK MAH.,405,364,357,239,118
BASAKSEHIR,BASAK MAH.,408,376,364,232,132
BASAKSEHIR,BASAK MAH.,406,365,356,250,106
BASAKSEHIR,BASAK MAH.,406,378,373,261,112
BASAKSEHIR,BASAK MAH.,406,371,362,235,127
BASAKSEHIR,BASAK MAH.,406,369,361,252,109
BASAKSEHIR,BASAK MAH.,406,368,363,247,116
BASAKSEHIR,BASAK MAH.,406,376,370,251,119
BASAKSEHIR,BASAK MAH.,407,377,367,241,126
BASAKSEHIR,BASAK MAH.,407,381,379,263,116
BASAKSEHIR,BASAK MAH.,407,373,368,237,131
BASAKSEHIR,BASAK MAH.,406,365,360,252,108
BASAKSEHIR,BASAK MAH.,407,370,362,239,123
BASAKSEHIR,BASAK MAH.,406,370,365,234,131
BASAKSEHIR,BASAK MAH.,406,376,375,251,124
BASAKSEHIR,BASAK MAH.,407,358,355,225,130
BASAKSEHIR,BASAK MAH.,407,370,361,254,107
BASAKSEHIR,BASAK MAH.,408,363,358,230,128
BASAKSEHIR,BASAK MAH.,406,363,352,217,135
BASAKSEHIR,BASAK MAH.,406,375,364,248,116
BASAKSEHIR,BASAK MAH.,405,379,367,241,126
BASAKSEHIR,BASAK MAH.,405,369,367,243,124
BASAKSEHIR,BASAK MAH.,405,364,360,221,139
BASAKSEHIR,BASAK MAH.,405,357,348,252,96
BASAKSEHIR,BASAK MAH.,406,378,369,221,148
BASAKSEHIR,BASAK MAH.,405,381,377,267,110
BASAKSEHIR,BASAK MAH.,402,344,334,235,99
BASAKSEHIR,BASAK MAH.,402,351,344,230,114
BASAKSEHIR,BASAK MAH.,402,365,361,241,120
BASAKSEHIR,BASAK MAH.,403,374,367,232,135
BASAKSEHIR,BASAK MAH.,403,368,360,234,126
BASAKSEHIR,BASAK MAH.,402,361,358,237,121
BASAKSEHIR,BASAK MAH.,402,366,363,234,129
BASAKSEHIR,BASAK MAH.,402,359,349,242,107
BASAKSEHIR,BASAK MAH.,403,375,372,255,117
BASAKSEHIR,BASAK MAH.,403,377,373,249,124
BASAKSEHIR,BASAK MAH.,403,358,351,252,99
BASAKSEHIR,BASAK MAH.,401,379,373,274,99
BASAKSEHIR,BASAK MAH.,403,366,360,241,119
BASAKSEHIR,BASAK MAH.,401,363,359,221,138
BASAKSEHIR,BASAK MAH.,402,357,349,245,104
BASAKSEHIR,BASAK MAH.,402,369,362,262,100
BASAKSEHIR,BASAK MAH.,403,356,350,262,88
BASAKSEHIR,BASAK MAH.,403,387,383,268,115
BASAKSEHIR,BASAK MAH.,403,362,357,249,108
BASAKSEHIR,BASAK MAH.,403,371,368,255,113
BASAKSEHIR,BASAK MAH.,403,385,377,254,123
BASAKSEHIR,BASAK MAH.,403,381,373,252,121
BASAKSEHIR,BASAK MAH.,403,370,363,259,104
BASAKSEHIR,BASAK MAH.,402,349,342,237,105
BASAKSEHIR,BASAK MAH.,402,370,365,251,114
BASAKSEHIR,BASAK MAH.,401,363,359,254,105
BASAKSEHIR,BASAK MAH.,403,361,355,256,99
BASAKSEHIR,BASAK MAH.,403,368,366,231,135
BASAKSEHIR,BASAK MAH.,403,368,357,246,111
BASAKSEHIR,BASAK MAH.,405,379,377,253,124
BASAKSEHIR,BASAKSEHIR MAH.,412,377,373,281,92
BASAKSEHIR,BASAKSEHIR MAH.,415,383,376,287,89
BASAKSEHIR,BASAKSEHIR MAH.,411,375,366,250,116
BASAKSEHIR,BASAKSEHIR MAH.,412,377,375,254,121
BASAKSEHIR,BASAKSEHIR MAH.,415,382,377,278,99
BASAKSEHIR,BASAKSEHIR MAH.,415,389,385,254,131
BASAKSEHIR,BASAKSEHIR MAH.,412,379,373,265,108
BASAKSEHIR,BASAKSEHIR MAH.,415,374,369,250,119
BASAKSEHIR,BASAKSEHIR MAH.,406,371,370,173,197
BASAKSEHIR,BASAKSEHIR MAH.,407,378,374,218,156
BASAKSEHIR,BASAKSEHIR MAH.,407,383,382,222,160
BASAKSEHIR,BASAKSEHIR MAH.,406,378,374,191,183
BASAKSEHIR,BASAKSEHIR MAH.,407,370,365,200,165
BASAKSEHIR,BASAKSEHIR MAH.,407,378,375,194,181
BASAKSEHIR,BASAKSEHIR MAH.,406,378,377,187,190
BASAKSEHIR,BASAKSEHIR MAH.,407,378,372,178,194
BASAKSEHIR,BASAKSEHIR MAH.,407,373,371,198,173
BASAKSEHIR,BASAKSEHIR MAH.,408,378,374,181,193
BASAKSEHIR,BASAKSEHIR MAH.,408,378,374,199,175
BASAKSEHIR,BASAKSEHIR MAH.,387,329,326,202,124
BASAKSEHIR,BASAKSEHIR MAH.,387,324,321,209,112
BASAKSEHIR,BASAKSEHIR MAH.,387,335,331,210,121
BASAKSEHIR,BASAKSEHIR MAH.,387,348,339,227,112
BASAKSEHIR,BASAKSEHIR MAH.,387,348,343,224,119
BASAKSEHIR,BASAKSEHIR MAH.,387,355,346,246,100
BASAKSEHIR,BASAKSEHIR MAH.,386,348,341,215,126
BASAKSEHIR,BASAKSEHIR MAH.,387,361,351,203,148
BASAKSEHIR,BASAKSEHIR MAH.,387,350,345,218,127
BASAKSEHIR,BASAKSEHIR MAH.,386,347,343,216,127
BASAKSEHIR,BASAKSEHIR MAH.,386,354,349,242,107
BASAKSEHIR,BASAKSEHIR MAH.,415,359,352,239,113
BASAKSEHIR,BASAKSEHIR MAH.,415,369,360,252,108
BASAKSEHIR,BASAKSEHIR MAH.,415,369,365,218,147
BASAKSEHIR,BASAKSEHIR MAH.,415,385,379,253,126
BASAKSEHIR,BASAKSEHIR MAH.,412,370,366,238,128
BASAKSEHIR,BASAKSEHIR MAH.,415,389,379,228,151
BASAKSEHIR,BASAKSEHIR MAH.,410,379,371,227,144
BASAKSEHIR,BASAKSEHIR MAH.,412,383,380,237,143
BASAKSEHIR,BASAKSEHIR MAH.,410,371,365,237,128
BASAKSEHIR,BASAKSEHIR MAH.,410,370,368,252,116
BASAKSEHIR,BASAKSEHIR MAH.,412,388,379,248,131
BASAKSEHIR,BASAKSEHIR MAH.,412,377,370,229,141
BASAKSEHIR,BASAKSEHIR MAH.,415,375,368,244,124
BASAKSEHIR,BASAKSEHIR MAH.,411,382,377,263,114
BASAKSEHIR,BASAKSEHIR MAH.,415,363,355,250,105
BASAKSEHIR,BASAKSEHIR MAH.,411,367,362,232,130
BASAKSEHIR,BASAKSEHIR MAH.,412,381,376,235,141
BASAKSEHIR,BASAKSEHIR MAH.,411,371,361,226,135
BASAKSEHIR,BASAKSEHIR MAH.,411,379,370,235,135
BASAKSEHIR,BASAKSEHIR MAH.,411,379,371,251,120
BASAKSEHIR,BASAKSEHIR MAH.,412,382,376,224,152
BASAKSEHIR,BASAKSEHIR MAH.,404,346,339,240,99
BASAKSEHIR,BASAKSEHIR MAH.,404,369,364,247,117
BASAKSEHIR,BASAKSEHIR MAH.,406,363,357,250,107
BASAKSEHIR,BASAKSEHIR MAH.,406,371,368,237,131
BASAKSEHIR,BASAKSEHIR MAH.,404,378,375,268,107
BASAKSEHIR,BASAKSEHIR MAH.,403,361,354,226,128
BASAKSEHIR,BASAKSEHIR MAH.,403,374,366,277,89
BASAKSEHIR,BASAKSEHIR MAH.,404,355,349,234,115
BASAKSEHIR,BASAKSEHIR MAH.,406,363,354,259,95
BASAKSEHIR,BASAKSEHIR MAH.,401,347,341,240,101
BASAKSEHIR,BASAKSEHIR MAH.,402,365,359,234,125
BASAKSEHIR,BASAKSEHIR MAH.,402,362,360,242,118
BASAKSEHIR,BASAKSEHIR MAH.,401,363,356,225,131
BASAKSEHIR,BASAKSEHIR MAH.,402,353,340,231,109
BASAKSEHIR,BASAKSEHIR MAH.,400,369,364,223,141
BASAKSEHIR,BASAKSEHIR MAH.,404,365,360,221,139
BASAKSEHIR,BASAKSEHIR MAH.,402,373,370,247,123
BASAKSEHIR,BASAKSEHIR MAH.,401,364,356,220,136
BASAKSEHIR,BASAKSEHIR MAH.,401,366,364,225,139
BASAKSEHIR,BASAKSEHIR MAH.,402,371,365,217,148
BASAKSEHIR,BASAKSEHIR MAH.,401,377,371,230,141
BASAKSEHIR,BASAKSEHIR MAH.,402,368,363,249,114
BASAKSEHIR,BASAKSEHIR MAH.,402,352,348,207,141
BASAKSEHIR,BASAKSEHIR MAH.,401,375,371,252,119
BASAKSEHIR,BASAKSEHIR MAH.,401,358,356,211,145
BASAKSEHIR,BASAKSEHIR MAH.,401,363,359,227,132
BASAKSEHIR,BASAKSEHIR MAH.,402,358,351,247,104
BASAKSEHIR,BASAKSEHIR MAH.,403,364,364,230,134
BASAKSEHIR,BASAKSEHIR MAH.,401,364,357,237,120
BASAKSEHIR,BASAKSEHIR MAH.,401,369,364,236,128
BASAKSEHIR,BASAKSEHIR MAH.,400,358,354,222,132
BASAKSEHIR,BASAKSEHIR MAH.,400,375,369,242,127
BASAKSEHIR,KAYABASI MAH.,399,363,356,267,89
BASAKSEHIR,KAYABASI MAH.,399,351,347,255,92
BASAKSEHIR,KAYABASI MAH.,398,358,353,245,108
BASAKSEHIR,KAYABASI MAH.,402,357,350,242,108
BASAKSEHIR,KAYABASI MAH.,399,360,356,262,94
BASAKSEHIR,KAYABASI MAH.,398,355,348,247,101
BASAKSEHIR,KAYABASI MAH.,399,356,347,253,94
BASAKSEHIR,KAYABASI MAH.,398,365,362,250,112
BASAKSEHIR,KAYABASI MAH.,397,353,347,255,92
BASAKSEHIR,KAYABASI MAH.,398,367,364,257,107
BASAKSEHIR,KAYABASI MAH.,397,360,358,247,111
BASAKSEHIR,KAYABASI MAH.,397,361,358,236,122
BASAKSEHIR,KAYABASI MAH.,336,284,282,144,138
BASAKSEHIR,KAYABASI MAH.,333,294,289,142,147
BASAKSEHIR,KAYABASI MAH.,333,291,288,146,142
BASAKSEHIR,KAYABASI MAH.,333,297,289,157,132
BASAKSEHIR,KAYABASI MAH.,415,359,355,264,91
BASAKSEHIR,KAYABASI MAH.,407,357,352,259,93
BASAKSEHIR,KAYABASI MAH.,412,378,377,297,80
BASAKSEHIR,KAYABASI MAH.,408,367,361,272,89
BASAKSEHIR,KAYABASI MAH.,407,368,365,280,85
BASAKSEHIR,KAYABASI MAH.,408,362,362,278,84
BASAKSEHIR,KAYABASI MAH.,407,362,357,250,107
BASAKSEHIR,KAYABASI MAH.,407,364,355,272,83
BASAKSEHIR,KAYABASI MAH.,407,376,374,280,94
BASAKSEHIR,KAYABASI MAH.,408,358,357,262,95
BASAKSEHIR,KAYABASI MAH.,407,377,373,274,99
BASAKSEHIR,KAYABASI MAH.,399,363,354,263,91
BASAKSEHIR,KAYABASI MAH.,400,349,345,257,88
BASAKSEHIR,KAYABASI MAH.,400,368,362,255,107
BASAKSEHIR,KAYABASI MAH.,400,370,356,223,133
BASAKSEHIR,KAYABASI MAH.,400,362,360,259,101
BASAKSEHIR,KAYABASI MAH.,399,354,350,239,111
BASAKSEHIR,KAYABASI MAH.,399,355,350,246,104
BASAKSEHIR,KAYABASI MAH.,400,354,348,249,99
BASAKSEHIR,KAYABASI MAH.,399,364,359,247,112
BASAKSEHIR,KAYABASI MAH.,400,373,368,248,120
BASAKSEHIR,KAYABASI MAH.,407,353,347,234,113
BASAKSEHIR,KAYABASI MAH.,407,358,346,223,123
BASAKSEHIR,KAYABASI MAH.,406,362,359,263,96
BASAKSEHIR,KAYABASI MAH.,405,372,365,226,139
BASAKSEHIR,KAYABASI MAH.,406,362,359,262,97
BASAKSEHIR,KAYABASI MAH.,406,377,370,262,108
BASAKSEHIR,KAYABASI MAH.,405,366,363,243,120
BASAKSEHIR,KAYABASI MAH.,406,369,363,240,123
BASAKSEHIR,KAYABASI MAH.,406,370,365,275,90
BASAKSEHIR,KAYABASI MAH.,405,379,379,259,120
BASAKSEHIR,KAYABASI MAH.,405,371,369,253,116
BASAKSEHIR,KAYABASI MAH.,405,365,360,266,94
BASAKSEHIR,KAYABASI MAH.,405,363,357,251,106
BASAKSEHIR,KAYABASI MAH.,405,377,375,270,105
BASAKSEHIR,KAYABASI MAH.,406,367,365,235,130
BASAKSEHIR,KAYABASI MAH.,405,374,366,243,123
BASAKSEHIR,KAYABASI MAH.,405,381,369,259,110
BASAKSEHIR,KAYABASI MAH.,405,366,360,237,123
BASAKSEHIR,KAYABASI MAH.,405,372,369,251,118
BASAKSEHIR,KAYABASI MAH.,405,374,373,265,108
BASAKSEHIR,KAYABASI MAH.,405,370,370,258,112
BASAKSEHIR,KAYABASI MAH.,406,366,362,239,123
BASAKSEHIR,KAYABASI MAH.,405,360,358,239,119
BASAKSEHIR,KAYABASI MAH.,405,361,353,240,113
BASAKSEHIR,KAYABASI MAH.,406,364,362,243,119
BASAKSEHIR,KAYABASI MAH.,405,370,361,254,107
BASAKSEHIR,KAYABASI MAH.,405,356,352,250,102
BASAKSEHIR,KAYABASI MAH.,406,370,363,259,104
BASAKSEHIR,KAYABASI MAH.,405,374,370,253,117
BASAKSEHIR,KAYABASI MAH.,387,335,333,252,81
BASAKSEHIR,KAYABASI MAH.,385,353,346,233,113
BASAKSEHIR,KAYABASI MAH.,386,354,345,254,91
BASAKSEHIR,KAYABASI MAH.,389,354,346,253,93
BASAKSEHIR,KAYABASI MAH.,387,345,340,233,107
BASAKSEHIR,KAYABASI MAH.,386,346,337,240,97
BASAKSEHIR,KAYABASI MAH.,387,356,355,284,71
BASAKSEHIR,KAYABASI MAH.,387,348,344,258,86
BASAKSEHIR,KAYABASI MAH.,386,336,328,244,84
BASAKSEHIR,KAYABASI MAH.,386,341,336,249,87
BASAKSEHIR,KAYABASI MAH.,387,346,345,231,114
BASAKSEHIR,KAYABASI MAH.,386,351,346,254,92
BASAKSEHIR,KAYABASI MAH.,387,350,346,240,106
BASAKSEHIR,KAYABASI MAH.,387,353,347,268,79
BASAKSEHIR,KAYABASI MAH.,415,346,344,268,76
BASAKSEHIR,KAYABASI MAH.,415,358,350,253,97
BASAKSEHIR,KAYABASI MAH.,414,361,355,262,93
BASAKSEHIR,KAYABASI MAH.,413,352,343,235,108
BASAKSEHIR,KAYABASI MAH.,414,369,364,266,98
BASAKSEHIR,KAYABASI MAH.,413,376,371,249,122
BASAKSEHIR,KAYABASI MAH.,413,378,373,303,70
BASAKSEHIR,KAYABASI MAH.,415,363,360,275,85
BASAKSEHIR,KAYABASI MAH.,413,370,368,260,108
BASAKSEHIR,KAYABASI MAH.,413,367,365,281,84
BASAKSEHIR,KAYABASI MAH.,401,354,351,252,99
BASAKSEHIR,KAYABASI MAH.,401,361,356,252,104
BASAKSEHIR,KAYABASI MAH.,400,373,360,270,90
BASAKSEHIR,KAYABASI MAH.,400,369,367,248,119
BASAKSEHIR,KAYABASI MAH.,400,357,351,242,109
BASAKSEHIR,KAYABASI MAH.,400,358,356,266,90
BASAKSEHIR,KAYABASI MAH.,400,369,360,255,105
BASAKSEHIR,KAYABASI MAH.,400,368,362,265,97
BASAKSEHIR,KAYABASI MAH.,400,352,342,253,89
BASAKSEHIR,KAYABASI MAH.,399,344,337,250,87
BASAKSEHIR,KAYABASI MAH.,400,363,359,257,102
BASAKSEHIR,KAYABASI MAH.,400,362,360,251,109
BASAKSEHIR,KAYABASI MAH.,399,365,361,267,94
BASAKSEHIR,KAYABASI MAH.,401,368,362,248,114
BASAKSEHIR,SAMLAR MAH.,308,272,270,169,101
BASAKSEHIR,SAMLAR MAH.,308,271,262,173,89
BASAKSEHIR,SAMLAR MAH.,310,283,277,180,97
BASAKSEHIR,ALTINSEHIR MAH.,402,344,336,174,162
BASAKSEHIR,ALTINSEHIR MAH.,403,340,335,202,133
BASAKSEHIR,ALTINSEHIR MAH.,404,342,332,193,139
BASAKSEHIR,ALTINSEHIR MAH.,403,346,339,185,154
BASAKSEHIR,ALTINSEHIR MAH.,402,362,354,203,151
BASAKSEHIR,ALTINSEHIR MAH.,401,344,338,192,146
BASAKSEHIR,ALTINSEHIR MAH.,402,349,340,204,136
BASAKSEHIR,ALTINSEHIR MAH.,401,358,350,211,139
BASAKSEHIR,ALTINSEHIR MAH.,403,363,354,214,140
BASAKSEHIR,ALTINSEHIR MAH.,401,361,356,175,181
BASAKSEHIR,ALTINSEHIR MAH.,401,349,348,190,158
BASAKSEHIR,ALTINSEHIR MAH.,403,369,360,206,154
BASAKSEHIR,ALTINSEHIR MAH.,401,354,347,218,129
BASAKSEHIR,ALTINSEHIR MAH.,401,349,341,200,141
BASAKSEHIR,ALTINSEHIR MAH.,402,341,337,202,135
BASAKSEHIR,ALTINSEHIR MAH.,401,347,344,187,157
BASAKSEHIR,ALTINSEHIR MAH.,402,371,366,204,162
BASAKSEHIR,ALTINSEHIR MAH.,402,363,357,181,176
BASAKSEHIR,ALTINSEHIR MAH.,401,341,339,216,123
BASAKSEHIR,ALTINSEHIR MAH.,402,362,361,201,160
BASAKSEHIR,ALTINSEHIR MAH.,402,345,338,198,140
BASAKSEHIR,ALTINSEHIR MAH.,403,373,371,197,174
BASAKSEHIR,ALTINSEHIR MAH.,402,369,366,204,162
BASAKSEHIR,BAHCESEHIR 1. KISIM MAH.,398,363,362,75,287
BASAKSEHIR,BAHCESEHIR 1. KISIM MAH.,398,385,380,77,303
BASAKSEHIR,BAHCESEHIR 1. KISIM MAH.,399,373,371,61,310
BASAKSEHIR,BAHCESEHIR 1. KISIM MAH.,399,372,370,64,306
BASAKSEHIR,BAHCESEHIR 1. KISIM MAH.,398,377,376,71,305
BASAKSEHIR,BAHCESEHIR 1. KISIM MAH.,398,385,383,74,309
BASAKSEHIR,BAHCESEHIR 1. KISIM MAH.,398,369,365,79,286
BASAKSEHIR,BAHCESEHIR 1. KISIM MAH.,399,383,380,77,303
BASAKSEHIR,BAHCESEHIR 1. KISIM MAH.,399,384,383,62,321
BASAKSEHIR,BAHCESEHIR 1. KISIM MAH.,399,378,372,59,313
BASAKSEHIR,BAHCESEHIR 1. KISIM MAH.,412,358,354,92,262
BASAKSEHIR,BAHCESEHIR 1. KISIM MAH.,415,377,376,127,249
BASAKSEHIR,BAHCESEHIR 1. KISIM MAH.,415,377,376,108,268
BASAKSEHIR,BAHCESEHIR 1. KISIM MAH.,411,368,365,123,242
BASAKSEHIR,BAHCESEHIR 1. KISIM MAH.,415,372,364,124,240
BASAKSEHIR,BAHCESEHIR 1. KISIM MAH.,415,383,379,107,272
BASAKSEHIR,BAHCESEHIR 1. KISIM MAH.,415,381,374,125,249
BASAKSEHIR,BAHCESEHIR 1. KISIM MAH.,415,389,383,122,261
BASAKSEHIR,BAHCESEHIR 1. KISIM MAH.,415,394,391,106,285
BASAKSEHIR,BAHCESEHIR 1. KISIM MAH.,415,392,389,113,276
BASAKSEHIR,BAHCESEHIR 1. KISIM MAH.,415,385,376,112,264
BASAKSEHIR,BAHCESEHIR 1. KISIM MAH.,415,381,377,122,255
BASAKSEHIR,BAHCESEHIR 1. KISIM MAH.,415,372,369,109,260
BASAKSEHIR,BAHCESEHIR 1. KISIM MAH.,415,380,374,99,275
BASAKSEHIR,BAHCESEHIR 1. KISIM MAH.,415,369,368,108,260
BASAKSEHIR,BAHCESEHIR 1. KISIM MAH.,389,336,333,38,295
BASAKSEHIR,BAHCESEHIR 1. KISIM MAH.,391,351,348,43,305
BASAKSEHIR,BAHCESEHIR 1. KISIM MAH.,388,362,357,60,297
BASAKSEHIR,BAHCESEHIR 1. KISIM MAH.,388,351,345,59,286
BASAKSEHIR,BAHCESEHIR 1. KISIM MAH.,389,359,356,37,319
BASAKSEHIR,BAHCESEHIR 1. KISIM MAH.,389,367,364,57,307
BASAKSEHIR,BAHCESEHIR 1. KISIM MAH.,390,367,362,58,304
BASAKSEHIR,BAHCESEHIR 1. KISIM MAH.,388,348,345,52,293
BASAKSEHIR,BAHCESEHIR 1. KISIM MAH.,388,348,346,47,299
BASAKSEHIR,BAHCESEHIR 1. KISIM MAH.,390,352,350,54,296
BASAKSEHIR,BAHCESEHIR 2. KISIM MAH.,408,348,344,59,285
BASAKSEHIR,BAHCESEHIR 2. KISIM MAH.,415,372,369,55,314
BASAKSEHIR,BAHCESEHIR 2. KISIM MAH.,409,368,364,57,307
BASAKSEHIR,BAHCESEHIR 2. KISIM MAH.,409,379,377,56,321
BASAKSEHIR,BAHCESEHIR 2. KISIM MAH.,408,370,367,47,320
BASAKSEHIR,BAHCESEHIR 2. KISIM MAH.,407,378,376,55,321
BASAKSEHIR,BAHCESEHIR 2. KISIM MAH.,406,387,384,61,323
BASAKSEHIR,BAHCESEHIR 2. KISIM MAH.,409,379,377,45,332
BASAKSEHIR,BAHCESEHIR 2. KISIM MAH.,408,366,365,66,299
BASAKSEHIR,BAHCESEHIR 2. KISIM MAH.,409,392,387,77,310
BASAKSEHIR,BAHCESEHIR 2. KISIM MAH.,408,381,378,51,327
BASAKSEHIR,BAHCESEHIR 2. KISIM MAH.,409,382,377,74,303
BASAKSEHIR,BAHCESEHIR 2. KISIM MAH.,408,386,384,60,324
BASAKSEHIR,BAHCESEHIR 2. KISIM MAH.,409,379,373,65,308
BASAKSEHIR,BAHCESEHIR 2. KISIM MAH.,401,332,324,79,245
BASAKSEHIR,BAHCESEHIR 2. KISIM MAH.,402,346,344,110,234
BASAKSEHIR,BAHCESEHIR 2. KISIM MAH.,401,350,347,70,277
BASAKSEHIR,BAHCESEHIR 2. KISIM MAH.,402,371,368,80,288
BASAKSEHIR,BAHCESEHIR 2. KISIM MAH.,405,354,350,90,260
BASAKSEHIR,BAHCESEHIR 2. KISIM MAH.,400,349,346,94,252
BASAKSEHIR,BAHCESEHIR 2. KISIM MAH.,400,356,351,94,257
BASAKSEHIR,BAHCESEHIR 2. KISIM MAH.,402,350,347,73,274
BASAKSEHIR,BAHCESEHIR 2. KISIM MAH.,400,358,350,90,260
BASAKSEHIR,BAHCESEHIR 2. KISIM MAH.,400,349,348,84,264
BASAKSEHIR,BAHCESEHIR 2. KISIM MAH.,400,364,359,100,259
BASAKSEHIR,BAHCESEHIR 2. KISIM MAH.,401,348,346,98,248
BASAKSEHIR,BAHCESEHIR 2. KISIM MAH.,401,368,361,81,280
BASAKSEHIR,BAHCESEHIR 2. KISIM MAH.,400,351,339,79,260
BASAKSEHIR,BAHCESEHIR 2. KISIM MAH.,400,333,328,73,255
BASAKSEHIR,BAHCESEHIR 2. KISIM MAH.,400,356,350,75,275
BASAKSEHIR,BAHCESEHIR 2. KISIM MAH.,400,352,347,110,237
BASAKSEHIR,BAHCESEHIR 2. KISIM MAH.,400,359,353,87,266
BASAKSEHIR,BAHCESEHIR 2. KISIM MAH.,401,357,353,97,256
BASAKSEHIR,BAHCESEHIR 2. KISIM MAH.,400,360,359,87,272
BASAKSEHIR,BAHCESEHIR 2. KISIM MAH.,381,315,312,93,219
BASAKSEHIR,BAHCESEHIR 2. KISIM MAH.,381,341,340,88,252
BASAKSEHIR,BAHCESEHIR 2. KISIM MAH.,384,338,333,82,251
BASAKSEHIR,BAHCESEHIR 2. KISIM MAH.,382,331,327,90,237
BASAKSEHIR,BAHCESEHIR 2. KISIM MAH.,382,345,343,85,258
BASAKSEHIR,BAHCESEHIR 2. KISIM MAH.,381,348,347,75,272
BASAKSEHIR,BAHCESEHIR 2. KISIM MAH.,381,350,344,82,262
BASAKSEHIR,BAHCESEHIR 2. KISIM MAH.,382,341,337,107,230
BASAKSEHIR,BAHCESEHIR 2. KISIM MAH.,381,340,334,89,245
BASAKSEHIR,BAHCESEHIR 2. KISIM MAH.,382,336,334,81,253
BASAKSEHIR,BAHCESEHIR 2. KISIM MAH.,410,339,333,72,261
BASAKSEHIR,BAHCESEHIR 2. KISIM MAH.,410,359,358,76,282
BASAKSEHIR,BAHCESEHIR 2. KISIM MAH.,409,359,357,78,279
BASAKSEHIR,BAHCESEHIR 2. KISIM MAH.,408,375,371,66,305
BASAKSEHIR,BAHCESEHIR 2. KISIM MAH.,408,367,362,92,270
BASAKSEHIR,BAHCESEHIR 2. KISIM MAH.,409,369,366,71,295
BASAKSEHIR,BAHCESEHIR 2. KISIM MAH.,409,379,376,81,295
BASAKSEHIR,BAHCESEHIR 2. KISIM MAH.,408,373,366,72,294
BASAKSEHIR,BAHCESEHIR 2. KISIM MAH.,412,366,364,76,288
BASAKSEHIR,BAHCESEHIR 2. KISIM MAH.,409,365,362,88,274
BASAKSEHIR,BAHCESEHIR 2. KISIM MAH.,409,383,381,76,305
BASAKSEHIR,BAHCESEHIR 2. KISIM MAH.,408,368,365,94,271
BASAKSEHIR,BAHCESEHIR 2. KISIM MAH.,409,376,375,90,285
BASAKSEHIR,BAHCESEHIR 2. KISIM MAH.,408,369,364,67,297
BASAKSEHIR,BAHCESEHIR 2. KISIM MAH.,408,366,363,79,284
BASAKSEHIR,BAHCESEHIR 2. KISIM MAH.,409,376,373,96,277
BASAKSEHIR,BAHCESEHIR 2. KISIM MAH.,408,357,355,86,269
BASAKSEHIR,BAHCESEHIR 2. KISIM MAH.,409,380,376,71,305
BASAKSEHIR,BAHCESEHIR 2. KISIM MAH.,409,366,364,100,264
BASAKSEHIR,BAHCESEHIR 2. KISIM MAH.,409,383,379,91,288
BASAKSEHIR,BAHCESEHIR 2. KISIM MAH.,366,330,328,156,172
BASAKSEHIR,BAHCESEHIR 2. KISIM MAH.,365,337,334,170,164
BASAKSEHIR,BAHCESEHIR 2. KISIM MAH.,366,331,326,160,166
BASAKSEHIR,BAHCESEHIR 2. KISIM MAH.,365,330,329,167,162
BASAKSEHIR,GUVERCINTEPE MAH.,412,356,344,168,176
BASAKSEHIR,GUVERCINTEPE MAH.,410,337,325,171,154
BASAKSEHIR,GUVERCINTEPE MAH.,411,370,364,194,170
BASAKSEHIR,GUVERCINTEPE MAH.,415,358,347,186,161
BASAKSEHIR,GUVERCINTEPE MAH.,415,369,355,176,179
BASAKSEHIR,GUVERCINTEPE MAH.,410,363,357,200,157
BASAKSEHIR,GUVERCINTEPE MAH.,415,383,373,216,157
BASAKSEHIR,GUVERCINTEPE MAH.,411,375,367,181,186
BASAKSEHIR,GUVERCINTEPE MAH.,415,360,353,199,154
BASAKSEHIR,GUVERCINTEPE MAH.,415,372,366,174,192
BASAKSEHIR,GUVERCINTEPE MAH.,413,359,352,173,179
BASAKSEHIR,GUVERCINTEPE MAH.,412,347,339,183,156
BASAKSEHIR,GUVERCINTEPE MAH.,411,352,346,163,183
BASAKSEHIR,GUVERCINTEPE MAH.,411,356,344,163,181
BASAKSEHIR,GUVERCINTEPE MAH.,411,367,363,158,205
BASAKSEHIR,GUVERCINTEPE MAH.,412,364,362,179,183
BASAKSEHIR,GUVERCINTEPE MAH.,411,362,356,182,174
BASAKSEHIR,GUVERCINTEPE MAH.,412,366,356,193,163
BASAKSEHIR,GUVERCINTEPE MAH.,411,351,345,181,164
BASAKSEHIR,GUVERCINTEPE MAH.,412,362,355,197,158
BASAKSEHIR,GUVERCINTEPE MAH.,411,364,352,190,162
BASAKSEHIR,GUVERCINTEPE MAH.,411,368,360,196,164
BASAKSEHIR,GUVERCINTEPE MAH.,385,350,343,237,106
BASAKSEHIR,GUVERCINTEPE MAH.,384,352,344,238,106
BASAKSEHIR,GUVERCINTEPE MAH.,382,352,349,220,129
BASAKSEHIR,GUVERCINTEPE MAH.,385,352,348,231,117
BASAKSEHIR,GUVERCINTEPE MAH.,383,348,337,237,100
BASAKSEHIR,GUVERCINTEPE MAH.,389,373,372,250,122
BASAKSEHIR,GUVERCINTEPE MAH.,408,365,348,208,140
BASAKSEHIR,GUVERCINTEPE MAH.,410,339,328,183,145
BASAKSEHIR,GUVERCINTEPE MAH.,408,346,338,182,156
BASAKSEHIR,GUVERCINTEPE MAH.,407,361,358,197,161
BASAKSEHIR,GUVERCINTEPE MAH.,408,358,355,190,165
BASAKSEHIR,GUVERCINTEPE MAH.,407,357,352,190,162
BASAKSEHIR,GUVERCINTEPE MAH.,406,356,347,169,178
BASAKSEHIR,GUVERCINTEPE MAH.,407,376,372,226,146
BASAKSEHIR,GUVERCINTEPE MAH.,406,354,347,203,144
BASAKSEHIR,GUVERCINTEPE MAH.,415,364,356,207,149
BASAKSEHIR,GUVERCINTEPE MAH.,407,356,351,203,148
BASAKSEHIR,GUVERCINTEPE MAH.,407,357,350,210,140
BASAKSEHIR,GUVERCINTEPE MAH.,406,352,345,191,154
BASAKSEHIR,GUVERCINTEPE MAH.,407,362,356,189,167
BASAKSEHIR,GUVERCINTEPE MAH.,407,358,348,224,124
BASAKSEHIR,GUVERCINTEPE MAH.,406,350,348,216,132
BASAKSEHIR,GUVERCINTEPE MAH.,407,352,345,222,123
BASAKSEHIR,GUVERCINTEPE MAH.,407,340,335,227,108
BASAKSEHIR,GUVERCINTEPE MAH.,407,354,348,238,110
BASAKSEHIR,GUVERCINTEPE MAH.,408,380,377,237,140
BASAKSEHIR,GUVERCINTEPE MAH.,407,341,334,189,145
BASAKSEHIR,GUVERCINTEPE MAH.,407,358,355,176,179
BASAKSEHIR,GUVERCINTEPE MAH.,406,361,356,207,149
BASAKSEHIR,GUVERCINTEPE MAH.,409,368,361,213,148
BASAKSEHIR,GUVERCINTEPE MAH.,407,344,335,202,133
BASAKSEHIR,GUVERCINTEPE MAH.,406,353,345,186,159
BASAKSEHIR,GUVERCINTEPE MAH.,407,352,340,177,163
BASAKSEHIR,GUVERCINTEPE MAH.,408,353,351,183,168
BASAKSEHIR,GUVERCINTEPE MAH.,407,351,350,181,169
BASAKSEHIR,GUVERCINTEPE MAH.,406,361,360,188,172
BASAKSEHIR,GUVERCINTEPE MAH.,359,314,310,143,167
BASAKSEHIR,GUVERCINTEPE MAH.,358,323,310,131,179
BASAKSEHIR,GUVERCINTEPE MAH.,359,321,319,159,160
BASAKSEHIR,GUVERCINTEPE MAH.,360,323,319,152,167
BASAKSEHIR,GUVERCINTEPE MAH.,359,327,320,177,143
BASAKSEHIR,GUVERCINTEPE MAH.,359,311,302,157,145
BASAKSEHIR,GUVERCINTEPE MAH.,362,328,321,160,161
BASAKSEHIR,GUVERCINTEPE MAH.,407,347,342,149,193
BASAKSEHIR,GUVERCINTEPE MAH.,407,373,368,160,208
BASAKSEHIR,GUVERCINTEPE MAH.,408,377,371,167,204
BASAKSEHIR,GUVERCINTEPE MAH.,408,380,378,170,208
BASAKSEHIR,GUVERCINTEPE MAH.,407,354,348,153,195
BASAKSEHIR,GUVERCINTEPE MAH.,408,365,363,149,214
BASAKSEHIR,GUVERCINTEPE MAH.,406,370,364,141,223
BASAKSEHIR,GUVERCINTEPE MAH.,407,363,353,195,158
BASAKSEHIR,GUVERCINTEPE MAH.,407,342,335,168,167
BASAKSEHIR,GUVERCINTEPE MAH.,407,358,356,154,202
BASAKSEHIR,GUVERCINTEPE MAH.,406,351,349,135,214
BASAKSEHIR,GUVERCINTEPE MAH.,407,353,342,133,209
BASAKSEHIR,GUVERCINTEPE MAH.,407,365,357,174,183
BASAKSEHIR,GUVERCINTEPE MAH.,407,366,362,187,175
BASAKSEHIR,GUVERCINTEPE MAH.,407,366,358,170,188
BASAKSEHIR,SAHINTEPE MAH.,406,329,323,134,189
BASAKSEHIR,SAHINTEPE MAH.,410,338,334,136,198
BASAKSEHIR,SAHINTEPE MAH.,404,354,353,161,192
BASAKSEHIR,SAHINTEPE MAH.,404,353,344,119,225
BASAKSEHIR,SAHINTEPE MAH.,406,359,351,161,190
BASAKSEHIR,SAHINTEPE MAH.,407,372,362,151,211
BASAKSEHIR,SAHINTEPE MAH.,406,347,337,156,181
BASAKSEHIR,SAHINTEPE MAH.,406,350,350,160,190
BASAKSEHIR,SAHINTEPE MAH.,405,352,347,135,212
BASAKSEHIR,SAHINTEPE MAH.,406,341,328,173,155
BASAKSEHIR,SAHINTEPE MAH.,408,334,332,178,154
BASAKSEHIR,SAHINTEPE MAH.,406,359,348,186,162
BASAKSEHIR,SAHINTEPE MAH.,407,363,355,203,152
BASAKSEHIR,SAHINTEPE MAH.,406,347,334,199,135
BASAKSEHIR,SAHINTEPE MAH.,405,358,353,168,185
BASAKSEHIR,SAHINTEPE MAH.,409,369,361,196,165
BASAKSEHIR,SAHINTEPE MAH.,406,367,359,203,156
BASAKSEHIR,SAHINTEPE MAH.,405,347,337,187,150
BASAKSEHIR,SAHINTEPE MAH.,406,375,369,190,179
BASAKSEHIR,SAHINTEPE MAH.,406,356,350,198,152
BASAKSEHIR,SAHINTEPE MAH.,406,356,352,179,173
BASAKSEHIR,SAHINTEPE MAH.,406,352,343,182,161
BASAKSEHIR,SAHINTEPE MAH.,406,352,347,157,190
BASAKSEHIR,SAHINTEPE MAH.,406,348,340,150,190
BASAKSEHIR,SAHINTEPE MAH.,406,353,348,187,161
BASAKSEHIR,SAHINTEPE MAH.,407,352,347,164,183
BASAKSEHIR,SAHINTEPE MAH.,406,336,327,200,127
BASAKSEHIR,SAHINTEPE MAH.,405,356,352,191,161
BASAKSEHIR,SAHINTEPE MAH.,405,361,354,179,175
BASAKSEHIR,SAHINTEPE MAH.,402,349,336,150,186
BASAKSEHIR,SAHINTEPE MAH.,401,316,303,137,166
BASAKSEHIR,SAHINTEPE MAH.,401,345,340,187,153
BASAKSEHIR,SAHINTEPE MAH.,404,356,348,188,160
BASAKSEHIR,SAHINTEPE MAH.,402,352,343,165,178
BASAKSEHIR,SAHINTEPE MAH.,402,348,346,173,173
BASAKSEHIR,SAHINTEPE MAH.,401,335,331,163,168
BASAKSEHIR,SAHINTEPE MAH.,401,334,328,152,176
BASAKSEHIR,SAHINTEPE MAH.,401,357,346,162,184
BASAKSEHIR,SAHINTEPE MAH.,402,342,331,142,189
BASAKSEHIR,SAHINTEPE MAH.,400,332,326,138,188
BASAKSEHIR,SAHINTEPE MAH.,400,340,334,155,179
BASAKSEHIR,SAHINTEPE MAH.,400,347,338,123,215
BASAKSEHIR,SAHINTEPE MAH.,401,348,337,161,176
BASAKSEHIR,SAHINTEPE MAH.,401,347,337,156,181
BASAKSEHIR,SAHINTEPE MAH.,400,342,331,175,156
BASAKSEHIR,SAHINTEPE MAH.,400,338,333,146,187
BASAKSEHIR,SAHINTEPE MAH.,400,348,341,156,185
BASAKSEHIR,SAHINTEPE MAH.,401,352,340,145,195
BASAKSEHIR,SAHINTEPE MAH.,401,340,333,180,153
BASAKSEHIR,SAHINTEPE MAH.,401,340,334,165,169
BASAKSEHIR,SAHINTEPE MAH.,405,370,366,172,194
BASAKSEHIR,SAHINTEPE MAH.,401,359,357,166,191
BASAKSEHIR,SAHINTEPE MAH.,401,356,350,157,193
BASAKSEHIR,SAHINTEPE MAH.,400,344,336,146,190
BASAKSEHIR,SAHINTEPE MAH.,401,338,319,146,173
BASAKSEHIR,SAHINTEPE MAH.,401,348,342,152,190
BASAKSEHIR,ZIYA GOKALP MAH.,284,221,217,85,132
BASAKSEHIR,ZIYA GOKALP MAH.,284,241,237,87,150
BASAKSEHIR,ZIYA GOKALP MAH.,413,369,363,118,245
BASAKSEHIR,ZIYA GOKALP MAH.,413,374,372,146,226
BASAKSEHIR,ZIYA GOKALP MAH.,413,347,340,101,239
BASAKSEHIR,ZIYA GOKALP MAH.,412,368,366,132,234
BASAKSEHIR,ZIYA GOKALP MAH.,415,369,365,125,240
BASAKSEHIR,ZIYA GOKALP MAH.,413,385,383,158,225
BASAKSEHIR,ZIYA GOKALP MAH.,403,360,346,148,198
BASAKSEHIR,ZIYA GOKALP MAH.,401,358,351,149,202
BASAKSEHIR,ZIYA GOKALP MAH.,400,360,349,179,170
BASAKSEHIR,ZIYA GOKALP MAH.,400,344,334,159,175
BASAKSEHIR,ZIYA GOKALP MAH.,402,345,329,146,183
BASAKSEHIR,ZIYA GOKALP MAH.,400,353,349,170,179
BASAKSEHIR,ZIYA GOKALP MAH.,392,308,298,122,176
BASAKSEHIR,ZIYA GOKALP MAH.,393,337,326,130,196
BASAKSEHIR,ZIYA GOKALP MAH.,392,353,346,131,215
BASAKSEHIR,ZIYA GOKALP MAH.,393,347,344,148,196
BASAKSEHIR,ZIYA GOKALP MAH.,392,330,325,130,195
BASAKSEHIR,ZIYA GOKALP MAH.,392,323,319,156,163
BASAKSEHIR,ZIYA GOKALP MAH.,393,347,340,167,173
BASAKSEHIR,ZIYA GOKALP MAH.,394,350,343,150,193
BASAKSEHIR,ZIYA GOKALP MAH.,393,345,335,136,199
BASAKSEHIR,ZIYA GOKALP MAH.,393,337,332,120,212
BASAKSEHIR,ZIYA GOKALP MAH.,393,317,307,124,183
BASAKSEHIR,ZIYA GOKALP MAH.,393,343,336,135,201
BASAKSEHIR,ZIYA GOKALP MAH.,392,340,330,128,202
BASAKSEHIR,ZIYA GOKALP MAH.,392,357,347,150,197
BASAKSEHIR,ZIYA GOKALP MAH.,392,337,329,156,173
BASAKSEHIR,ZIYA GOKALP MAH.,393,340,335,134,201
BASAKSEHIR,ZIYA GOKALP MAH.,391,355,347,154,193
BAGCILAR,CINAR MAH.,401,329,321,173,148
BAGCILAR,CINAR MAH.,401,340,335,204,131
BAGCILAR,CINAR MAH.,400,360,359,189,170
BAGCILAR,CINAR MAH.,400,348,344,221,123
BAGCILAR,CINAR MAH.,403,356,349,212,137
BAGCILAR,CINAR MAH.,401,355,347,212,135
BAGCILAR,CINAR MAH.,400,348,342,205,137
BAGCILAR,CINAR MAH.,403,367,359,221,138
BAGCILAR,CINAR MAH.,400,352,343,212,131
BAGCILAR,CINAR MAH.,402,341,338,215,123
BAGCILAR,CINAR MAH.,400,359,356,243,113
BAGCILAR,CINAR MAH.,401,352,349,237,112
BAGCILAR,CINAR MAH.,404,368,361,224,137
BAGCILAR,CINAR MAH.,400,367,357,240,117
BAGCILAR,CINAR MAH.,401,359,353,236,117
BAGCILAR,CINAR MAH.,401,351,344,182,162
BAGCILAR,CINAR MAH.,401,368,362,210,152
BAGCILAR,CINAR MAH.,415,336,325,199,126
BAGCILAR,CINAR MAH.,412,324,318,168,150
BAGCILAR,CINAR MAH.,415,359,349,239,110
BAGCILAR,CINAR MAH.,412,346,342,203,139
BAGCILAR,CINAR MAH.,410,359,353,217,136
BAGCILAR,CINAR MAH.,415,380,375,241,134
BAGCILAR,CINAR MAH.,412,372,366,229,137
BAGCILAR,CINAR MAH.,415,366,360,223,137
BAGCILAR,CINAR MAH.,412,373,369,242,127
BAGCILAR,CINAR MAH.,410,363,360,210,150
BAGCILAR,CINAR MAH.,410,374,368,239,129
BAGCILAR,CINAR MAH.,410,367,361,193,168
BAGCILAR,CINAR MAH.,415,387,379,235,144
BAGCILAR,CINAR MAH.,410,365,360,215,145
BAGCILAR,CINAR MAH.,411,353,351,226,125
BAGCILAR,CINAR MAH.,412,361,353,232,121
BAGCILAR,CINAR MAH.,410,362,358,202,156
BAGCILAR,CINAR MAH.,412,370,366,236,130
BAGCILAR,CINAR MAH.,412,376,374,203,171
BAGCILAR,CINAR MAH.,412,359,353,208,145
BAGCILAR,CINAR MAH.,412,365,360,239,121
BAGCILAR,CINAR MAH.,411,351,349,224,125
BAGCILAR,CINAR MAH.,411,376,368,242,126
BAGCILAR,CINAR MAH.,411,355,348,233,115
BAGCILAR,CINAR MAH.,411,351,347,217,130
BAGCILAR,CINAR MAH.,412,361,355,232,123
BAGCILAR,CINAR MAH.,411,313,308,199,109
BAGCILAR,CINAR MAH.,415,342,338,228,110
BAGCILAR,CINAR MAH.,415,363,349,210,139
BAGCILAR,CINAR MAH.,411,368,362,254,108
BAGCILAR,CINAR MAH.,411,374,372,258,114
BAGCILAR,CINAR MAH.,410,358,352,219,133
BAGCILAR,CINAR MAH.,415,346,343,221,122
BAGCILAR,CINAR MAH.,411,365,359,266,93
BAGCILAR,CINAR MAH.,410,384,379,242,137
BAGCILAR,CINAR MAH.,410,361,353,234,119
BAGCILAR,CINAR MAH.,411,368,362,243,119
BAGCILAR,CINAR MAH.,410,349,347,231,116
BAGCILAR,CINAR MAH.,410,371,366,246,120
BAGCILAR,CINAR MAH.,411,373,364,237,127
BAGCILAR,CINAR MAH.,411,364,357,219,138
BAGCILAR,CINAR MAH.,409,366,365,238,127
BAGCILAR,CINAR MAH.,410,365,359,242,117
BAGCILAR,CINAR MAH.,410,367,363,251,112
BAGCILAR,CINAR MAH.,410,369,365,252,113
BAGCILAR,CINAR MAH.,410,361,358,248,110
BAGCILAR,INONU MAH.,403,343,336,179,157
BAGCILAR,INONU MAH.,403,344,337,216,121
BAGCILAR,INONU MAH.,401,347,344,227,117
BAGCILAR,INONU MAH.,401,365,360,195,165
BAGCILAR,INONU MAH.,400,359,356,207,149
BAGCILAR,INONU MAH.,401,348,344,224,120
BAGCILAR,INONU MAH.,400,356,353,224,129
BAGCILAR,INONU MAH.,401,354,347,217,130
BAGCILAR,INONU MAH.,401,362,357,228,129
BAGCILAR,INONU MAH.,400,359,355,221,134
BAGCILAR,INONU MAH.,400,358,354,221,133
BAGCILAR,INONU MAH.,400,360,356,235,121
BAGCILAR,INONU MAH.,400,354,347,228,119
BAGCILAR,INONU MAH.,400,349,342,201,141
BAGCILAR,INONU MAH.,399,349,344,221,123
BAGCILAR,INONU MAH.,403,350,344,214,130
BAGCILAR,INONU MAH.,400,347,341,228,113
BAGCILAR,INONU MAH.,400,360,359,236,123
BAGCILAR,INONU MAH.,405,353,350,228,122
BAGCILAR,INONU MAH.,401,369,364,212,152
BAGCILAR,INONU MAH.,401,354,350,208,142
BAGCILAR,INONU MAH.,400,359,355,216,139
BAGCILAR,INONU MAH.,401,350,348,224,124
BAGCILAR,INONU MAH.,401,365,361,226,135
BAGCILAR,INONU MAH.,400,354,350,206,144
BAGCILAR,INONU MAH.,403,356,349,207,142
BAGCILAR,INONU MAH.,400,358,357,238,119
BAGCILAR,INONU MAH.,409,349,346,241,105
BAGCILAR,INONU MAH.,415,375,365,248,117
BAGCILAR,INONU MAH.,410,377,369,206,163
BAGCILAR,INONU MAH.,409,369,366,245,121
BAGCILAR,INONU MAH.,410,369,364,244,120
BAGCILAR,INONU MAH.,409,362,353,247,106
BAGCILAR,INONU MAH.,410,372,366,256,110
BAGCILAR,INONU MAH.,410,371,370,254,116
BAGCILAR,INONU MAH.,410,356,355,233,122
BAGCILAR,INONU MAH.,409,356,350,242,108
BAGCILAR,INONU MAH.,409,367,366,245,121
BAGCILAR,INONU MAH.,410,354,346,232,114
BAGCILAR,INONU MAH.,411,350,347,239,108
BAGCILAR,INONU MAH.,409,366,361,259,102
BAGCILAR,INONU MAH.,410,363,358,240,118
BAGCILAR,INONU MAH.,410,373,369,250,119
BAGCILAR,MERKEZ MAH.,411,333,322,179,143
BAGCILAR,MERKEZ MAH.,415,331,329,184,145
BAGCILAR,MERKEZ MAH.,415,363,357,190,167
BAGCILAR,MERKEZ MAH.,411,374,372,173,199
BAGCILAR,MERKEZ MAH.,415,369,362,193,169
BAGCILAR,MERKEZ MAH.,411,365,356,183,173
BAGCILAR,MERKEZ MAH.,415,367,365,171,194
BAGCILAR,MERKEZ MAH.,411,352,345,182,163
BAGCILAR,MERKEZ MAH.,411,357,347,189,158
BAGCILAR,MERKEZ MAH.,411,351,343,206,137
BAGCILAR,MERKEZ MAH.,412,352,351,193,158
BAGCILAR,MERKEZ MAH.,411,355,352,188,164
BAGCILAR,MERKEZ MAH.,410,365,363,218,145
BAGCILAR,MERKEZ MAH.,415,366,359,176,183
BAGCILAR,MERKEZ MAH.,415,383,373,200,173
BAGCILAR,MERKEZ MAH.,411,366,356,185,171
BAGCILAR,MERKEZ MAH.,410,361,357,197,160
BAGCILAR,MERKEZ MAH.,415,379,376,217,159
BAGCILAR,MERKEZ MAH.,410,352,348,203,145
BAGCILAR,MERKEZ MAH.,412,370,366,196,170
BAGCILAR,MERKEZ MAH.,411,360,354,183,171
BAGCILAR,MERKEZ MAH.,410,357,351,207,144
BAGCILAR,MERKEZ MAH.,415,333,327,204,123
BAGCILAR,MERKEZ MAH.,411,343,334,180,154
BAGCILAR,MERKEZ MAH.,410,356,350,210,140
BAGCILAR,MERKEZ MAH.,415,379,373,228,145
BAGCILAR,MERKEZ MAH.,415,357,348,208,140
BAGCILAR,MERKEZ MAH.,413,370,364,198,166
BAGCILAR,MERKEZ MAH.,413,370,360,230,130
BAGCILAR,MERKEZ MAH.,410,366,362,225,137
BAGCILAR,MERKEZ MAH.,410,351,350,217,133
BAGCILAR,MERKEZ MAH.,410,352,345,224,121
BAGCILAR,MERKEZ MAH.,413,379,374,231,143
BAGCILAR,MERKEZ MAH.,413,354,348,205,143
BAGCILAR,MERKEZ MAH.,411,350,347,206,141
BAGCILAR,MERKEZ MAH.,413,379,374,226,148
BAGCILAR,MERKEZ MAH.,415,355,354,218,136
BAGCILAR,MERKEZ MAH.,413,366,360,235,125
BAGCILAR,MERKEZ MAH.,413,372,369,215,154
BAGCILAR,MERKEZ MAH.,413,372,366,220,146
BAGCILAR,MERKEZ MAH.,413,368,364,217,147
BAGCILAR,MERKEZ MAH.,415,375,371,247,124
BAGCILAR,MERKEZ MAH.,413,369,366,220,146
BAGCILAR,MERKEZ MAH.,412,358,352,207,145
BAGCILAR,MERKEZ MAH.,412,366,351,230,121
BAGCILAR,SANCAKTEPE MAH.,415,354,348,205,143
BAGCILAR,SANCAKTEPE MAH.,415,350,341,176,165
BAGCILAR,SANCAKTEPE MAH.,416,377,370,230,140
BAGCILAR,SANCAKTEPE MAH.,416,371,366,227,139
BAGCILAR,SANCAKTEPE MAH.,415,380,378,234,144
BAGCILAR,SANCAKTEPE MAH.,415,373,367,223,144
BAGCILAR,SANCAKTEPE MAH.,415,368,363,208,155
BAGCILAR,SANCAKTEPE MAH.,416,373,370,227,143
BAGCILAR,SANCAKTEPE MAH.,416,381,377,247,130
BAGCILAR,SANCAKTEPE MAH.,415,373,368,228,140
BAGCILAR,SANCAKTEPE MAH.,415,382,380,240,140
BAGCILAR,SANCAKTEPE MAH.,415,371,368,224,144
BAGCILAR,SANCAKTEPE MAH.,414,373,369,223,146
BAGCILAR,SANCAKTEPE MAH.,414,371,362,195,167
BAGCILAR,SANCAKTEPE MAH.,415,376,370,232,138
BAGCILAR,SANCAKTEPE MAH.,414,378,368,253,115
BAGCILAR,SANCAKTEPE MAH.,415,359,355,229,126
BAGCILAR,SANCAKTEPE MAH.,413,381,371,234,137
BAGCILAR,SANCAKTEPE MAH.,414,354,352,220,132
BAGCILAR,SANCAKTEPE MAH.,392,318,309,131,178
BAGCILAR,SANCAKTEPE MAH.,391,334,331,152,179
BAGCILAR,SANCAKTEPE MAH.,391,347,336,155,181
BAGCILAR,SANCAKTEPE MAH.,391,344,341,120,221
BAGCILAR,SANCAKTEPE MAH.,391,352,348,165,183
BAGCILAR,SANCAKTEPE MAH.,392,356,354,195,159
BAGCILAR,SANCAKTEPE MAH.,391,352,348,165,183
BAGCILAR,SANCAKTEPE MAH.,392,347,343,181,162
BAGCILAR,SANCAKTEPE MAH.,393,336,330,166,164
BAGCILAR,SANCAKTEPE MAH.,391,359,356,184,172
BAGCILAR,SANCAKTEPE MAH.,391,339,334,183,151
BAGCILAR,SANCAKTEPE MAH.,393,327,325,135,190
BAGCILAR,SANCAKTEPE MAH.,391,346,341,150,191
BAGCILAR,SANCAKTEPE MAH.,391,346,341,149,192
BAGCILAR,SANCAKTEPE MAH.,391,348,341,184,157
BAGCILAR,YAVUZ SELIM MAH.,408,345,339,210,129
BAGCILAR,YAVUZ SELIM MAH.,409,367,361,247,114
BAGCILAR,YAVUZ SELIM MAH.,409,373,370,248,122
BAGCILAR,YAVUZ SELIM MAH.,407,354,351,246,105
BAGCILAR,YAVUZ SELIM MAH.,408,371,366,218,148
BAGCILAR,YAVUZ SELIM MAH.,407,372,361,219,142
BAGCILAR,YAVUZ SELIM MAH.,407,357,351,231,120
BAGCILAR,YAVUZ SELIM MAH.,410,360,352,217,135
BAGCILAR,YAVUZ SELIM MAH.,408,371,369,239,130
BAGCILAR,YAVUZ SELIM MAH.,407,356,353,203,150
BAGCILAR,YAVUZ SELIM MAH.,407,360,357,212,145
BAGCILAR,YAVUZ SELIM MAH.,406,380,377,247,130
BAGCILAR,YAVUZ SELIM MAH.,406,369,367,283,84
BAGCILAR,YAVUZ SELIM MAH.,408,367,365,225,140
BAGCILAR,YAVUZ SELIM MAH.,408,364,355,225,130
BAGCILAR,YAVUZ SELIM MAH.,406,371,368,240,128
BAGCILAR,YAVUZ SELIM MAH.,408,358,351,207,144
BAGCILAR,YAVUZ SELIM MAH.,408,361,357,229,128
BAGCILAR,YAVUZ SELIM MAH.,407,370,364,226,138
BAGCILAR,YAVUZ SELIM MAH.,412,345,334,208,126
BAGCILAR,YAVUZ SELIM MAH.,412,344,335,182,153
BAGCILAR,YAVUZ SELIM MAH.,415,359,354,218,136
BAGCILAR,YAVUZ SELIM MAH.,412,361,355,203,152
BAGCILAR,YAVUZ SELIM MAH.,415,378,372,258,114
BAGCILAR,YAVUZ SELIM MAH.,415,365,360,212,148
BAGCILAR,YAVUZ SELIM MAH.,415,375,365,198,167
BAGCILAR,YAVUZ SELIM MAH.,415,367,358,223,135
BAGCILAR,YAVUZ SELIM MAH.,411,351,345,206,139
BAGCILAR,YAVUZ SELIM MAH.,412,357,356,227,129
BAGCILAR,YAVUZ SELIM MAH.,412,358,356,231,125
BAGCILAR,YAVUZ SELIM MAH.,411,379,376,227,149
BAGCILAR,YAVUZ SELIM MAH.,412,365,361,212,149
BAGCILAR,YAVUZ SELIM MAH.,412,354,352,223,129
BAGCILAR,YAVUZ SELIM MAH.,412,373,367,242,125
BAGCILAR,YAVUZ SELIM MAH.,412,351,348,212,136
BAGCILAR,YAVUZ SELIM MAH.,412,361,357,227,130
BAGCILAR,YAVUZ SELIM MAH.,412,358,353,191,162
BAGCILAR,YAVUZ SELIM MAH.,412,366,364,198,166
BAGCILAR,YAVUZ SELIM MAH.,411,350,346,190,156
BAGCILAR,YAVUZ SELIM MAH.,412,370,366,242,124
BAGCILAR,YAVUZ SELIM MAH.,412,352,344,215,129
BAGCILAR,YAVUZ SELIM MAH.,412,365,357,218,139
BAGCILAR,YAVUZ SELIM MAH.,410,367,356,228,128
BAGCILAR,YAVUZ SELIM MAH.,412,365,358,195,163
BAGCILAR,YAVUZ SELIM MAH.,410,371,369,221,148
BAGCILAR,YAVUZ SELIM MAH.,411,362,356,217,139
BAGCILAR,YAVUZ SELIM MAH.,410,366,365,235,130
BAGCILAR,YAVUZ SELIM MAH.,410,362,355,246,109
BAGCILAR,YAVUZ SELIM MAH.,412,349,340,195,145
BAGCILAR,YAVUZ SELIM MAH.,412,372,366,234,132
BAGCILAR,YENIGUN MAH.,404,329,323,208,115
BAGCILAR,YENIGUN MAH.,405,337,333,244,89
BAGCILAR,YENIGUN MAH.,405,332,327,237,90
BAGCILAR,YENIGUN MAH.,406,341,336,218,118
BAGCILAR,YENIGUN MAH.,405,350,346,223,123
BAGCILAR,YENIGUN MAH.,405,351,348,214,134
BAGCILAR,YENIGUN MAH.,406,359,353,216,137
BAGCILAR,YENIGUN MAH.,407,359,356,217,139
BAGCILAR,YENIGUN MAH.,406,371,368,253,115
BAGCILAR,YENIGUN MAH.,407,365,364,232,132
BAGCILAR,YENIGUN MAH.,405,375,366,226,140
BAGCILAR,YENIGUN MAH.,405,362,356,227,129
BAGCILAR,YENIGUN MAH.,405,357,354,234,120
BAGCILAR,YENIGUN MAH.,406,368,365,239,126
BAGCILAR,YENIGUN MAH.,406,359,346,238,108
BAGCILAR,YENIGUN MAH.,406,363,358,235,123
BAGCILAR,YENIGUN MAH.,405,363,360,236,124
BAGCILAR,YENIGUN MAH.,405,366,365,224,141
BAGCILAR,YENIGUN MAH.,405,364,361,220,141
BAGCILAR,YENIGUN MAH.,406,367,361,223,138
BAGCILAR,YENIGUN MAH.,406,356,353,226,127
BAGCILAR,YENIGUN MAH.,406,365,361,245,116
BAGCILAR,YENIGUN MAH.,409,362,360,219,141
BAGCILAR,YENIGUN MAH.,405,363,362,241,121
BAGCILAR,YENIGUN MAH.,404,370,366,246,120
BAGCILAR,YENIGUN MAH.,404,348,342,213,129
BAGCILAR,YENIGUN MAH.,405,362,352,216,136
BAGCILAR,YENIGUN MAH.,406,367,365,257,108
BAGCILAR,YENIGUN MAH.,405,368,360,231,129
BAGCILAR,YENIGUN MAH.,405,356,351,216,135
BAGCILAR,YENIGUN MAH.,406,355,348,199,149
BAGCILAR,YENIGUN MAH.,405,335,331,212,119
BAGCILAR,YENIGUN MAH.,406,356,351,218,133
BAGCILAR,YENIGUN MAH.,408,346,340,227,113
BAGCILAR,YENIGUN MAH.,406,351,347,239,108
BAGCILAR,YENIGUN MAH.,405,356,350,278,72
BAGCILAR,YENIGUN MAH.,406,370,363,249,114
BAGCILAR,YENIGUN MAH.,406,352,348,254,94
BAGCILAR,YENIGUN MAH.,406,372,367,240,127
BAGCILAR,YENIGUN MAH.,406,360,356,231,125
BAGCILAR,YENIGUN MAH.,405,350,348,247,101
BAGCILAR,BAGLAR MAH.,411,339,333,144,189
BAGCILAR,BAGLAR MAH.,411,319,316,111,205
BAGCILAR,BAGLAR MAH.,412,371,366,156,210
BAGCILAR,BAGLAR MAH.,409,361,356,168,188
BAGCILAR,BAGLAR MAH.,409,377,371,167,204
BAGCILAR,BAGLAR MAH.,409,365,356,190,166
BAGCILAR,BAGLAR MAH.,409,358,350,148,202
BAGCILAR,BAGLAR MAH.,409,366,362,165,197
BAGCILAR,BAGLAR MAH.,409,365,360,167,193
BAGCILAR,BAGLAR MAH.,409,364,359,173,186
BAGCILAR,BAGLAR MAH.,410,379,372,162,210
BAGCILAR,BAGLAR MAH.,409,366,364,186,178
BAGCILAR,BAGLAR MAH.,409,357,348,167,181
BAGCILAR,BAGLAR MAH.,409,373,367,156,211
BAGCILAR,BAGLAR MAH.,409,372,367,171,196
BAGCILAR,BAGLAR MAH.,409,363,358,172,186
BAGCILAR,BAGLAR MAH.,409,377,374,156,218
BAGCILAR,BAGLAR MAH.,410,370,367,150,217
BAGCILAR,BAGLAR MAH.,411,360,356,157,199
BAGCILAR,BAGLAR MAH.,409,366,364,129,235
BAGCILAR,BAGLAR MAH.,409,370,366,172,194
BAGCILAR,BAGLAR MAH.,409,371,365,170,195
BAGCILAR,BAGLAR MAH.,409,370,365,184,181
BAGCILAR,BAGLAR MAH.,409,371,362,147,215
BAGCILAR,BAGLAR MAH.,410,380,377,163,214
BAGCILAR,BAGLAR MAH.,409,359,357,138,219
BAGCILAR,BARBAROS MAH.,413,343,338,210,128
BAGCILAR,BARBAROS MAH.,415,352,338,218,120
BAGCILAR,BARBAROS MAH.,415,341,332,202,130
BAGCILAR,BARBAROS MAH.,415,351,348,216,132
BAGCILAR,BARBAROS MAH.,415,363,352,197,155
BAGCILAR,BARBAROS MAH.,415,365,361,205,156
BAGCILAR,BARBAROS MAH.,415,347,339,216,123
BAGCILAR,BARBAROS MAH.,415,352,349,241,108
BAGCILAR,BARBAROS MAH.,415,373,369,242,127
BAGCILAR,BARBAROS MAH.,414,373,368,225,143
BAGCILAR,BARBAROS MAH.,415,363,361,199,162
BAGCILAR,BARBAROS MAH.,415,361,354,226,128
BAGCILAR,BARBAROS MAH.,414,366,355,232,123
BAGCILAR,BARBAROS MAH.,414,367,358,234,124
BAGCILAR,BARBAROS MAH.,414,368,358,237,121
BAGCILAR,BARBAROS MAH.,415,372,368,227,141
BAGCILAR,BARBAROS MAH.,414,370,362,214,148
BAGCILAR,BARBAROS MAH.,415,355,347,241,106
BAGCILAR,BARBAROS MAH.,415,373,369,236,133
BAGCILAR,BARBAROS MAH.,415,368,361,221,140
BAGCILAR,BARBAROS MAH.,415,360,358,216,142
BAGCILAR,BARBAROS MAH.,415,359,357,224,133
BAGCILAR,BARBAROS MAH.,414,371,367,242,125
BAGCILAR,BARBAROS MAH.,415,371,370,242,128
BAGCILAR,BARBAROS MAH.,414,370,363,250,113
BAGCILAR,BARBAROS MAH.,415,383,377,222,155
BAGCILAR,BARBAROS MAH.,415,370,367,233,134
BAGCILAR,BARBAROS MAH.,415,361,360,221,139
BAGCILAR,BARBAROS MAH.,413,373,369,250,119
BAGCILAR,BARBAROS MAH.,413,368,363,228,135
BAGCILAR,BARBAROS MAH.,414,360,354,216,138
BAGCILAR,BARBAROS MAH.,414,358,354,211,143
BAGCILAR,BARBAROS MAH.,414,369,360,214,146
BAGCILAR,BARBAROS MAH.,412,369,365,237,128
BAGCILAR,BARBAROS MAH.,413,365,362,214,148
BAGCILAR,BARBAROS MAH.,412,352,347,237,110
BAGCILAR,HURRIYET MAH.,408,327,316,124,192
BAGCILAR,HURRIYET MAH.,407,325,314,114,200
BAGCILAR,HURRIYET MAH.,406,318,300,139,161
BAGCILAR,HURRIYET MAH.,407,313,306,128,178
BAGCILAR,HURRIYET MAH.,406,357,351,177,174
BAGCILAR,HURRIYET MAH.,407,354,348,178,170
BAGCILAR,HURRIYET MAH.,406,351,349,198,151
BAGCILAR,HURRIYET MAH.,407,370,366,176,190
BAGCILAR,HURRIYET MAH.,406,365,361,189,172
BAGCILAR,HURRIYET MAH.,406,358,356,184,172
BAGCILAR,HURRIYET MAH.,407,363,354,197,157
BAGCILAR,HURRIYET MAH.,407,359,354,176,178
BAGCILAR,HURRIYET MAH.,407,369,365,165,200
BAGCILAR,HURRIYET MAH.,406,366,363,182,181
BAGCILAR,HURRIYET MAH.,406,374,364,163,201
BAGCILAR,HURRIYET MAH.,409,361,352,177,175
BAGCILAR,HURRIYET MAH.,406,369,361,169,192
BAGCILAR,HURRIYET MAH.,407,359,355,177,178
BAGCILAR,HURRIYET MAH.,406,341,335,177,158
BAGCILAR,HURRIYET MAH.,407,376,374,201,173
BAGCILAR,HURRIYET MAH.,407,361,352,184,168
BAGCILAR,HURRIYET MAH.,408,361,351,181,170
BAGCILAR,HURRIYET MAH.,406,367,362,176,186
BAGCILAR,HURRIYET MAH.,407,370,366,178,188
BAGCILAR,HURRIYET MAH.,406,356,350,170,180
BAGCILAR,HURRIYET MAH.,407,346,341,171,170
BAGCILAR,HURRIYET MAH.,406,359,356,182,174
BAGCILAR,HURRIYET MAH.,408,363,358,153,205
BAGCILAR,HURRIYET MAH.,407,367,362,180,182
BAGCILAR,HURRIYET MAH.,410,351,348,175,173
BAGCILAR,HURRIYET MAH.,407,363,360,175,185
BAGCILAR,HURRIYET MAH.,406,366,356,168,188
BAGCILAR,HURRIYET MAH.,406,358,349,170,179
BAGCILAR,HURRIYET MAH.,406,364,355,177,178
BAGCILAR,HURRIYET MAH.,406,366,359,186,173
BAGCILAR,HURRIYET MAH.,408,375,373,177,196
BAGCILAR,HURRIYET MAH.,407,352,347,154,193
BAGCILAR,HURRIYET MAH.,406,356,352,204,148
BAGCILAR,HURRIYET MAH.,406,351,348,179,169
BAGCILAR,HURRIYET MAH.,407,351,344,172,172
BAGCILAR,HURRIYET MAH.,407,369,368,197,171
BAGCILAR,HURRIYET MAH.,407,362,358,188,170
BAGCILAR,HURRIYET MAH.,406,361,351,173,178
BAGCILAR,HURRIYET MAH.,406,364,359,191,168
BAGCILAR,HURRIYET MAH.,407,368,364,160,204
BAGCILAR,KAZIM KARABEKIR MAH.,407,340,335,216,119
BAGCILAR,KAZIM KARABEKIR MAH.,407,340,332,186,146
BAGCILAR,KAZIM KARABEKIR MAH.,407,373,365,242,123
BAGCILAR,KAZIM KARABEKIR MAH.,407,357,349,219,130
BAGCILAR,KAZIM KARABEKIR MAH.,406,373,366,230,136
BAGCILAR,KAZIM KARABEKIR MAH.,407,363,358,231,127
BAGCILAR,KAZIM KARABEKIR MAH.,409,363,348,207,141
BAGCILAR,KAZIM KARABEKIR MAH.,406,361,356,203,153
BAGCILAR,KAZIM KARABEKIR MAH.,406,349,337,230,107
BAGCILAR,KAZIM KARABEKIR MAH.,408,366,360,247,113
BAGCILAR,KAZIM KARABEKIR MAH.,408,365,360,227,133
BAGCILAR,KAZIM KARABEKIR MAH.,408,364,359,240,119
BAGCILAR,KAZIM KARABEKIR MAH.,406,364,359,221,138
BAGCILAR,KAZIM KARABEKIR MAH.,406,375,371,242,129
BAGCILAR,KAZIM KARABEKIR MAH.,407,359,346,230,116
BAGCILAR,KAZIM KARABEKIR MAH.,407,363,358,209,149
BAGCILAR,KAZIM KARABEKIR MAH.,407,368,363,242,121
BAGCILAR,KAZIM KARABEKIR MAH.,406,344,338,198,140
BAGCILAR,KAZIM KARABEKIR MAH.,407,358,350,226,124
BAGCILAR,KAZIM KARABEKIR MAH.,407,365,355,228,127
BAGCILAR,KAZIM KARABEKIR MAH.,406,367,361,242,119
BAGCILAR,KAZIM KARABEKIR MAH.,407,363,354,227,127
BAGCILAR,KAZIM KARABEKIR MAH.,406,353,343,220,123
BAGCILAR,KAZIM KARABEKIR MAH.,405,358,353,223,130
BAGCILAR,KAZIM KARABEKIR MAH.,406,371,367,225,142
BAGCILAR,KAZIM KARABEKIR MAH.,407,359,353,259,94
BAGCILAR,KAZIM KARABEKIR MAH.,408,339,335,213,122
BAGCILAR,KAZIM KARABEKIR MAH.,410,352,349,226,123
BAGCILAR,KAZIM KARABEKIR MAH.,408,376,370,211,159
BAGCILAR,KAZIM KARABEKIR MAH.,408,365,356,210,146
BAGCILAR,KAZIM KARABEKIR MAH.,409,365,358,228,130
BAGCILAR,KAZIM KARABEKIR MAH.,408,372,364,233,131
BAGCILAR,KAZIM KARABEKIR MAH.,408,359,354,220,134
BAGCILAR,KAZIM KARABEKIR MAH.,411,364,359,221,138
BAGCILAR,KAZIM KARABEKIR MAH.,408,353,348,218,130
BAGCILAR,KAZIM KARABEKIR MAH.,407,381,381,214,167
BAGCILAR,KAZIM KARABEKIR MAH.,408,372,365,236,129
BAGCILAR,KAZIM KARABEKIR MAH.,407,380,375,245,130
BAGCILAR,KAZIM KARABEKIR MAH.,407,363,359,197,162
BAGCILAR,KAZIM KARABEKIR MAH.,408,358,353,225,128
BAGCILAR,KAZIM KARABEKIR MAH.,407,353,349,200,149
BAGCILAR,KAZIM KARABEKIR MAH.,408,355,353,195,158
BAGCILAR,KAZIM KARABEKIR MAH.,407,359,351,213,138
BAGCILAR,KAZIM KARABEKIR MAH.,407,361,356,247,109
BAGCILAR,KAZIM KARABEKIR MAH.,407,355,347,206,141
BAGCILAR,KAZIM KARABEKIR MAH.,407,368,364,242,122
BAGCILAR,KAZIM KARABEKIR MAH.,407,360,352,229,123
BAGCILAR,KAZIM KARABEKIR MAH.,408,364,361,202,159
BAGCILAR,KIRAZLI MAH.,412,332,324,169,155
BAGCILAR,KIRAZLI MAH.,415,363,357,208,149
BAGCILAR,KIRAZLI MAH.,415,385,375,229,146
BAGCILAR,KIRAZLI MAH.,411,378,373,207,166
BAGCILAR,KIRAZLI MAH.,415,372,364,204,160
BAGCILAR,KIRAZLI MAH.,412,374,369,214,155
BAGCILAR,KIRAZLI MAH.,411,376,371,207,164
BAGCILAR,KIRAZLI MAH.,411,374,371,218,153
BAGCILAR,KIRAZLI MAH.,415,362,358,206,152
BAGCILAR,KIRAZLI MAH.,415,377,373,253,120
BAGCILAR,KIRAZLI MAH.,415,379,376,236,140
BAGCILAR,KIRAZLI MAH.,415,369,363,219,144
BAGCILAR,KIRAZLI MAH.,411,360,355,226,129
BAGCILAR,KIRAZLI MAH.,411,375,370,225,145
BAGCILAR,KIRAZLI MAH.,410,357,348,208,140
BAGCILAR,KIRAZLI MAH.,412,373,365,226,139
BAGCILAR,KIRAZLI MAH.,410,388,377,187,190
BAGCILAR,KIRAZLI MAH.,410,358,352,215,137
BAGCILAR,KIRAZLI MAH.,412,381,378,207,171
BAGCILAR,KIRAZLI MAH.,411,373,367,197,170
BAGCILAR,KIRAZLI MAH.,411,371,363,234,129
BAGCILAR,KIRAZLI MAH.,411,355,348,229,119
BAGCILAR,KIRAZLI MAH.,410,389,384,205,179
BAGCILAR,KIRAZLI MAH.,411,374,369,230,139
BAGCILAR,KIRAZLI MAH.,415,349,340,200,140
BAGCILAR,KIRAZLI MAH.,415,357,352,202,150
BAGCILAR,KIRAZLI MAH.,411,360,352,213,139
BAGCILAR,KIRAZLI MAH.,411,382,376,231,145
BAGCILAR,KIRAZLI MAH.,415,364,355,249,106
BAGCILAR,KIRAZLI MAH.,411,357,350,221,129
BAGCILAR,KIRAZLI MAH.,412,382,376,202,174
BAGCILAR,KIRAZLI MAH.,411,358,352,197,155
BAGCILAR,KIRAZLI MAH.,411,344,338,181,157
BAGCILAR,KIRAZLI MAH.,411,365,361,223,138
BAGCILAR,KIRAZLI MAH.,415,379,375,220,155
BAGCILAR,KIRAZLI MAH.,411,335,330,209,121
BAGCILAR,KIRAZLI MAH.,411,368,363,207,156
BAGCILAR,KIRAZLI MAH.,412,356,348,209,139
BAGCILAR,KIRAZLI MAH.,411,365,359,209,150
BAGCILAR,KIRAZLI MAH.,410,358,356,220,136
BAGCILAR,KIRAZLI MAH.,410,361,354,237,117
BAGCILAR,KIRAZLI MAH.,410,361,354,247,107
BAGCILAR,KIRAZLI MAH.,410,359,353,220,133
BAGCILAR,KIRAZLI MAH.,410,368,365,236,129
BAGCILAR,KIRAZLI MAH.,410,376,370,209,161
BAGCILAR,KIRAZLI MAH.,410,345,341,221,120
BAGCILAR,KIRAZLI MAH.,411,380,375,253,122
BAGCILAR,KIRAZLI MAH.,402,345,333,220,113
BAGCILAR,KIRAZLI MAH.,402,330,317,190,127
BAGCILAR,KIRAZLI MAH.,401,360,355,242,113
BAGCILAR,KIRAZLI MAH.,401,365,359,215,144
BAGCILAR,KIRAZLI MAH.,401,371,366,240,126
BAGCILAR,KIRAZLI MAH.,401,366,359,228,131
BAGCILAR,KIRAZLI MAH.,401,356,350,235,115
BAGCILAR,KIRAZLI MAH.,401,355,353,236,117
BAGCILAR,KIRAZLI MAH.,401,359,354,231,123
BAGCILAR,KIRAZLI MAH.,402,365,358,246,112
BAGCILAR,KIRAZLI MAH.,402,357,352,225,127
BAGCILAR,KIRAZLI MAH.,404,370,366,219,147
BAGCILAR,KIRAZLI MAH.,402,369,364,246,118
BAGCILAR,KIRAZLI MAH.,402,372,366,221,145
BAGCILAR,KIRAZLI MAH.,402,352,349,206,143
BAGCILAR,KIRAZLI MAH.,402,364,361,233,128
BAGCILAR,KIRAZLI MAH.,402,366,362,240,122
BAGCILAR,KIRAZLI MAH.,401,357,351,225,126
BAGCILAR,KIRAZLI MAH.,400,369,363,231,132
BAGCILAR,KIRAZLI MAH.,402,344,338,230,108
BAGCILAR,KIRAZLI MAH.,402,344,341,214,127
BAGCILAR,KIRAZLI MAH.,400,348,340,234,106
BAGCILAR,KIRAZLI MAH.,401,356,347,210,137
BAGCILAR,KIRAZLI MAH.,402,360,352,228,124
BAGCILAR,KIRAZLI MAH.,400,349,343,226,117
BAGCILAR,KIRAZLI MAH.,402,345,343,205,138
BAGCILAR,YILDIZTEPE MAH.,407,347,337,177,160
BAGCILAR,YILDIZTEPE MAH.,409,344,341,176,165
BAGCILAR,YILDIZTEPE MAH.,406,336,331,204,127
BAGCILAR,YILDIZTEPE MAH.,408,346,342,202,140
BAGCILAR,YILDIZTEPE MAH.,406,363,353,215,138
BAGCILAR,YILDIZTEPE MAH.,406,362,355,185,170
BAGCILAR,YILDIZTEPE MAH.,406,354,349,191,158
BAGCILAR,YILDIZTEPE MAH.,406,369,357,229,128
BAGCILAR,YILDIZTEPE MAH.,406,380,375,233,142
BAGCILAR,YILDIZTEPE MAH.,405,349,342,224,118
BAGCILAR,YILDIZTEPE MAH.,406,341,339,235,104
BAGCILAR,YILDIZTEPE MAH.,406,374,368,219,149
BAGCILAR,YILDIZTEPE MAH.,406,364,354,226,128
BAGCILAR,YILDIZTEPE MAH.,407,349,349,217,132
BAGCILAR,YILDIZTEPE MAH.,407,351,347,224,123
BAGCILAR,YILDIZTEPE MAH.,408,364,360,246,114
BAGCILAR,YILDIZTEPE MAH.,406,349,339,206,133
BAGCILAR,YILDIZTEPE MAH.,406,372,370,241,129
BAGCILAR,YILDIZTEPE MAH.,408,375,371,246,125
BAGCILAR,YILDIZTEPE MAH.,405,352,349,212,137
BAGCILAR,YILDIZTEPE MAH.,406,364,358,224,134
BAGCILAR,YILDIZTEPE MAH.,405,366,364,228,136
BAGCILAR,YILDIZTEPE MAH.,406,358,355,209,146
BAGCILAR,YILDIZTEPE MAH.,405,362,361,244,117
BAGCILAR,YILDIZTEPE MAH.,405,349,344,220,124
BAGCILAR,YILDIZTEPE MAH.,406,349,340,225,115
BAGCILAR,YILDIZTEPE MAH.,405,356,348,225,123
BAGCILAR,YILDIZTEPE MAH.,406,335,331,193,138
BAGCILAR,YILDIZTEPE MAH.,406,341,338,212,126
BAGCILAR,YILDIZTEPE MAH.,406,365,361,249,112
BAGCILAR,YILDIZTEPE MAH.,406,369,365,227,138
BAGCILAR,YILDIZTEPE MAH.,407,364,357,216,141
BAGCILAR,YILDIZTEPE MAH.,406,363,362,237,125
BAGCILAR,YILDIZTEPE MAH.,406,347,337,225,112
BAGCILAR,YILDIZTEPE MAH.,406,363,354,247,107
BAGCILAR,YILDIZTEPE MAH.,405,363,358,221,137
BAGCILAR,YILDIZTEPE MAH.,406,352,350,219,131
BAGCILAR,YILDIZTEPE MAH.,410,344,337,234,103
BAGCILAR,YILDIZTEPE MAH.,409,338,329,199,130
BAGCILAR,YILDIZTEPE MAH.,415,337,333,205,128
BAGCILAR,YILDIZTEPE MAH.,415,366,360,240,120
BAGCILAR,YILDIZTEPE MAH.,415,356,352,222,130
BAGCILAR,YILDIZTEPE MAH.,410,371,367,234,133
BAGCILAR,YILDIZTEPE MAH.,409,368,365,227,138
BAGCILAR,YILDIZTEPE MAH.,409,356,351,215,136
BAGCILAR,YILDIZTEPE MAH.,415,371,367,212,155
BAGCILAR,YILDIZTEPE MAH.,415,360,353,253,100
BAGCILAR,YILDIZTEPE MAH.,410,365,360,243,117
BAGCILAR,YILDIZTEPE MAH.,409,348,343,246,97
BAGCILAR,YILDIZTEPE MAH.,415,373,365,259,106
BAGCILAR,YILDIZTEPE MAH.,411,372,369,240,129
BAGCILAR,YILDIZTEPE MAH.,411,362,356,220,136
BAGCILAR,YILDIZTEPE MAH.,409,351,348,221,127
BAGCILAR,YILDIZTEPE MAH.,408,353,343,220,123
BAGCILAR,YILDIZTEPE MAH.,409,370,366,215,151
BAGCILAR,YILDIZTEPE MAH.,411,365,361,227,134
BAGCILAR,YILDIZTEPE MAH.,410,375,369,239,130
BAGCILAR,YILDIZTEPE MAH.,411,380,375,257,118
BAGCILAR,YILDIZTEPE MAH.,409,339,337,223,114
BAGCILAR,YILDIZTEPE MAH.,410,363,360,223,137
BAGCILAR,YILDIZTEPE MAH.,409,353,345,235,110
BAGCILAR,YILDIZTEPE MAH.,410,363,356,241,115
BAGCILAR,YILDIZTEPE MAH.,411,368,363,236,127
BAGCILAR,YILDIZTEPE MAH.,410,358,349,228,121
BAGCILAR,YILDIZTEPE MAH.,411,371,368,244,124
BAGCILAR,YILDIZTEPE MAH.,411,378,372,252,120
BAGCILAR,YILDIZTEPE MAH.,410,356,348,243,105
BAGCILAR,YILDIZTEPE MAH.,410,353,348,251,97
BAGCILAR,YILDIZTEPE MAH.,411,369,361,236,125
BAGCILAR,DEMIRKAPI MAH.,407,342,329,213,116
BAGCILAR,DEMIRKAPI MAH.,409,352,347,263,84
BAGCILAR,DEMIRKAPI MAH.,404,352,345,246,99
BAGCILAR,DEMIRKAPI MAH.,406,363,357,254,103
BAGCILAR,DEMIRKAPI MAH.,405,372,370,270,100
BAGCILAR,DEMIRKAPI MAH.,405,363,354,253,101
BAGCILAR,DEMIRKAPI MAH.,404,357,352,226,126
BAGCILAR,DEMIRKAPI MAH.,405,369,366,246,120
BAGCILAR,DEMIRKAPI MAH.,405,374,373,261,112
BAGCILAR,DEMIRKAPI MAH.,405,361,358,264,94
BAGCILAR,DEMIRKAPI MAH.,405,358,355,255,100
BAGCILAR,DEMIRKAPI MAH.,406,366,360,242,118
BAGCILAR,DEMIRKAPI MAH.,404,347,344,239,105
BAGCILAR,DEMIRKAPI MAH.,404,351,345,247,98
BAGCILAR,DEMIRKAPI MAH.,406,347,344,214,130
BAGCILAR,DEMIRKAPI MAH.,404,354,352,257,95
BAGCILAR,DEMIRKAPI MAH.,404,354,342,231,111
BAGCILAR,DEMIRKAPI MAH.,415,379,373,255,118
BAGCILAR,DEMIRKAPI MAH.,404,363,352,233,119
BAGCILAR,DEMIRKAPI MAH.,404,346,341,228,113
BAGCILAR,DEMIRKAPI MAH.,405,353,347,239,108
BAGCILAR,DEMIRKAPI MAH.,404,370,366,243,123
BAGCILAR,DEMIRKAPI MAH.,404,361,346,252,94
BAGCILAR,DEMIRKAPI MAH.,404,355,349,247,102
BAGCILAR,DEMIRKAPI MAH.,404,355,354,252,102
BAGCILAR,DEMIRKAPI MAH.,404,362,354,249,105
BAGCILAR,DEMIRKAPI MAH.,404,354,349,243,106
BAGCILAR,DEMIRKAPI MAH.,404,351,339,216,123
BAGCILAR,DEMIRKAPI MAH.,404,366,360,270,90
BAGCILAR,DEMIRKAPI MAH.,401,327,317,196,121
BAGCILAR,DEMIRKAPI MAH.,401,329,323,156,167
BAGCILAR,DEMIRKAPI MAH.,401,335,325,167,158
BAGCILAR,DEMIRKAPI MAH.,401,339,331,179,152
BAGCILAR,DEMIRKAPI MAH.,402,364,359,196,163
BAGCILAR,DEMIRKAPI MAH.,401,345,337,205,132
BAGCILAR,DEMIRKAPI MAH.,403,342,335,176,159
BAGCILAR,DEMIRKAPI MAH.,402,366,359,185,174
BAGCILAR,DEMIRKAPI MAH.,400,350,346,161,185
BAGCILAR,DEMIRKAPI MAH.,400,353,347,191,156
BAGCILAR,DEMIRKAPI MAH.,402,342,332,184,148
BAGCILAR,DEMIRKAPI MAH.,401,346,335,180,155
BAGCILAR,DEMIRKAPI MAH.,401,347,337,183,154
BAGCILAR,DEMIRKAPI MAH.,401,348,347,185,162
BAGCILAR,DEMIRKAPI MAH.,400,353,351,197,154
BAGCILAR,DEMIRKAPI MAH.,401,346,343,186,157
BAGCILAR,DEMIRKAPI MAH.,401,342,332,179,153
BAGCILAR,DEMIRKAPI MAH.,402,352,344,212,132
BAGCILAR,DEMIRKAPI MAH.,400,369,365,216,149
BAGCILAR,DEMIRKAPI MAH.,401,350,342,192,150
BAGCILAR,DEMIRKAPI MAH.,400,335,331,193,138
BAGCILAR,DEMIRKAPI MAH.,401,365,362,187,175
BAGCILAR,DEMIRKAPI MAH.,403,362,357,194,163
BAGCILAR,DEMIRKAPI MAH.,401,344,342,177,165
BAGCILAR,DEMIRKAPI MAH.,400,339,336,188,148
BAGCILAR,DEMIRKAPI MAH.,405,340,337,160,177
BAGCILAR,DEMIRKAPI MAH.,404,364,357,196,161
BAGCILAR,DEMIRKAPI MAH.,401,349,340,193,147
BAGCILAR,DEMIRKAPI MAH.,401,346,343,151,192
BAGCILAR,DEMIRKAPI MAH.,403,334,328,184,144
BAGCILAR,DEMIRKAPI MAH.,402,315,312,179,133
BAGCILAR,DEMIRKAPI MAH.,407,351,346,224,122
BAGCILAR,DEMIRKAPI MAH.,407,347,346,204,142
BAGCILAR,DEMIRKAPI MAH.,403,352,345,196,149
BAGCILAR,DEMIRKAPI MAH.,403,345,338,209,129
BAGCILAR,DEMIRKAPI MAH.,404,363,357,204,153
BAGCILAR,DEMIRKAPI MAH.,403,359,353,188,165
BAGCILAR,DEMIRKAPI MAH.,405,363,359,238,121
BAGCILAR,DEMIRKAPI MAH.,404,350,346,197,149
BAGCILAR,DEMIRKAPI MAH.,403,364,359,200,159
BAGCILAR,DEMIRKAPI MAH.,406,353,348,210,138
BAGCILAR,DEMIRKAPI MAH.,403,361,353,190,163
BAGCILAR,DEMIRKAPI MAH.,403,347,338,166,172
BAGCILAR,DEMIRKAPI MAH.,403,351,347,171,176
BAGCILAR,DEMIRKAPI MAH.,403,366,361,215,146
BAGCILAR,DEMIRKAPI MAH.,403,360,357,174,183
BAGCILAR,DEMIRKAPI MAH.,402,349,346,203,143
BAGCILAR,DEMIRKAPI MAH.,403,340,338,177,161
BAGCILAR,DEMIRKAPI MAH.,402,357,350,177,173
BAGCILAR,DEMIRKAPI MAH.,403,353,349,213,136
BAGCILAR,DEMIRKAPI MAH.,403,344,338,202,136
BAGCILAR,DEMIRKAPI MAH.,402,349,348,208,140
BAGCILAR,DEMIRKAPI MAH.,402,360,352,196,156
BAGCILAR,DEMIRKAPI MAH.,404,347,336,192,144
BAGCILAR,DEMIRKAPI MAH.,402,363,356,211,145
BAGCILAR,DEMIRKAPI MAH.,403,343,341,202,139
BAGCILAR,DEMIRKAPI MAH.,403,355,350,221,129
BAGCILAR,DEMIRKAPI MAH.,403,357,351,206,145
BAGCILAR,DEMIRKAPI MAH.,402,344,341,198,143
BAGCILAR,DEMIRKAPI MAH.,403,352,343,193,150
BAGCILAR,DEMIRKAPI MAH.,403,345,339,195,144
BAGCILAR,GUNESLI MAH.,414,348,343,230,113
BAGCILAR,GUNESLI MAH.,415,335,328,246,82
BAGCILAR,GUNESLI MAH.,415,363,358,256,102
BAGCILAR,GUNESLI MAH.,415,359,354,249,105
BAGCILAR,GUNESLI MAH.,417,357,353,238,115
BAGCILAR,GUNESLI MAH.,414,366,362,247,115
BAGCILAR,GUNESLI MAH.,415,357,353,241,112
BAGCILAR,GUNESLI MAH.,417,358,352,230,122
BAGCILAR,GUNESLI MAH.,415,362,359,240,119
BAGCILAR,GUNESLI MAH.,415,368,367,282,85
BAGCILAR,GUNESLI MAH.,416,364,362,237,125
BAGCILAR,GUNESLI MAH.,415,361,358,243,115
BAGCILAR,GUNESLI MAH.,415,367,363,229,134
BAGCILAR,GUNESLI MAH.,415,378,374,239,135
BAGCILAR,GUNESLI MAH.,415,389,383,261,122
BAGCILAR,GUNESLI MAH.,415,383,378,238,140
BAGCILAR,GUNESLI MAH.,415,367,357,246,111
BAGCILAR,GUNESLI MAH.,415,360,353,233,120
BAGCILAR,GUNESLI MAH.,415,379,375,254,121
BAGCILAR,GUNESLI MAH.,415,376,375,249,126
BAGCILAR,GUNESLI MAH.,415,368,357,220,137
BAGCILAR,GUNESLI MAH.,415,365,359,249,110
BAGCILAR,GUNESLI MAH.,414,369,362,247,115
BAGCILAR,GUNESLI MAH.,414,371,366,265,101
BAGCILAR,GUNESLI MAH.,415,366,363,246,117
BAGCILAR,GUNESLI MAH.,414,371,364,253,111
BAGCILAR,GUNESLI MAH.,414,367,358,242,116
BAGCILAR,GUNESLI MAH.,415,368,363,246,117
BAGCILAR,GUNESLI MAH.,415,364,358,230,128
BAGCILAR,GUNESLI MAH.,415,377,369,247,122
BAGCILAR,GUNESLI MAH.,414,392,386,279,107
BAGCILAR,GUNESLI MAH.,415,368,362,244,118
BAGCILAR,GUNESLI MAH.,415,365,362,233,129
BAGCILAR,GUNESLI MAH.,414,359,358,246,112
BAGCILAR,GUNESLI MAH.,415,356,352,226,126
BAGCILAR,GUNESLI MAH.,415,327,320,176,144
BAGCILAR,GUNESLI MAH.,415,348,341,211,130
BAGCILAR,GUNESLI MAH.,415,329,321,193,128
BAGCILAR,GUNESLI MAH.,412,360,359,219,140
BAGCILAR,GUNESLI MAH.,415,369,365,204,161
BAGCILAR,GUNESLI MAH.,415,364,360,186,174
BAGCILAR,GUNESLI MAH.,415,370,367,215,152
BAGCILAR,GUNESLI MAH.,415,378,369,218,151
BAGCILAR,GUNESLI MAH.,415,356,352,234,118
BAGCILAR,GUNESLI MAH.,415,359,349,219,130
BAGCILAR,GUNESLI MAH.,415,361,356,210,146
BAGCILAR,GUNESLI MAH.,415,358,356,205,151
BAGCILAR,GUNESLI MAH.,413,370,367,203,164
BAGCILAR,GUNESLI MAH.,415,371,370,232,138
BAGCILAR,GUNESLI MAH.,413,370,364,230,134
BAGCILAR,GUNESLI MAH.,413,369,365,207,158
BAGCILAR,GUNESLI MAH.,413,354,350,214,136
BAGCILAR,GUNESLI MAH.,415,370,365,223,142
BAGCILAR,GUNESLI MAH.,411,371,366,202,164
BAGCILAR,GUNESLI MAH.,413,364,360,211,149
BAGCILAR,GUNESLI MAH.,412,359,357,189,168
BAGCILAR,GUNESLI MAH.,415,352,349,205,144
BAGCILAR,GUNESLI MAH.,413,362,358,217,141
BAGCILAR,GUNESLI MAH.,413,370,364,228,136
BAGCILAR,GUNESLI MAH.,415,373,370,210,160
BAGCILAR,GUNESLI MAH.,412,364,358,196,162
BAGCILAR,GUNESLI MAH.,413,368,359,206,153
BAGCILAR,GUNESLI MAH.,415,360,351,186,165
BAGCILAR,GUNESLI MAH.,414,372,366,234,132
BAGCILAR,GUNESLI MAH.,412,372,369,226,143
BAGCILAR,GUNESLI MAH.,413,347,341,198,143
BAGCILAR,GUNESLI MAH.,414,351,349,180,169
BAGCILAR,GUNESLI MAH.,414,373,369,215,154
BAGCILAR,GUNESLI MAH.,414,373,363,219,144
BAGCILAR,GUNESLI MAH.,413,361,354,186,168
BAGCILAR,GUNESLI MAH.,413,366,360,226,134
BAGCILAR,GUNESLI MAH.,414,367,364,228,136
BAGCILAR,GUNESLI MAH.,413,364,361,226,135
BAGCILAR,GUNESLI MAH.,413,369,364,231,133
BAGCILAR,GUNESLI MAH.,412,363,354,197,157
BAGCILAR,GUNESLI MAH.,413,376,372,203,169
BAGCILAR,GUNESLI MAH.,415,375,366,207,159
BAGCILAR,MAHMUTBEY MAH.,415,325,317,158,159
BAGCILAR,MAHMUTBEY MAH.,410,369,368,201,167
BAGCILAR,MAHMUTBEY MAH.,415,369,364,176,188
BAGCILAR,MAHMUTBEY MAH.,411,363,362,190,172
BAGCILAR,MAHMUTBEY MAH.,415,368,365,206,159
BAGCILAR,MAHMUTBEY MAH.,412,377,370,200,170
BAGCILAR,MAHMUTBEY MAH.,412,358,349,182,167
BAGCILAR,MAHMUTBEY MAH.,415,375,366,182,184
BAGCILAR,MAHMUTBEY MAH.,412,369,361,201,160
BAGCILAR,MAHMUTBEY MAH.,412,379,379,182,197
BAGCILAR,MAHMUTBEY MAH.,412,381,378,186,192
BAGCILAR,MAHMUTBEY MAH.,411,377,372,183,189
BAGCILAR,MAHMUTBEY MAH.,410,369,362,203,159
BAGCILAR,MAHMUTBEY MAH.,410,357,348,179,169
BAGCILAR,MAHMUTBEY MAH.,412,363,358,214,144
BAGCILAR,MAHMUTBEY MAH.,410,368,358,205,153
BAGCILAR,MAHMUTBEY MAH.,411,371,365,195,170
BAGCILAR,MAHMUTBEY MAH.,404,338,335,228,107
BAGCILAR,MAHMUTBEY MAH.,402,362,356,257,99
BAGCILAR,MAHMUTBEY MAH.,403,363,355,224,131
BAGCILAR,MAHMUTBEY MAH.,404,360,357,246,111
BAGCILAR,MAHMUTBEY MAH.,403,360,354,234,120
BAGCILAR,MAHMUTBEY MAH.,403,348,340,232,108
BAGCILAR,MAHMUTBEY MAH.,403,359,350,259,91
BAGCILAR,MAHMUTBEY MAH.,404,347,343,239,104
BAGCILAR,MAHMUTBEY MAH.,404,356,354,233,121
BAGCILAR,MAHMUTBEY MAH.,403,353,342,235,107
BAGCILAR,MAHMUTBEY MAH.,404,359,353,237,116
BAGCILAR,MAHMUTBEY MAH.,406,363,361,249,112
BAGCILAR,MAHMUTBEY MAH.,403,371,368,226,142
BAGCILAR,MAHMUTBEY MAH.,405,365,354,242,112
BAGCILAR,MAHMUTBEY MAH.,403,354,340,209,131
BAGCILAR,MAHMUTBEY MAH.,407,369,362,230,132
BAGCILAR,MAHMUTBEY MAH.,404,359,349,234,115
BAGCILAR,MAHMUTBEY MAH.,403,349,341,219,122
BAGCILAR,MAHMUTBEY MAH.,404,365,359,226,133
BAGCILAR,MAHMUTBEY MAH.,404,348,345,244,101
BAGCILAR,MAHMUTBEY MAH.,403,351,345,207,138
BAGCILAR,MAHMUTBEY MAH.,403,358,355,229,126
BAGCILAR,MAHMUTBEY MAH.,404,357,354,224,130
BAGCILAR,YENIMAHALLE MAH.,415,357,353,192,161
BAGCILAR,YENIMAHALLE MAH.,415,327,321,184,137
BAGCILAR,YENIMAHALLE MAH.,415,353,344,197,147
BAGCILAR,YENIMAHALLE MAH.,415,377,370,224,146
BAGCILAR,YENIMAHALLE MAH.,415,379,376,211,165
BAGCILAR,YENIMAHALLE MAH.,412,369,363,192,171
BAGCILAR,YENIMAHALLE MAH.,417,356,355,185,170
BAGCILAR,YENIMAHALLE MAH.,417,373,364,214,150
BAGCILAR,YENIMAHALLE MAH.,417,380,373,222,151
BAGCILAR,YENIMAHALLE MAH.,417,374,366,182,184
BAGCILAR,YENIMAHALLE MAH.,415,373,371,232,139
BAGCILAR,YENIMAHALLE MAH.,412,363,359,229,130
BAGCILAR,YENIMAHALLE MAH.,417,384,380,237,143
BAGCILAR,YENIMAHALLE MAH.,412,378,373,200,173
BAGCILAR,YENIMAHALLE MAH.,417,366,361,216,145
BAGCILAR,YENIMAHALLE MAH.,412,366,362,231,131
BAGCILAR,YENIMAHALLE MAH.,415,374,364,217,147
BAGCILAR,YENIMAHALLE MAH.,415,366,361,202,159
BAGCILAR,YENIMAHALLE MAH.,412,374,369,219,150
BAGCILAR,YENIMAHALLE MAH.,415,374,369,221,148
BAGCILAR,YENIMAHALLE MAH.,412,381,375,211,164
BAGCILAR,YENIMAHALLE MAH.,415,369,362,203,159
BAGCILAR,YENIMAHALLE MAH.,415,390,382,201,181
BAGCILAR,YENIMAHALLE MAH.,415,372,362,189,173
BAGCILAR,YENIMAHALLE MAH.,414,381,370,239,131
BAGCILAR,YENIMAHALLE MAH.,412,363,357,212,145
BAGCILAR,YENIMAHALLE MAH.,415,377,370,201,169
BAGCILAR,YENIMAHALLE MAH.,414,366,364,218,146
BAGCILAR,YENIMAHALLE MAH.,415,377,373,216,157
BAGCILAR,YENIMAHALLE MAH.,414,365,362,192,170
BAGCILAR,YENIMAHALLE MAH.,412,371,370,196,174
BAGCILAR,YENIMAHALLE MAH.,414,375,369,194,175
BAGCILAR,YENIMAHALLE MAH.,413,367,365,193,172
BAGCILAR,YENIMAHALLE MAH.,412,360,351,166,185
BAGCILAR,YENIMAHALLE MAH.,409,343,337,183,154
BAGCILAR,YENIMAHALLE MAH.,404,328,322,157,165
BAGCILAR,YENIMAHALLE MAH.,401,364,355,172,183
BAGCILAR,YENIMAHALLE MAH.,402,358,349,189,160
BAGCILAR,YENIMAHALLE MAH.,403,370,365,222,143
BAGCILAR,YENIMAHALLE MAH.,401,360,354,212,142
BAGCILAR,YENIMAHALLE MAH.,401,357,356,177,179
BAGCILAR,YENIMAHALLE MAH.,402,358,352,219,133
BAGCILAR,YENIMAHALLE MAH.,402,360,350,203,147
BAGCILAR,YENIMAHALLE MAH.,402,357,348,209,139
BAGCILAR,YENIMAHALLE MAH.,401,350,346,209,137
BAGCILAR,YENIMAHALLE MAH.,401,352,349,172,177
BAGCILAR,YENIMAHALLE MAH.,402,358,350,193,157
BAGCILAR,YENIMAHALLE MAH.,402,346,334,183,151
BAGCILAR,YENIMAHALLE MAH.,402,340,338,161,177
BAGCILAR,YENIMAHALLE MAH.,402,363,354,196,158
BAGCILAR,YENIMAHALLE MAH.,402,349,347,182,165
BAGCILAR,YENIMAHALLE MAH.,402,348,343,210,133
BAGCILAR,YENIMAHALLE MAH.,401,342,340,186,154
BAGCILAR,YENIMAHALLE MAH.,401,363,359,198,161
BAGCILAR,YENIMAHALLE MAH.,401,360,354,200,154
BAGCILAR,YENIMAHALLE MAH.,401,363,358,200,158
BAGCILAR,YENIMAHALLE MAH.,401,369,366,207,159
BAGCILAR,YENIMAHALLE MAH.,402,377,368,198,170
BAGCILAR,YENIMAHALLE MAH.,401,363,361,170,191
BAGCILAR,YENIMAHALLE MAH.,402,356,348,179,169
BAGCILAR,15 TEMMUZ MAH.,415,350,343,215,128
BAGCILAR,15 TEMMUZ MAH.,410,359,357,265,92
BAGCILAR,15 TEMMUZ MAH.,415,374,363,248,115
BAGCILAR,15 TEMMUZ MAH.,410,353,348,232,116
BAGCILAR,15 TEMMUZ MAH.,415,359,353,230,123
BAGCILAR,15 TEMMUZ MAH.,415,374,370,253,117
BAGCILAR,15 TEMMUZ MAH.,415,362,359,247,112
BAGCILAR,15 TEMMUZ MAH.,415,360,353,243,110
BAGCILAR,15 TEMMUZ MAH.,415,345,343,218,125
BAGCILAR,15 TEMMUZ MAH.,409,347,346,229,117
BAGCILAR,15 TEMMUZ MAH.,415,362,357,244,113
BAGCILAR,15 TEMMUZ MAH.,415,384,378,262,116
BAGCILAR,15 TEMMUZ MAH.,415,356,352,241,111
BAGCILAR,15 TEMMUZ MAH.,415,367,361,252,109
BAGCILAR,15 TEMMUZ MAH.,415,338,331,218,113
BAGCILAR,15 TEMMUZ MAH.,409,360,355,244,111
BAGCILAR,15 TEMMUZ MAH.,415,375,370,237,133
BAGCILAR,15 TEMMUZ MAH.,415,372,367,238,129
BAGCILAR,15 TEMMUZ MAH.,412,372,368,264,104
BAGCILAR,15 TEMMUZ MAH.,412,352,344,236,108
BAGCILAR,15 TEMMUZ MAH.,413,371,369,233,136
BAGCILAR,15 TEMMUZ MAH.,415,363,357,242,115
BAGCILAR,15 TEMMUZ MAH.,410,371,365,237,128
BAGCILAR,15 TEMMUZ MAH.,412,369,360,249,111
BAGCILAR,15 TEMMUZ MAH.,400,318,311,218,93
BAGCILAR,15 TEMMUZ MAH.,398,341,333,205,128
BAGCILAR,15 TEMMUZ MAH.,400,349,347,219,128
BAGCILAR,15 TEMMUZ MAH.,397,340,330,221,109
BAGCILAR,15 TEMMUZ MAH.,400,368,362,231,131
BAGCILAR,15 TEMMUZ MAH.,398,358,354,232,122
BAGCILAR,15 TEMMUZ MAH.,397,341,339,216,123
BAGCILAR,15 TEMMUZ MAH.,398,346,340,217,123
BAGCILAR,15 TEMMUZ MAH.,398,337,334,202,132
BAGCILAR,15 TEMMUZ MAH.,398,343,341,229,112
BAGCILAR,15 TEMMUZ MAH.,398,327,322,224,98
BAGCILAR,15 TEMMUZ MAH.,397,328,320,209,111
BAGCILAR,15 TEMMUZ MAH.,397,342,336,219,117
BAGCILAR,15 TEMMUZ MAH.,398,343,340,242,98
BAGCILAR,15 TEMMUZ MAH.,398,343,331,188,143
BAGCILAR,15 TEMMUZ MAH.,398,329,324,219,105
BAGCILAR,15 TEMMUZ MAH.,397,333,329,229,100
BAGCILAR,15 TEMMUZ MAH.,397,329,326,221,105
BAGCILAR,15 TEMMUZ MAH.,397,359,354,227,127
BAGCILAR,15 TEMMUZ MAH.,397,330,326,242,84
BAGCILAR,15 TEMMUZ MAH.,397,329,325,202,123
BAGCILAR,15 TEMMUZ MAH.,395,311,304,182,122
BAGCILAR,15 TEMMUZ MAH.,395,360,359,226,133
BAGCILAR,15 TEMMUZ MAH.,395,346,337,215,122
BAGCILAR,15 TEMMUZ MAH.,395,333,331,214,117
BAGCILAR,15 TEMMUZ MAH.,394,338,335,222,113
BAGCILAR,15 TEMMUZ MAH.,395,336,333,226,107
BAGCILAR,15 TEMMUZ MAH.,395,342,337,235,102
BAGCILAR,15 TEMMUZ MAH.,395,333,327,215,112
BAGCILAR,15 TEMMUZ MAH.,397,333,325,192,133
BAGCILAR,15 TEMMUZ MAH.,395,314,309,189,120
BAGCILAR,15 TEMMUZ MAH.,395,342,335,227,108
BAGCILAR,15 TEMMUZ MAH.,395,326,324,197,127
BAGCILAR,15 TEMMUZ MAH.,397,326,320,214,106
BAGCILAR,15 TEMMUZ MAH.,396,330,326,225,101
BAGCILAR,15 TEMMUZ MAH.,396,313,310,213,97
BAGCILAR,15 TEMMUZ MAH.,397,352,348,231,117
BAGCILAR,15 TEMMUZ MAH.,395,328,321,187,134
BAGCILAR,15 TEMMUZ MAH.,395,340,336,230,106
BAGCILAR,15 TEMMUZ MAH.,395,327,324,227,97
BAGCILAR,15 TEMMUZ MAH.,394,327,324,197,127
BAGCILAR,15 TEMMUZ MAH.,406,340,336,206,130
BAGCILAR,15 TEMMUZ MAH.,406,352,349,204,145
BAGCILAR,15 TEMMUZ MAH.,406,359,354,228,126
BAGCILAR,15 TEMMUZ MAH.,406,370,366,231,135
BAGCILAR,15 TEMMUZ MAH.,405,349,343,204,139
BAGCILAR,15 TEMMUZ MAH.,407,348,339,220,119
BAGCILAR,15 TEMMUZ MAH.,407,359,355,240,115
BAGCILAR,15 TEMMUZ MAH.,406,357,351,229,122
BAGCILAR,15 TEMMUZ MAH.,405,362,357,207,150
BAGCILAR,15 TEMMUZ MAH.,406,358,349,215,134
BAGCILAR,15 TEMMUZ MAH.,406,344,335,225,110
BAGCILAR,15 TEMMUZ MAH.,410,358,351,241,110
BAGCILAR,15 TEMMUZ MAH.,406,347,339,194,145
BAGCILAR,15 TEMMUZ MAH.,406,359,357,235,122
BAGCILAR,15 TEMMUZ MAH.,406,340,331,201,130
BAGCILAR,15 TEMMUZ MAH.,408,357,351,209,142
BAGCILAR,15 TEMMUZ MAH.,406,352,342,206,136
BAGCILAR,15 TEMMUZ MAH.,405,348,339,196,143
BAGCILAR,15 TEMMUZ MAH.,406,338,331,217,114
BAGCILAR,FATIH MAH.,415,346,337,202,135
BAGCILAR,FATIH MAH.,413,365,356,212,144
BAGCILAR,FATIH MAH.,412,358,352,221,131
BAGCILAR,FATIH MAH.,413,351,345,213,132
BAGCILAR,FATIH MAH.,411,355,346,212,134
BAGCILAR,FATIH MAH.,411,355,345,183,162
BAGCILAR,FATIH MAH.,413,361,357,215,142
BAGCILAR,FATIH MAH.,412,362,353,227,126
BAGCILAR,FATIH MAH.,413,355,350,217,133
BAGCILAR,FATIH MAH.,412,377,369,244,125
BAGCILAR,FATIH MAH.,415,364,359,192,167
BAGCILAR,FATIH MAH.,412,357,350,179,171
BAGCILAR,FATIH MAH.,413,371,365,185,180
BAGCILAR,FATIH MAH.,413,371,366,224,142
BAGCILAR,FATIH MAH.,413,346,345,194,151
BAGCILAR,FATIH MAH.,413,369,365,233,132
BAGCILAR,FATIH MAH.,413,354,344,199,145
BAGCILAR,FATIH MAH.,411,357,345,205,140
BAGCILAR,FATIH MAH.,415,353,347,190,157
BAGCILAR,FATIH MAH.,413,343,335,182,153
BAGCILAR,FATIH MAH.,415,363,355,214,141
BAGCILAR,FATIH MAH.,415,366,360,221,139
BAGCILAR,FATIH MAH.,415,378,370,216,154
BAGCILAR,FATIH MAH.,415,367,356,194,162
BAGCILAR,FATIH MAH.,415,359,355,180,175
BAGCILAR,FATIH MAH.,415,365,363,233,130
BAGCILAR,FATIH MAH.,415,363,348,201,147
BAGCILAR,FATIH MAH.,415,362,360,214,146
BAGCILAR,FATIH MAH.,415,355,347,221,126
BAGCILAR,FATIH MAH.,415,354,350,200,150
BAGCILAR,FATIH MAH.,415,369,362,203,159
BAGCILAR,FATIH MAH.,415,372,363,203,160
BAGCILAR,FATIH MAH.,415,381,375,218,157
BAGCILAR,FATIH MAH.,415,370,364,224,140
BAGCILAR,FATIH MAH.,414,374,364,226,138
BAGCILAR,FATIH MAH.,415,371,365,215,150
BAGCILAR,FATIH MAH.,415,378,372,201,171
BAGCILAR,FATIH MAH.,415,376,375,227,148
BAGCILAR,FATIH MAH.,414,365,359,198,161
BAGCILAR,FATIH MAH.,415,368,360,218,142
BAGCILAR,FATIH MAH.,415,370,360,216,144
BAGCILAR,FATIH MAH.,413,352,346,193,153
BAGCILAR,FATIH MAH.,414,360,353,201,152
BAGCILAR,FATIH MAH.,415,377,374,204,170
BAGCILAR,FATIH MAH.,415,376,370,244,126
BAGCILAR,FATIH MAH.,413,372,369,198,171
BAGCILAR,FATIH MAH.,414,366,366,212,154
BAGCILAR,FATIH MAH.,414,360,355,228,127
BAGCILAR,FATIH MAH.,414,375,368,213,155
BAGCILAR,FATIH MAH.,414,361,358,211,147
BAGCILAR,FATIH MAH.,415,363,354,208,146
BAGCILAR,FATIH MAH.,414,353,351,210,141
BAGCILAR,FATIH MAH.,415,372,360,192,168
BAGCILAR,FATIH MAH.,412,356,353,230,123
BAGCILAR,FATIH MAH.,412,369,362,248,114
BAGCILAR,FATIH MAH.,415,365,357,189,168
BAGCILAR,FATIH MAH.,415,364,358,246,112
BAGCILAR,FATIH MAH.,415,365,360,214,146
BAGCILAR,FATIH MAH.,394,336,327,189,138
BAGCILAR,FATIH MAH.,394,354,345,196,149
BAGCILAR,FATIH MAH.,394,351,348,238,110
BAGCILAR,FATIH MAH.,396,359,353,236,117
BAGCILAR,FATIH MAH.,394,341,336,202,134
BAGCILAR,FATIH MAH.,394,355,347,224,123
BAGCILAR,FATIH MAH.,397,364,360,207,153
BAGCILAR,FATIH MAH.,394,351,345,210,135
BAGCILAR,FATIH MAH.,395,348,344,210,134
BAGCILAR,FATIH MAH.,393,356,351,221,130
BAGCILAR,FATIH MAH.,395,365,357,214,143
BAGCILAR,FATIH MAH.,394,345,341,218,123
BAGCILAR,FATIH MAH.,394,339,331,230,101
BAGCILAR,FATIH MAH.,393,346,341,227,114
BAGCILAR,FATIH MAH.,397,351,341,217,124
BAGCILAR,FATIH MAH.,393,355,348,224,124
BAGCILAR,FEVZI CAKMAK MAH.,410,325,320,178,142
BAGCILAR,FEVZI CAKMAK MAH.,415,339,331,167,164
BAGCILAR,FEVZI CAKMAK MAH.,415,347,342,230,112
BAGCILAR,FEVZI CAKMAK MAH.,415,368,363,228,135
BAGCILAR,FEVZI CAKMAK MAH.,415,374,371,220,151
BAGCILAR,FEVZI CAKMAK MAH.,415,348,341,185,156
BAGCILAR,FEVZI CAKMAK MAH.,415,374,373,230,143
BAGCILAR,FEVZI CAKMAK MAH.,415,370,365,237,128
BAGCILAR,FEVZI CAKMAK MAH.,415,378,375,228,147
BAGCILAR,FEVZI CAKMAK MAH.,415,370,363,177,186
BAGCILAR,FEVZI CAKMAK MAH.,415,379,376,207,169
BAGCILAR,FEVZI CAKMAK MAH.,415,363,358,189,169
BAGCILAR,FEVZI CAKMAK MAH.,411,360,353,201,152
BAGCILAR,FEVZI CAKMAK MAH.,411,352,347,216,131
BAGCILAR,FEVZI CAKMAK MAH.,414,348,345,176,169
BAGCILAR,FEVZI CAKMAK MAH.,414,353,345,194,151
BAGCILAR,FEVZI CAKMAK MAH.,411,357,350,189,161
BAGCILAR,FEVZI CAKMAK MAH.,414,364,351,185,166
BAGCILAR,FEVZI CAKMAK MAH.,415,371,367,227,140
BAGCILAR,FEVZI CAKMAK MAH.,415,359,353,201,152
BAGCILAR,FEVZI CAKMAK MAH.,414,370,365,199,166
BAGCILAR,FEVZI CAKMAK MAH.,415,365,360,204,156
BAGCILAR,FEVZI CAKMAK MAH.,415,362,359,202,157
BAGCILAR,FEVZI CAKMAK MAH.,414,363,358,210,148
BAGCILAR,FEVZI CAKMAK MAH.,414,375,365,248,117
BAGCILAR,FEVZI CAKMAK MAH.,409,356,352,204,148
BAGCILAR,FEVZI CAKMAK MAH.,414,364,359,208,151
BAGCILAR,FEVZI CAKMAK MAH.,415,354,352,202,150
BAGCILAR,FEVZI CAKMAK MAH.,414,369,364,215,149
BAGCILAR,FEVZI CAKMAK MAH.,410,362,357,223,134
BAGCILAR,FEVZI CAKMAK MAH.,413,355,349,204,145
BAGCILAR,FEVZI CAKMAK MAH.,405,343,341,207,134
BAGCILAR,FEVZI CAKMAK MAH.,405,320,311,173,138
BAGCILAR,FEVZI CAKMAK MAH.,405,361,360,242,118
BAGCILAR,FEVZI CAKMAK MAH.,406,359,356,210,146
BAGCILAR,FEVZI CAKMAK MAH.,404,344,337,194,143
BAGCILAR,FEVZI CAKMAK MAH.,406,374,367,232,135
BAGCILAR,FEVZI CAKMAK MAH.,405,362,357,231,126
BAGCILAR,FEVZI CAKMAK MAH.,405,365,362,210,152
BAGCILAR,FEVZI CAKMAK MAH.,406,363,355,225,130
BAGCILAR,FEVZI CAKMAK MAH.,404,355,353,220,133
BAGCILAR,FEVZI CAKMAK MAH.,405,355,348,198,150
BAGCILAR,FEVZI CAKMAK MAH.,405,360,349,230,119
BAGCILAR,FEVZI CAKMAK MAH.,405,361,355,219,136
BAGCILAR,FEVZI CAKMAK MAH.,409,357,352,217,135
BAGCILAR,FEVZI CAKMAK MAH.,408,370,366,226,140
BAGCILAR,FEVZI CAKMAK MAH.,404,355,352,220,132
BAGCILAR,FEVZI CAKMAK MAH.,404,366,358,230,128
BAGCILAR,FEVZI CAKMAK MAH.,407,341,339,221,118
BAGCILAR,FEVZI CAKMAK MAH.,406,369,368,222,146
BAGCILAR,FEVZI CAKMAK MAH.,404,337,331,219,112
BAGCILAR,FEVZI CAKMAK MAH.,405,357,348,215,133
BAGCILAR,FEVZI CAKMAK MAH.,404,363,356,221,135
BAGCILAR,FEVZI CAKMAK MAH.,404,362,358,213,145
BAGCILAR,FEVZI CAKMAK MAH.,404,353,347,188,159
BAGCILAR,FEVZI CAKMAK MAH.,405,357,354,220,134
BAGCILAR,FEVZI CAKMAK MAH.,404,366,361,251,110
BAGCILAR,FEVZI CAKMAK MAH.,405,375,371,214,157
BAGCILAR,FEVZI CAKMAK MAH.,405,364,361,224,137
BAGCILAR,GOZTEPE MAH.,403,329,319,202,117
BAGCILAR,GOZTEPE MAH.,403,326,317,224,93
BAGCILAR,GOZTEPE MAH.,403,354,346,179,167
BAGCILAR,GOZTEPE MAH.,404,338,328,202,126
BAGCILAR,GOZTEPE MAH.,404,342,337,207,130
BAGCILAR,GOZTEPE MAH.,402,357,348,214,134
BAGCILAR,GOZTEPE MAH.,402,355,349,220,129
BAGCILAR,GOZTEPE MAH.,403,355,347,201,146
BAGCILAR,GOZTEPE MAH.,402,349,345,192,153
BAGCILAR,GOZTEPE MAH.,402,346,337,193,144
BAGCILAR,GOZTEPE MAH.,402,344,338,219,119
BAGCILAR,GOZTEPE MAH.,402,354,344,208,136
BAGCILAR,GOZTEPE MAH.,403,356,351,224,127
BAGCILAR,GOZTEPE MAH.,404,350,347,235,112
BAGCILAR,GOZTEPE MAH.,403,357,356,233,123
BAGCILAR,GOZTEPE MAH.,403,362,358,213,145
BAGCILAR,GOZTEPE MAH.,404,339,338,187,151
BAGCILAR,GOZTEPE MAH.,402,352,346,199,147
BAGCILAR,GOZTEPE MAH.,402,344,339,188,151
BAGCILAR,GOZTEPE MAH.,401,355,346,197,149
BAGCILAR,GOZTEPE MAH.,405,340,334,195,139
BAGCILAR,GOZTEPE MAH.,405,361,357,208,149
BAGCILAR,GOZTEPE MAH.,402,333,326,181,145
BAGCILAR,GOZTEPE MAH.,403,365,358,207,151
BAGCILAR,GOZTEPE MAH.,401,348,338,185,153
BAGCILAR,GOZTEPE MAH.,402,358,348,197,151
BAGCILAR,GOZTEPE MAH.,403,353,347,209,138
BAGCILAR,GOZTEPE MAH.,402,350,340,192,148
BAGCILAR,GOZTEPE MAH.,404,351,344,206,138
BAGCILAR,GOZTEPE MAH.,401,353,344,212,132
BAGCILAR,GOZTEPE MAH.,402,349,344,190,154
BAGCILAR,GOZTEPE MAH.,408,350,346,215,131
BAGCILAR,GOZTEPE MAH.,415,342,334,225,109
BAGCILAR,GOZTEPE MAH.,415,378,373,249,124
BAGCILAR,GOZTEPE MAH.,412,378,367,237,130
BAGCILAR,GOZTEPE MAH.,415,361,356,244,112
BAGCILAR,GOZTEPE MAH.,412,355,345,231,114
BAGCILAR,GOZTEPE MAH.,412,377,371,287,84
BAGCILAR,GOZTEPE MAH.,415,381,371,266,105
BAGCILAR,GOZTEPE MAH.,412,372,363,256,107
BAGCILAR,GOZTEPE MAH.,415,381,375,269,106
BAGCILAR,GOZTEPE MAH.,415,372,367,239,128
BAGCILAR,GOZTEPE MAH.,412,371,366,241,125
BAGCILAR,GOZTEPE MAH.,409,383,379,272,107
BAGCILAR,GOZTEPE MAH.,415,355,352,268,84
BAGCILAR,GOZTEPE MAH.,412,378,369,250,119
BAGCILAR,GOZTEPE MAH.,415,381,374,255,119
BAGCILAR,GOZTEPE MAH.,412,361,357,236,121
BAGCILAR,GOZTEPE MAH.,413,375,370,246,124
BAGCILAR,GOZTEPE MAH.,412,361,354,239,115
BAGCILAR,GOZTEPE MAH.,411,373,370,258,112
BAGCILAR,GOZTEPE MAH.,413,367,365,249,116
BAGCILAR,GOZTEPE MAH.,413,378,373,272,101
BAGCILAR,GOZTEPE MAH.,412,362,354,243,111
BAGCILAR,GOZTEPE MAH.,412,373,368,256,112
BAGCILAR,GOZTEPE MAH.,412,360,356,253,103
BAGCILAR,GOZTEPE MAH.,411,371,364,255,109
BAGCILAR,KEMALPASA MAH.,415,337,323,181,142
BAGCILAR,KEMALPASA MAH.,412,324,319,187,132
BAGCILAR,KEMALPASA MAH.,415,371,365,207,158
BAGCILAR,KEMALPASA MAH.,411,368,361,182,179
BAGCILAR,KEMALPASA MAH.,410,367,358,225,133
BAGCILAR,KEMALPASA MAH.,415,374,368,220,148
BAGCILAR,KEMALPASA MAH.,411,363,357,208,149
BAGCILAR,KEMALPASA MAH.,411,363,358,227,131
BAGCILAR,KEMALPASA MAH.,411,363,358,203,155
BAGCILAR,KEMALPASA MAH.,411,373,371,235,136
BAGCILAR,KEMALPASA MAH.,410,364,358,185,173
BAGCILAR,KEMALPASA MAH.,415,349,342,212,130
BAGCILAR,KEMALPASA MAH.,412,359,355,215,140
BAGCILAR,KEMALPASA MAH.,411,358,354,191,163
BAGCILAR,KEMALPASA MAH.,412,372,366,215,151
BAGCILAR,KEMALPASA MAH.,411,362,354,198,156
BAGCILAR,KEMALPASA MAH.,411,374,370,229,141
BAGCILAR,KEMALPASA MAH.,412,374,370,224,146
BAGCILAR,KEMALPASA MAH.,410,356,352,229,123
BAGCILAR,KEMALPASA MAH.,410,364,360,188,172
BAGCILAR,KEMALPASA MAH.,412,360,357,219,138
BAGCILAR,KEMALPASA MAH.,412,362,360,216,144
BAGCILAR,KEMALPASA MAH.,410,356,352,205,147
BAGCILAR,KEMALPASA MAH.,412,352,343,210,133
BAGCILAR,KEMALPASA MAH.,411,370,366,248,118
BAGCILAR,KEMALPASA MAH.,412,354,346,208,138
BAGCILAR,KEMALPASA MAH.,410,349,340,181,159
BAGCILAR,KEMALPASA MAH.,385,333,325,140,185
BAGCILAR,KEMALPASA MAH.,385,353,350,183,167
BAGCILAR,KEMALPASA MAH.,386,350,345,192,153
BAGCILAR,KEMALPASA MAH.,386,339,334,156,178
BAGCILAR,KEMALPASA MAH.,386,351,343,180,163
BAGCILAR,KEMALPASA MAH.,386,343,337,177,160
BAGCILAR,KEMALPASA MAH.,388,345,335,157,178
BAGCILAR,KEMALPASA MAH.,386,346,339,157,182
BAGCILAR,KEMALPASA MAH.,385,337,333,171,162
BAGCILAR,KEMALPASA MAH.,388,329,324,171,153
BAGCILAR,KEMALPASA MAH.,389,365,356,195,161
BAGCILAR,KEMALPASA MAH.,385,348,345,202,143
BAGCILAR,KEMALPASA MAH.,395,330,321,169,152
BAGCILAR,KEMALPASA MAH.,399,340,333,158,175
BAGCILAR,KEMALPASA MAH.,399,361,346,163,183
BAGCILAR,KEMALPASA MAH.,397,367,363,146,217
BAGCILAR,KEMALPASA MAH.,396,360,355,180,175
BAGCILAR,KEMALPASA MAH.,396,365,360,157,203
BAGCILAR,KEMALPASA MAH.,397,353,347,158,189
BAGCILAR,KEMALPASA MAH.,398,363,361,185,176
BAGCILAR,KEMALPASA MAH.,396,360,358,207,151
BAGCILAR,KEMALPASA MAH.,396,348,340,140,200
BAGCILAR,KEMALPASA MAH.,396,346,338,167,171
BAGCILAR,KEMALPASA MAH.,396,349,345,197,148
BAGCILAR,KEMALPASA MAH.,396,354,352,181,171
BAGCILAR,KEMALPASA MAH.,396,349,340,172,168
BAGCILAR,KEMALPASA MAH.,397,355,351,175,176
BAGCILAR,KEMALPASA MAH.,395,352,343,150,193
BAGCILAR,KEMALPASA MAH.,396,346,335,185,150
BAGCILAR,KEMALPASA MAH.,396,356,351,167,184
BAGCILAR,KEMALPASA MAH.,395,351,345,167,178
BAGCILAR,100. YIL MAH.,409,334,329,244,85
BAGCILAR,100. YIL MAH.,411,362,355,265,90
BAGCILAR,100. YIL MAH.,409,350,346,259,87
BAGCILAR,100. YIL MAH.,408,365,359,269,90
BAGCILAR,100. YIL MAH.,408,381,377,295,82
BAGCILAR,100. YIL MAH.,408,373,366,255,111
BAGCILAR,100. YIL MAH.,409,387,381,304,77
BAGCILAR,100. YIL MAH.,410,370,369,264,105
BAGCILAR,100. YIL MAH.,408,364,358,259,99
BAGCILAR,100. YIL MAH.,408,364,359,266,93
BAGCILAR,100. YIL MAH.,408,361,351,240,111
BAGCILAR,100. YIL MAH.,408,364,359,257,102
BAGCILAR,100. YIL MAH.,409,367,360,247,113
BAGCILAR,100. YIL MAH.,409,367,362,277,85
BAGCILAR,100. YIL MAH.,408,366,364,251,113
BAGCILAR,100. YIL MAH.,409,368,365,282,83
BAGCILAR,100. YIL MAH.,409,378,374,275,99
BAGCILAR,100. YIL MAH.,408,370,364,290,74
BAGCILAR,100. YIL MAH.,408,371,364,259,105
BAGCILAR,100. YIL MAH.,407,348,343,266,77
BAGCILAR,100. YIL MAH.,408,360,354,254,100
BAGCILAR,100. YIL MAH.,409,353,347,262,85
BAGCILAR,100. YIL MAH.,410,361,357,229,128
BAGCILAR,100. YIL MAH.,408,365,363,241,122
BAGCILAR,100. YIL MAH.,410,349,343,241,102
BAGCILAR,100. YIL MAH.,411,345,334,217,117
BAGCILAR,100. YIL MAH.,415,357,353,256,97
BAGCILAR,100. YIL MAH.,410,363,359,261,98
BAGCILAR,100. YIL MAH.,410,358,347,254,93
BAGCILAR,100. YIL MAH.,410,374,366,256,110
BAGCILAR,100. YIL MAH.,410,373,367,228,139
BAGCILAR,100. YIL MAH.,411,373,366,244,122
BAGCILAR,100. YIL MAH.,410,372,366,224,142
BAGCILAR,100. YIL MAH.,415,374,367,271,96
BAGCILAR,100. YIL MAH.,411,365,359,250,109
BAGCILAR,100. YIL MAH.,411,374,366,262,104
BAGCILAR,100. YIL MAH.,410,374,368,263,105
BAGCILAR,100. YIL MAH.,410,367,361,221,140
BAGCILAR,100. YIL MAH.,410,373,364,240,124
BAGCILAR,100. YIL MAH.,411,368,357,262,95
BAGCILAR,100. YIL MAH.,411,385,382,253,129
BAGCILAR,100. YIL MAH.,410,380,368,267,101
BAGCILAR,100. YIL MAH.,415,378,377,248,129
BAGCILAR,100. YIL MAH.,410,372,363,233,130
BAGCILAR,100. YIL MAH.,410,360,355,250,105
BAGCILAR,100. YIL MAH.,410,374,368,238,130
BAGCILAR,100. YIL MAH.,411,363,357,239,118
BAGCILAR,100. YIL MAH.,410,364,354,222,132
BAGCILAR,100. YIL MAH.,410,375,372,243,129
BAGCILAR,100. YIL MAH.,409,358,349,246,103
BAGCILAR,100. YIL MAH.,411,379,378,250,128
BAGCILAR,100. YIL MAH.,410,352,349,236,113
BAGCILAR,100. YIL MAH.,411,363,362,244,118
BAGCILAR,100. YIL MAH.,411,360,352,252,100
BAGCILAR,100. YIL MAH.,415,377,372,231,141
BAGCILAR,100. YIL MAH.,414,330,321,216,105
BAGCILAR,100. YIL MAH.,408,353,348,245,103
BAGCILAR,100. YIL MAH.,408,368,363,263,100
BAGCILAR,100. YIL MAH.,407,357,351,235,116
BAGCILAR,100. YIL MAH.,407,372,363,238,125
BAGCILAR,100. YIL MAH.,407,367,366,246,120
BAGCILAR,100. YIL MAH.,407,369,361,266,95
BAGCILAR,100. YIL MAH.,415,375,369,255,114
BAGCILAR,100. YIL MAH.,407,361,358,272,86
BAGCILAR,100. YIL MAH.,408,367,367,263,104
BAGCILAR,100. YIL MAH.,408,372,366,253,113
BAGCILAR,100. YIL MAH.,407,376,371,267,104
BAGCILAR,100. YIL MAH.,408,356,354,255,99
BAGCILAR,100. YIL MAH.,408,352,349,275,74
BAGCILAR,100. YIL MAH.,407,359,357,260,97
BAGCILAR,100. YIL MAH.,408,372,367,274,93
BAGCILAR,100. YIL MAH.,407,359,359,240,119
BAGCILAR,100. YIL MAH.,408,350,345,235,110
BAGCILAR,100. YIL MAH.,407,373,363,259,104
BAGCILAR,100. YIL MAH.,408,363,359,254,105
BAGCILAR,100. YIL MAH.,407,362,354,239,115
BAGCILAR,100. YIL MAH.,408,362,355,266,89
BAGCILAR,100. YIL MAH.,406,346,336,245,91
BAGCILAR,100. YIL MAH.,408,364,356,237,119
BAGCILAR,100. YIL MAH.,408,347,342,225,117
SILIVRI,AKOREN MAH.,364,314,301,85,216
SILIVRI,AKOREN MAH.,364,323,317,67,250
SILIVRI,AKOREN MAH.,364,326,320,75,245
SILIVRI,ALIBEY MAH.,400,333,332,110,222
SILIVRI,ALIBEY MAH.,402,340,334,116,218
SILIVRI,ALIBEY MAH.,404,356,351,135,216
SILIVRI,ALIBEY MAH.,401,364,361,137,224
SILIVRI,ALIBEY MAH.,399,356,353,120,233
SILIVRI,ALIBEY MAH.,399,352,347,102,245
SILIVRI,ALIBEY MAH.,399,363,358,147,211
SILIVRI,ALIBEY MAH.,400,371,367,120,247
SILIVRI,ALIBEY MAH.,400,353,348,107,241
SILIVRI,ALIBEY MAH.,400,361,357,127,230
SILIVRI,ALIBEY MAH.,400,365,363,120,243
SILIVRI,ALIBEY MAH.,400,356,355,116,239
SILIVRI,ALIBEY MAH.,401,369,363,105,258
SILIVRI,ALIBEY MAH.,400,362,357,97,260
SILIVRI,ALIBEY MAH.,399,344,341,114,227
SILIVRI,ALIBEY MAH.,400,366,356,101,255
SILIVRI,ALIBEY MAH.,399,371,362,116,246
SILIVRI,ALIBEY MAH.,415,325,318,129,189
SILIVRI,ALIBEY MAH.,415,367,362,132,230
SILIVRI,ALIBEY MAH.,411,374,369,145,224
SILIVRI,ALIBEY MAH.,415,368,363,149,214
SILIVRI,ALIBEY MAH.,411,365,359,147,212
SILIVRI,ALIBEY MAH.,415,363,360,151,209
SILIVRI,ALIBEY MAH.,411,372,369,159,210
SILIVRI,ALIBEY MAH.,415,358,354,158,196
SILIVRI,ALIBEY MAH.,415,374,372,149,223
SILIVRI,ALIBEY MAH.,415,372,365,155,210
SILIVRI,ALIBEY MAH.,413,371,362,124,238
SILIVRI,ALIBEY MAH.,413,376,375,167,208
SILIVRI,ALIBEY MAH.,413,362,358,141,217
SILIVRI,ALIBEY MAH.,413,367,359,151,208
SILIVRI,ALIBEY MAH.,415,375,374,152,222
SILIVRI,ALIBEY MAH.,413,365,360,140,220
SILIVRI,ALIBEY MAH.,413,364,362,134,228
SILIVRI,ALIPASA  MAH.,389,340,321,127,194
SILIVRI,ALIPASA  MAH.,390,352,340,134,206
SILIVRI,BALABAN MAH.,359,286,280,78,202
SILIVRI,BALABAN MAH.,361,300,297,91,206
SILIVRI,BALABAN MAH.,358,310,309,124,185
SILIVRI,BALABAN MAH.,358,315,310,105,205
SILIVRI,BALABAN MAH.,358,329,326,120,206
SILIVRI,BALABAN MAH.,358,303,300,130,170
SILIVRI,BEKIRLI MAH.,176,156,152,30,122
SILIVRI,BEYCILER MAH.,382,335,320,98,222
SILIVRI,BEYCILER MAH.,380,361,353,119,234
SILIVRI,BEYCILER MAH.,380,361,355,101,254
SILIVRI,BUYUK CAVUSLU MAH.,359,263,259,111,148
SILIVRI,BUYUK CAVUSLU MAH.,359,319,309,106,203
SILIVRI,BUYUK CAVUSLU MAH.,359,327,325,121,204
SILIVRI,BUYUK CAVUSLU MAH.,359,300,298,119,179
SILIVRI,BUYUK CAVUSLU MAH.,358,318,313,114,199
SILIVRI,BUYUK CAVUSLU MAH.,359,325,317,126,191
SILIVRI,BUYUK CAVUSLU MAH.,359,327,322,133,189
SILIVRI,BUYUK KILICLI MAH.,307,256,249,113,136
SILIVRI,BUYUK KILICLI MAH.,307,284,281,81,200
SILIVRI,BUYUK KILICLI MAH.,308,289,281,111,170
SILIVRI,BUYUK SINEKLI MAH.,310,285,278,61,217
SILIVRI,CUMHURIYET  MAH.,402,314,306,137,169
SILIVRI,CUMHURIYET  MAH.,402,349,344,154,190
SILIVRI,CUMHURIYET  MAH.,405,359,352,159,193
SILIVRI,CUMHURIYET  MAH.,401,349,347,171,176
SILIVRI,CUMHURIYET  MAH.,402,348,339,155,184
SILIVRI,CUMHURIYET  MAH.,401,355,354,181,173
SILIVRI,CUMHURIYET  MAH.,402,367,364,182,182
SILIVRI,CUMHURIYET  MAH.,402,346,343,178,165
SILIVRI,CUMHURIYET  MAH.,402,341,336,160,176
SILIVRI,CUMHURIYET  MAH.,401,342,337,161,176
SILIVRI,CUMHURIYET  MAH.,402,342,338,178,160
SILIVRI,CUMHURIYET  MAH.,401,343,339,160,179
SILIVRI,CUMHURIYET  MAH.,401,362,356,196,160
SILIVRI,CAYIRDERE MAH.,343,284,275,80,195
SILIVRI,CAYIRDERE MAH.,341,314,309,75,234
SILIVRI,CAYIRDERE MAH.,342,310,303,89,214
SILIVRI,CELTIK MAH.,289,239,238,83,155
SILIVRI,CELTIK MAH.,290,262,257,101,156
SILIVRI,CELTIK MAH.,288,260,256,108,148
SILIVRI,DANAMANDIRA MAH.,290,256,253,104,149
SILIVRI,DANAMANDIRA MAH.,291,285,280,89,191
SILIVRI,DANAMANDIRA MAH.,290,267,262,110,152
SILIVRI,FATIH MAH.,409,333,328,119,209
SILIVRI,FATIH MAH.,410,351,347,123,224
SILIVRI,FATIH MAH.,411,357,352,140,212
SILIVRI,FATIH MAH.,410,352,347,124,223
SILIVRI,FATIH MAH.,415,374,370,138,232
SILIVRI,FATIH MAH.,411,355,347,116,231
SILIVRI,FATIH MAH.,411,362,357,114,243
SILIVRI,FATIH MAH.,411,370,365,155,210
SILIVRI,FATIH MAH.,411,376,375,149,226
SILIVRI,FATIH MAH.,411,370,367,143,224
SILIVRI,FATIH MAH.,411,356,350,112,238
SILIVRI,FATIH MAH.,411,363,357,155,202
SILIVRI,FATIH MAH.,409,369,362,143,219
SILIVRI,FENER MAH.,315,255,249,79,170
SILIVRI,FENER MAH.,317,287,284,88,196
SILIVRI,FENER MAH.,312,298,292,94,198
SILIVRI,FENER MAH.,312,282,275,96,179
SILIVRI,FEVZIPASA MAH.,393,304,298,75,223
SILIVRI,FEVZIPASA MAH.,393,363,356,147,209
SILIVRI,FEVZIPASA MAH.,391,363,358,157,201
SILIVRI,FEVZIPASA MAH.,392,354,342,141,201
SILIVRI,FEVZIPASA MAH.,391,351,345,134,211
SILIVRI,FEVZIPASA MAH.,392,353,338,125,213
SILIVRI,GAZITEPE  MAH.,335,294,285,62,223
SILIVRI,GAZITEPE  MAH.,337,303,298,93,205
SILIVRI,GAZITEPE  MAH.,340,312,307,103,204
SILIVRI,GUMUSYAKA MAH.,398,315,306,117,189
SILIVRI,GUMUSYAKA MAH.,399,346,341,152,189
SILIVRI,GUMUSYAKA MAH.,397,361,355,180,175
SILIVRI,GUMUSYAKA MAH.,398,352,345,131,214
SILIVRI,GUMUSYAKA MAH.,397,336,330,124,206
SILIVRI,GUMUSYAKA MAH.,396,334,330,132,198
SILIVRI,GUMUSYAKA MAH.,396,348,347,162,185
SILIVRI,GUMUSYAKA MAH.,396,365,363,173,190
SILIVRI,GUMUSYAKA MAH.,397,344,341,164,177
SILIVRI,GUMUSYAKA MAH.,397,353,348,165,183
SILIVRI,GUMUSYAKA MAH.,396,332,328,148,180
SILIVRI,GUMUSYAKA MAH.,400,347,342,168,174
SILIVRI,GUMUSYAKA MAH.,397,326,322,168,154
SILIVRI,GUMUSYAKA MAH.,397,379,373,178,195
SILIVRI,HURRIYET MAH.,335,304,295,138,157
SILIVRI,HURRIYET MAH.,334,295,294,142,152
SILIVRI,HURRIYET MAH.,333,299,298,134,164
SILIVRI,HURRIYET MAH.,334,301,299,152,147
SILIVRI,ISMETPASA MAH.,377,311,306,93,213
SILIVRI,ISMETPASA MAH.,379,343,336,107,229
SILIVRI,ISMETPASA MAH.,376,327,323,142,181
SILIVRI,ISMETPASA MAH.,376,345,333,113,220
SILIVRI,ISMETPASA MAH.,378,349,345,139,206
SILIVRI,ISMETPASA MAH.,376,346,345,135,210
SILIVRI,KADIKOY MAH.,406,361,357,74,283
SILIVRI,KADIKOY MAH.,405,381,373,103,270
SILIVRI,KADIKOY MAH.,406,386,382,119,263
SILIVRI,KAVAKLI MAH.,369,316,313,128,185
SILIVRI,KAVAKLI MAH.,369,333,327,152,175
SILIVRI,KAVAKLI MAH.,371,339,335,149,186
SILIVRI,KAVAKLI MAH.,369,344,340,134,206
SILIVRI,KURFALLI MAH.,406,366,359,128,231
SILIVRI,KUCUK KILICLI  MAH.,231,210,206,63,143
SILIVRI,KUCUK SINEKLI MAH.,130,123,118,40,78
SILIVRI,MIMAR SINAN MAH.,415,336,326,210,116
SILIVRI,MIMAR SINAN MAH.,410,344,334,193,141
SILIVRI,MIMAR SINAN MAH.,410,358,354,203,151
SILIVRI,MIMAR SINAN MAH.,411,368,365,216,149
SILIVRI,MIMAR SINAN MAH.,411,361,353,220,133
SILIVRI,MIMAR SINAN MAH.,411,341,338,197,141
SILIVRI,MIMAR SINAN MAH.,411,356,354,225,129
SILIVRI,MIMAR SINAN MAH.,410,354,349,231,118
SILIVRI,MIMAR SINAN MAH.,411,366,359,203,156
SILIVRI,MIMAR SINAN MAH.,411,351,349,207,142
SILIVRI,MIMAR SINAN MAH.,411,357,347,216,131
SILIVRI,MIMAR SINAN MAH.,410,360,360,234,126
SILIVRI,MIMAR SINAN MAH.,411,336,332,196,136
SILIVRI,MIMAR SINAN MAH.,409,365,358,215,143
SILIVRI,MIMAR SINAN MAH.,410,367,361,222,139
SILIVRI,MIMAR SINAN MAH.,410,331,329,67,262
SILIVRI,MIMAR SINAN MAH.,410,363,357,80,277
SILIVRI,MIMAR SINAN MAH.,410,346,342,96,246
SILIVRI,MIMAR SINAN MAH.,409,371,371,89,282
SILIVRI,MIMAR SINAN MAH.,411,357,353,85,268
SILIVRI,MIMAR SINAN MAH.,409,365,361,92,269
SILIVRI,MIMAR SINAN MAH.,409,371,365,89,276
SILIVRI,MIMAR SINAN MAH.,410,368,364,81,283
SILIVRI,MIMAR SINAN MAH.,410,367,365,88,277
SILIVRI,ORTAKOY MAH.,410,364,358,136,222
SILIVRI,ORTAKOY MAH.,408,364,356,157,199
SILIVRI,ORTAKOY MAH.,410,371,371,133,238
SILIVRI,ORTAKOY MAH.,410,367,360,157,203
SILIVRI,ORTAKOY MAH.,410,375,366,151,215
SILIVRI,ORTAKOY MAH.,410,382,378,155,223
SILIVRI,ORTAKOY MAH.,409,393,383,178,205
SILIVRI,PIRI MEHMET PASA MAH.,405,349,342,90,252
SILIVRI,PIRI MEHMET PASA MAH.,406,321,317,88,229
SILIVRI,PIRI MEHMET PASA MAH.,405,366,362,131,231
SILIVRI,PIRI MEHMET PASA MAH.,405,364,361,122,239
SILIVRI,PIRI MEHMET PASA MAH.,405,358,354,101,253
SILIVRI,PIRI MEHMET PASA MAH.,405,369,365,132,233
SILIVRI,PIRI MEHMET PASA MAH.,404,357,352,95,257
SILIVRI,PIRI MEHMET PASA MAH.,405,370,362,90,272
SILIVRI,PIRI MEHMET PASA MAH.,407,353,351,117,234
SILIVRI,PIRI MEHMET PASA MAH.,404,360,357,114,243
SILIVRI,PIRI MEHMET PASA MAH.,407,344,340,88,252
SILIVRI,PIRI MEHMET PASA MAH.,404,367,363,114,249
SILIVRI,PIRI MEHMET PASA MAH.,405,344,338,111,227
SILIVRI,PIRI MEHMET PASA MAH.,404,362,358,138,220
SILIVRI,PIRI MEHMET PASA MAH.,404,359,357,127,230
SILIVRI,PIRI MEHMET PASA MAH.,405,358,350,129,221
SILIVRI,PIRI MEHMET PASA MAH.,404,355,351,111,240
SILIVRI,SANCAKTEPE MAH.,378,316,311,132,179
SILIVRI,SANCAKTEPE MAH.,377,336,332,153,179
SILIVRI,SANCAKTEPE MAH.,378,341,338,140,198
SILIVRI,SANCAKTEPE MAH.,377,341,340,159,181
SILIVRI,SANCAKTEPE MAH.,378,313,308,146,162
SILIVRI,SANCAKTEPE MAH.,378,317,312,133,179
SILIVRI,SANCAKTEPE MAH.,378,326,320,138,182
SILIVRI,SANCAKTEPE MAH.,378,326,321,129,192
SILIVRI,SANCAKTEPE MAH.,378,351,348,171,177
SILIVRI,SAYALAR MAH.,337,302,298,45,253
SILIVRI,SAYALAR MAH.,337,321,313,48,265
SILIVRI,SELIMPASA MAH.,412,334,327,113,214
SILIVRI,SELIMPASA MAH.,415,354,351,175,176
SILIVRI,SELIMPASA MAH.,413,353,350,175,175
SILIVRI,SELIMPASA MAH.,411,363,362,136,226
SILIVRI,SELIMPASA MAH.,391,320,319,117,202
SILIVRI,SELIMPASA MAH.,391,356,351,136,215
SILIVRI,SELIMPASA MAH.,391,333,330,126,204
SILIVRI,SELIMPASA MAH.,391,346,343,160,183
SILIVRI,SELIMPASA MAH.,403,318,307,152,155
SILIVRI,SELIMPASA MAH.,403,336,333,194,139
SILIVRI,SELIMPASA MAH.,402,353,350,232,118
SILIVRI,SELIMPASA MAH.,402,346,339,187,152
SILIVRI,SELIMPASA MAH.,402,357,350,207,143
SILIVRI,SELIMPASA MAH.,402,355,346,206,140
SILIVRI,SELIMPASA MAH.,402,336,330,188,142
SILIVRI,SELIMPASA MAH.,402,348,339,223,116
SILIVRI,SELIMPASA MAH.,402,348,343,196,147
SILIVRI,SELIMPASA MAH.,402,357,357,209,148
SILIVRI,SELIMPASA MAH.,404,349,344,213,131
SILIVRI,SELIMPASA MAH.,402,341,336,216,120
SILIVRI,SELIMPASA MAH.,406,346,342,203,139
SILIVRI,SELIMPASA MAH.,392,316,310,129,181
SILIVRI,SELIMPASA MAH.,393,348,344,174,170
SILIVRI,SELIMPASA MAH.,393,344,339,162,177
SILIVRI,SELIMPASA MAH.,395,352,348,173,175
SILIVRI,SELIMPASA MAH.,392,340,334,189,145
SILIVRI,SELIMPASA MAH.,392,353,347,188,159
SILIVRI,SELIMPASA MAH.,392,358,357,187,170
SILIVRI,SELIMPASA MAH.,392,344,341,172,169
SILIVRI,SELIMPASA MAH.,393,325,318,157,161
SILIVRI,SELIMPASA MAH.,392,356,353,179,174
SILIVRI,SELIMPASA MAH.,392,338,329,161,168
SILIVRI,SELIMPASA MAH.,391,341,338,162,176
SILIVRI,SEMIZKUMLAR MAH.,379,304,299,82,217
SILIVRI,SEMIZKUMLAR MAH.,380,321,314,123,191
SILIVRI,SEMIZKUMLAR MAH.,378,316,315,107,208
SILIVRI,SEMIZKUMLAR MAH.,379,324,323,133,190
SILIVRI,SEMIZKUMLAR MAH.,379,331,326,115,211
SILIVRI,SEMIZKUMLAR MAH.,347,49,48,21,27
SILIVRI,SEMIZKUMLAR MAH.,347,203,193,108,85
SILIVRI,SEMIZKUMLAR MAH.,345,212,208,133,75
SILIVRI,SEMIZKUMLAR MAH.,346,225,222,118,104
SILIVRI,SEMIZKUMLAR MAH.,345,205,200,105,95
SILIVRI,SEYMEN MAH.,282,247,240,55,185
SILIVRI,SEYMEN MAH.,283,262,258,65,193
SILIVRI,SEYMEN MAH.,283,257,250,64,186
SILIVRI,YENI MAH.,403,334,330,135,195
SILIVRI,YENI MAH.,403,346,344,128,216
SILIVRI,YENI MAH.,403,376,373,159,214
SILIVRI,YENI MAH.,403,364,360,150,210
SILIVRI,YENI MAH.,403,355,350,124,226
SILIVRI,YENI MAH.,402,359,355,140,215
SILIVRI,YENI MAH.,404,368,364,156,208
SILIVRI,YENI MAH.,403,370,367,165,202
SILIVRI,YENI MAH.,403,366,361,147,214
SILIVRI,YENI MAH.,403,348,342,151,191
SILIVRI,YENI MAH.,403,342,340,135,205
SILIVRI,YENI MAH.,402,349,342,136,206
SILIVRI,YENI MAH.,402,351,348,165,183
SILIVRI,YENI MAH.,402,351,348,139,209
SILIVRI,YENI MAH.,403,348,345,172,173
SILIVRI,YENI MAH.,403,364,360,154,206
SILIVRI,YENI MAH.,402,357,355,166,189
SILIVRI,YENI MAH.,403,352,348,161,187
SILIVRI,YENI MAH.,403,353,351,135,216
SILIVRI,YENI MAH.,403,356,349,155,194
SILIVRI,YENI MAH.,403,362,359,135,224
SILIVRI,YENI MAH.,364,328,324,168,156
SILIVRI,YENI MAH.,364,332,331,156,175
SILIVRI,YENI MAH.,365,323,312,133,179
SILIVRI,YENI MAH.,363,332,325,147,178
SILIVRI,YENI MAH.,364,325,321,174,147
SILIVRI,YENI MAH.,363,318,314,124,190
SILIVRI,YENI MAH.,399,339,333,201,132
SILIVRI,YENI MAH.,399,339,335,173,162
SILIVRI,YENI MAH.,399,335,333,200,133
SILIVRI,YENI MAH.,402,338,329,169,160
SILIVRI,YENI MAH.,399,348,337,198,139
SILIVRI,YENI MAH.,399,332,323,173,150
SILIVRI,YENI MAH.,399,333,325,172,153
SILIVRI,YENI MAH.,398,333,330,168,162
SILIVRI,YENI MAH.,399,306,299,146,153
SILIVRI,YENI MAH.,373,307,295,184,111
SILIVRI,YENI MAH.,372,310,307,166,141
SILIVRI,YENI MAH.,373,333,325,177,148
SILIVRI,YENI MAH.,372,306,298,180,118
SILIVRI,YENI MAH.,372,332,327,155,172
SILIVRI,YENI MAH.,372,330,319,182,137
SILIVRI,YENI MAH.,397,345,330,107,223
SILIVRI,YENI MAH.,397,358,353,131,222
SILIVRI,YENI MAH.,397,354,350,134,216
SILIVRI,YENI MAH.,397,363,354,132,222
SILIVRI,YENI MAH.,402,356,351,142,209
SILIVRI,YENI MAH.,396,357,355,127,228
SILIVRI,YENI MAH.,397,367,364,126,238
SILIVRI,YENI MAH.,397,351,345,120,225
SILIVRI,YENI MAH.,398,356,352,143,209
SILIVRI,YENI MAH.,397,363,359,146,213
SILIVRI,YENI MAH.,398,355,352,140,212
SILIVRI,YENI MAH.,398,358,352,143,209
SILIVRI,YENI MAH.,397,363,359,166,193
SILIVRI,YOLCATI MAH.,284,261,260,107,153
SILIVRI,SILIVRI ACIK CEZA INFAZ KURUMU,8,11,11,5,6
SILIVRI,SILIVRI 1 NOLU L TIPI KAPALI CEZA INFAZ KURUMU,162,168,165,92,73
SILIVRI,SILIVRI 1 NOLU L TIPI KAPALI CEZA INFAZ KURUMU,244,249,247,5,242
SILIVRI,SILIVRI 1 NOLU L TIPI KAPALI CEZA INFAZ KURUMU,257,262,261,11,250
SILIVRI,SILIVRI 2 NOLU L TIPI KAPALI CEZA INFAZ KURUMU,282,284,279,14,265
SILIVRI,SILIVRI 2 NOLU L TIPI KAPALI CEZA INFAZ KURUMU,142,139,136,48,88
SILIVRI,SILIVRI 2 NOLU L TIPI KAPALI CEZA INFAZ KURUMU,160,162,160,59,101
SILIVRI,SILIVRI 2 NOLU L TIPI KAPALI CEZA INFAZ KURUMU,262,260,257,33,224
SILIVRI,SILIVRI 2 NOLU L TIPI KAPALI CEZA INFAZ KURUMU,219,213,210,81,129
SILIVRI,SILIVRI 3 NOLU L TIPI KAPALI CEZA INFAZ KURUMU,331,332,328,179,149
SILIVRI,SILIVRI 3 NOLU L TIPI KAPALI CEZA INFAZ KURUMU,215,218,210,119,91
SILIVRI,SILIVRI 3 NOLU L TIPI KAPALI CEZA INFAZ KURUMU,328,334,331,13,318
SILIVRI,SILIVRI 3 NOLU L TIPI KAPALI CEZA INFAZ KURUMU,184,189,187,11,176
SILIVRI,SILIVRI 4 NOLU L TIPI KAPALI CEZA INFAZ KURUMU,314,309,298,18,280
SILIVRI,SILIVRI 4 NOLU L TIPI KAPALI CEZA INFAZ KURUMU,269,263,259,9,250
SILIVRI,SILIVRI 4 NOLU L TIPI KAPALI CEZA INFAZ KURUMU,292,215,211,90,121
SILIVRI,SILIVRI 5 NOLU L TIPI KAPALI CEZA INFAZ KURUMU,187,189,184,98,86
SILIVRI,SILIVRI 5 NOLU L TIPI KAPALI CEZA INFAZ KURUMU,375,378,377,44,333
SILIVRI,SILIVRI 5 NOLU L TIPI KAPALI CEZA INFAZ KURUMU,117,121,121,11,110
SILIVRI,SILIVRI 6 NOLU L TIPI KAPALI CEZA INFAZ KURUMU,239,233,230,11,219
SILIVRI,SILIVRI 6 NOLU L TIPI KAPALI CEZA INFAZ KURUMU,203,204,203,44,159
SILIVRI,SILIVRI 6 NOLU L TIPI KAPALI CEZA INFAZ KURUMU,279,282,279,123,156
SILIVRI,SILIVRI 7 NOLU L TIPI KAPALI CEZA INFAZ KURUMU,355,358,353,44,309
SILIVRI,SILIVRI 7 NOLU L TIPI KAPALI CEZA INFAZ KURUMU,357,359,349,85,264
SILIVRI,SILIVRI 7 NOLU L TIPI KAPALI CEZA INFAZ KURUMU,218,218,218,101,117
SILIVRI,SILIVRI 8 NOLU L TIPI KAPALI CEZA INFAZ KURUMU,281,285,283,9,274
SILIVRI,SILIVRI 8 NOLU L TIPI KAPALI CEZA INFAZ KURUMU,171,174,170,63,107
SILIVRI,SILIVRI 8 NOLU L TIPI KAPALI CEZA INFAZ KURUMU,320,323,322,52,270
SILIVRI,SILIVRI 8 NOLU L TIPI KAPALI CEZA INFAZ KURUMU,213,216,213,77,136
SILIVRI,SILIVRI KAPALI CEZA INFAZ KURUMU,164,166,165,6,159
SILIVRI,SILIVRI KAPALI CEZA INFAZ KURUMU,103,102,101,6,95
SILIVRI,SILIVRI KAPALI CEZA INFAZ KURUMU,144,128,127,6,121
SILIVRI,SILIVRI 6 NOLU L TIPI KAPALI CEZA INFAZ KURUMU,261,257,255,96,159
MALTEPE,ALTAYCESME MAH.,405,355,346,137,209
MALTEPE,ALTAYCESME MAH.,405,339,334,142,192
MALTEPE,ALTAYCESME MAH.,407,362,353,116,237
MALTEPE,ALTAYCESME MAH.,404,369,365,135,230
MALTEPE,ALTAYCESME MAH.,405,382,380,122,258
MALTEPE,ALTAYCESME MAH.,404,369,364,115,249
MALTEPE,ALTAYCESME MAH.,405,370,365,122,243
MALTEPE,ALTAYCESME MAH.,405,364,359,118,241
MALTEPE,ALTAYCESME MAH.,405,374,373,141,232
MALTEPE,ALTAYCESME MAH.,404,366,364,132,232
MALTEPE,ALTAYCESME MAH.,405,384,383,129,254
MALTEPE,ALTAYCESME MAH.,407,385,381,151,230
MALTEPE,ALTAYCESME MAH.,403,381,376,127,249
MALTEPE,ALTAYCESME MAH.,405,366,360,116,244
MALTEPE,ALTAYCESME MAH.,405,382,380,111,269
MALTEPE,ALTAYCESME MAH.,404,375,371,116,255
MALTEPE,ALTAYCESME MAH.,404,376,373,120,253
MALTEPE,ALTAYCESME MAH.,403,369,365,131,234
MALTEPE,ALTAYCESME MAH.,405,370,367,129,238
MALTEPE,ALTAYCESME MAH.,405,387,383,107,276
MALTEPE,ALTAYCESME MAH.,404,366,361,101,260
MALTEPE,ALTAYCESME MAH.,405,369,361,101,260
MALTEPE,ALTAYCESME MAH.,401,330,323,109,214
MALTEPE,ALTAYCESME MAH.,402,337,330,113,217
MALTEPE,ALTAYCESME MAH.,403,373,368,153,215
MALTEPE,ALTAYCESME MAH.,402,368,364,124,240
MALTEPE,ALTAYCESME MAH.,402,366,361,121,240
MALTEPE,ALTAYCESME MAH.,404,360,348,131,217
MALTEPE,ALTAYCESME MAH.,402,368,363,121,242
MALTEPE,ALTAYCESME MAH.,402,368,361,150,211
MALTEPE,ALTAYCESME MAH.,401,368,361,118,243
MALTEPE,ALTAYCESME MAH.,401,356,350,136,214
MALTEPE,ALTAYCESME MAH.,402,360,358,135,223
MALTEPE,ALTAYCESME MAH.,401,365,363,155,208
MALTEPE,ALTAYCESME MAH.,393,348,342,78,264
MALTEPE,ALTAYCESME MAH.,393,358,349,117,232
MALTEPE,ALTAYCESME MAH.,392,361,359,83,276
MALTEPE,ALTAYCESME MAH.,394,362,355,115,240
MALTEPE,ALTAYCESME MAH.,395,372,368,108,260
MALTEPE,ALTAYCESME MAH.,392,363,360,96,264
MALTEPE,ALTAYCESME MAH.,393,370,367,138,229
MALTEPE,ALTAYCESME MAH.,393,370,367,135,232
MALTEPE,ALTAYCESME MAH.,392,371,366,111,255
MALTEPE,ALTAYCESME MAH.,393,358,356,104,252
MALTEPE,ALTAYCESME MAH.,392,365,356,88,268
MALTEPE,ALTAYCESME MAH.,392,359,357,81,276
MALTEPE,ALTAYCESME MAH.,393,359,358,93,265
MALTEPE,ALTAYCESME MAH.,393,366,364,84,280
MALTEPE,ALTAYCESME MAH.,397,327,324,103,221
MALTEPE,ALTAYCESME MAH.,400,360,359,123,236
MALTEPE,ALTAYCESME MAH.,398,362,357,133,224
MALTEPE,ALTAYCESME MAH.,397,347,344,129,215
MALTEPE,ALTAYCESME MAH.,397,364,359,130,229
MALTEPE,ALTAYCESME MAH.,396,361,355,116,239
MALTEPE,ALTAYCESME MAH.,397,364,363,144,219
MALTEPE,ALTAYCESME MAH.,397,369,367,156,211
MALTEPE,ALTAYCESME MAH.,397,357,353,135,218
MALTEPE,ALTAYCESME MAH.,396,361,359,141,218
MALTEPE,ALTAYCESME MAH.,397,363,359,139,220
MALTEPE,BAGLARBASI MAH.,407,339,337,118,219
MALTEPE,BAGLARBASI MAH.,407,308,300,130,170
MALTEPE,BAGLARBASI MAH.,406,338,330,118,212
MALTEPE,BAGLARBASI MAH.,410,374,372,138,234
MALTEPE,BAGLARBASI MAH.,406,375,371,156,215
MALTEPE,BAGLARBASI MAH.,406,376,369,132,237
MALTEPE,BAGLARBASI MAH.,406,378,375,149,226
MALTEPE,BAGLARBASI MAH.,405,365,364,127,237
MALTEPE,BAGLARBASI MAH.,406,370,365,144,221
MALTEPE,BAGLARBASI MAH.,406,368,364,154,210
MALTEPE,BAGLARBASI MAH.,407,378,364,154,210
MALTEPE,BAGLARBASI MAH.,409,369,368,143,225
MALTEPE,BAGLARBASI MAH.,406,371,367,137,230
MALTEPE,BAGLARBASI MAH.,406,366,361,130,231
MALTEPE,BAGLARBASI MAH.,406,377,374,133,241
MALTEPE,BAGLARBASI MAH.,409,365,363,132,231
MALTEPE,BAGLARBASI MAH.,407,385,381,165,216
MALTEPE,BAGLARBASI MAH.,405,380,375,147,228
MALTEPE,BAGLARBASI MAH.,409,369,368,136,232
MALTEPE,BAGLARBASI MAH.,405,365,359,129,230
MALTEPE,BAGLARBASI MAH.,406,361,354,115,239
MALTEPE,BAGLARBASI MAH.,405,360,354,110,244
MALTEPE,BAGLARBASI MAH.,406,371,369,124,245
MALTEPE,BAGLARBASI MAH.,405,364,359,129,230
MALTEPE,BAGLARBASI MAH.,406,371,368,124,244
MALTEPE,BAGLARBASI MAH.,415,347,345,117,228
MALTEPE,BAGLARBASI MAH.,415,333,326,125,201
MALTEPE,BAGLARBASI MAH.,415,331,325,110,215
MALTEPE,BAGLARBASI MAH.,412,363,363,108,255
MALTEPE,BAGLARBASI MAH.,415,364,361,136,225
MALTEPE,BAGLARBASI MAH.,412,375,373,145,228
MALTEPE,BAGLARBASI MAH.,412,365,362,157,205
MALTEPE,BAGLARBASI MAH.,412,375,373,140,233
MALTEPE,BAGLARBASI MAH.,412,374,367,122,245
MALTEPE,BAGLARBASI MAH.,412,368,364,118,246
MALTEPE,BAGLARBASI MAH.,411,368,364,129,235
MALTEPE,BAGLARBASI MAH.,412,374,368,141,227
MALTEPE,BAGLARBASI MAH.,411,381,379,114,265
MALTEPE,BAGLARBASI MAH.,412,370,367,149,218
MALTEPE,BAGLARBASI MAH.,410,373,369,133,236
MALTEPE,BAGLARBASI MAH.,412,381,377,137,240
MALTEPE,BAGLARBASI MAH.,411,370,368,131,237
MALTEPE,BAGLARBASI MAH.,412,368,364,116,248
MALTEPE,BAGLARBASI MAH.,412,372,366,137,229
MALTEPE,BAGLARBASI MAH.,415,372,370,139,231
MALTEPE,BAGLARBASI MAH.,411,379,377,137,240
MALTEPE,BAGLARBASI MAH.,411,376,371,144,227
MALTEPE,BAGLARBASI MAH.,415,378,374,133,241
MALTEPE,BAGLARBASI MAH.,412,385,379,102,277
MALTEPE,BAGLARBASI MAH.,411,351,348,131,217
MALTEPE,BAGLARBASI MAH.,391,316,313,92,221
MALTEPE,BAGLARBASI MAH.,393,334,326,91,235
MALTEPE,BAGLARBASI MAH.,392,355,350,98,252
MALTEPE,BAGLARBASI MAH.,391,334,331,102,229
MALTEPE,BAGLARBASI MAH.,392,350,345,101,244
MALTEPE,BAGLARBASI MAH.,391,344,343,85,258
MALTEPE,BAGLARBASI MAH.,392,345,341,118,223
MALTEPE,BAGLARBASI MAH.,391,342,339,106,233
MALTEPE,BAGLARBASI MAH.,392,351,349,135,214
MALTEPE,BAGLARBASI MAH.,392,349,348,118,230
MALTEPE,BAGLARBASI MAH.,392,337,336,113,223
MALTEPE,BAGLARBASI MAH.,396,348,344,111,233
MALTEPE,BAGLARBASI MAH.,416,351,347,179,168
MALTEPE,BAGLARBASI MAH.,416,376,371,147,224
MALTEPE,BAGLARBASI MAH.,416,350,348,132,216
MALTEPE,BAGLARBASI MAH.,416,376,371,151,220
MALTEPE,BAGLARBASI MAH.,415,361,357,150,207
MALTEPE,BAGLARBASI MAH.,416,356,354,151,203
MALTEPE,BAGLARBASI MAH.,416,370,370,143,227
MALTEPE,BAGLARBASI MAH.,414,362,362,125,237
MALTEPE,BAGLARBASI MAH.,416,376,370,163,207
MALTEPE,BAGLARBASI MAH.,379,291,289,125,164
MALTEPE,BAGLARBASI MAH.,378,329,327,142,185
MALTEPE,BAGLARBASI MAH.,378,331,329,124,205
MALTEPE,BAGLARBASI MAH.,378,334,327,107,220
MALTEPE,BAGLARBASI MAH.,379,333,329,123,206
MALTEPE,BAGLARBASI MAH.,378,342,337,147,190
MALTEPE,BAGLARBASI MAH.,378,335,328,137,191
MALTEPE,BAGLARBASI MAH.,378,351,347,180,167
MALTEPE,BAGLARBASI MAH.,379,351,345,129,216
MALTEPE,BAGLARBASI MAH.,378,333,327,160,167
MALTEPE,BAGLARBASI MAH.,378,328,325,140,185
MALTEPE,CEVIZLI MAH.,385,339,330,152,178
MALTEPE,CEVIZLI MAH.,387,359,351,175,176
MALTEPE,CEVIZLI MAH.,385,354,350,186,164
MALTEPE,CEVIZLI MAH.,384,358,356,192,164
MALTEPE,CEVIZLI MAH.,385,353,351,189,162
MALTEPE,CEVIZLI MAH.,385,346,342,157,185
MALTEPE,CEVIZLI MAH.,384,331,328,150,178
MALTEPE,CEVIZLI MAH.,385,347,344,178,166
MALTEPE,CEVIZLI MAH.,385,354,350,171,179
MALTEPE,CEVIZLI MAH.,385,344,340,153,187
MALTEPE,CEVIZLI MAH.,385,352,340,181,159
MALTEPE,CEVIZLI MAH.,400,317,307,145,162
MALTEPE,CEVIZLI MAH.,399,322,314,126,188
MALTEPE,CEVIZLI MAH.,400,342,339,149,190
MALTEPE,CEVIZLI MAH.,400,347,343,144,199
MALTEPE,CEVIZLI MAH.,400,356,351,138,213
MALTEPE,CEVIZLI MAH.,400,360,358,122,236
MALTEPE,CEVIZLI MAH.,400,350,345,180,165
MALTEPE,CEVIZLI MAH.,399,348,344,138,206
MALTEPE,CEVIZLI MAH.,400,369,363,156,207
MALTEPE,CEVIZLI MAH.,399,355,350,135,215
MALTEPE,CEVIZLI MAH.,399,346,342,144,198
MALTEPE,CEVIZLI MAH.,401,348,343,145,198
MALTEPE,CEVIZLI MAH.,400,357,355,120,235
MALTEPE,CEVIZLI MAH.,400,352,350,173,177
MALTEPE,CEVIZLI MAH.,400,344,338,157,181
MALTEPE,CEVIZLI MAH.,399,357,353,170,183
MALTEPE,CEVIZLI MAH.,399,339,336,146,190
MALTEPE,CEVIZLI MAH.,400,342,341,133,208
MALTEPE,CEVIZLI MAH.,400,352,347,133,214
MALTEPE,CEVIZLI MAH.,399,344,341,165,176
MALTEPE,CEVIZLI MAH.,395,330,327,138,189
MALTEPE,CEVIZLI MAH.,397,331,327,118,209
MALTEPE,CEVIZLI MAH.,395,365,359,146,213
MALTEPE,CEVIZLI MAH.,395,342,339,129,210
MALTEPE,CEVIZLI MAH.,395,354,345,135,210
MALTEPE,CEVIZLI MAH.,396,364,358,136,222
MALTEPE,CEVIZLI MAH.,395,357,353,130,223
MALTEPE,CEVIZLI MAH.,396,363,361,138,223
MALTEPE,CEVIZLI MAH.,395,351,347,126,221
MALTEPE,CEVIZLI MAH.,395,350,345,141,204
MALTEPE,CEVIZLI MAH.,395,356,354,125,229
MALTEPE,CEVIZLI MAH.,396,364,363,148,215
MALTEPE,CEVIZLI MAH.,395,360,356,116,240
MALTEPE,CEVIZLI MAH.,395,356,349,147,202
MALTEPE,CEVIZLI MAH.,409,317,308,146,162
MALTEPE,CEVIZLI MAH.,409,339,331,159,172
MALTEPE,CEVIZLI MAH.,408,344,340,171,169
MALTEPE,CEVIZLI MAH.,408,358,355,180,175
MALTEPE,CEVIZLI MAH.,408,357,351,157,194
MALTEPE,CEVIZLI MAH.,407,353,346,168,178
MALTEPE,CEVIZLI MAH.,415,363,359,177,182
MALTEPE,CEVIZLI MAH.,408,364,361,163,198
MALTEPE,CEVIZLI MAH.,408,385,379,157,222
MALTEPE,CEVIZLI MAH.,407,371,370,179,191
MALTEPE,CEVIZLI MAH.,408,356,353,129,224
MALTEPE,CEVIZLI MAH.,407,365,364,165,199
MALTEPE,CEVIZLI MAH.,408,353,351,168,183
MALTEPE,CEVIZLI MAH.,407,372,366,156,210
MALTEPE,CEVIZLI MAH.,408,364,351,176,175
MALTEPE,CEVIZLI MAH.,408,365,363,179,184
MALTEPE,CEVIZLI MAH.,408,368,365,169,196
MALTEPE,CEVIZLI MAH.,407,360,356,163,193
MALTEPE,CEVIZLI MAH.,407,364,357,182,175
MALTEPE,CEVIZLI MAH.,407,362,361,171,190
MALTEPE,CEVIZLI MAH.,409,371,369,181,188
MALTEPE,ESENKENT MAH.,392,325,320,141,179
MALTEPE,ESENKENT MAH.,393,351,343,155,188
MALTEPE,ESENKENT MAH.,393,353,351,140,211
MALTEPE,ESENKENT MAH.,394,343,339,149,190
MALTEPE,ESENKENT MAH.,392,361,355,152,203
MALTEPE,ESENKENT MAH.,392,355,351,150,201
MALTEPE,ESENKENT MAH.,393,350,342,155,187
MALTEPE,ESENKENT MAH.,393,359,355,158,197
MALTEPE,ESENKENT MAH.,392,356,354,162,192
MALTEPE,ESENKENT MAH.,393,358,355,172,183
MALTEPE,ESENKENT MAH.,388,342,335,145,190
MALTEPE,ESENKENT MAH.,387,314,311,151,160
MALTEPE,ESENKENT MAH.,386,346,344,146,198
MALTEPE,ESENKENT MAH.,387,349,346,153,193
MALTEPE,ESENKENT MAH.,387,334,330,146,184
MALTEPE,ESENKENT MAH.,387,354,353,155,198
MALTEPE,ESENKENT MAH.,389,352,347,166,181
MALTEPE,ESENKENT MAH.,386,342,335,150,185
MALTEPE,ESENKENT MAH.,387,348,345,175,170
MALTEPE,ESENKENT MAH.,387,342,339,141,198
MALTEPE,ESENKENT MAH.,387,343,339,144,195
MALTEPE,ESENKENT MAH.,386,328,324,153,171
MALTEPE,ESENKENT MAH.,386,356,346,131,215
MALTEPE,ESENKENT MAH.,410,340,334,90,244
MALTEPE,ESENKENT MAH.,409,338,334,123,211
MALTEPE,ESENKENT MAH.,409,365,359,156,203
MALTEPE,ESENKENT MAH.,409,369,366,146,220
MALTEPE,ESENKENT MAH.,409,369,365,120,245
MALTEPE,ESENKENT MAH.,409,356,350,141,209
MALTEPE,ESENKENT MAH.,410,377,373,133,240
MALTEPE,ESENKENT MAH.,408,374,371,147,224
MALTEPE,ESENKENT MAH.,389,366,355,141,214
MALTEPE,ESENKENT MAH.,390,347,341,158,183
MALTEPE,ESENKENT MAH.,390,361,356,146,210
MALTEPE,ESENKENT MAH.,390,350,343,159,184
MALTEPE,ESENKENT MAH.,390,353,351,163,188
MALTEPE,ESENKENT MAH.,393,353,348,140,208
MALTEPE,ESENKENT MAH.,390,363,360,152,208
MALTEPE,ESENKENT MAH.,389,348,344,141,203
MALTEPE,ESENKENT MAH.,390,348,345,154,191
MALTEPE,ESENKENT MAH.,390,351,348,168,180
MALTEPE,ESENKENT MAH.,388,337,332,141,191
MALTEPE,ESENKENT MAH.,392,352,351,131,220
MALTEPE,ESENKENT MAH.,390,353,349,156,193
MALTEPE,FEYZULLAH MAH.,378,304,302,93,209
MALTEPE,FEYZULLAH MAH.,376,298,294,46,248
MALTEPE,FEYZULLAH MAH.,376,332,325,81,244
MALTEPE,FEYZULLAH MAH.,379,346,339,62,277
MALTEPE,FEYZULLAH MAH.,376,330,327,65,262
MALTEPE,FEYZULLAH MAH.,377,335,333,60,273
MALTEPE,FEYZULLAH MAH.,377,328,326,84,242
MALTEPE,FEYZULLAH MAH.,376,338,335,80,255
MALTEPE,FEYZULLAH MAH.,377,333,333,103,230
MALTEPE,FEYZULLAH MAH.,405,339,333,97,236
MALTEPE,FEYZULLAH MAH.,405,323,315,82,233
MALTEPE,FEYZULLAH MAH.,406,318,310,84,226
MALTEPE,FEYZULLAH MAH.,407,370,362,64,298
MALTEPE,FEYZULLAH MAH.,406,383,380,96,284
MALTEPE,FEYZULLAH MAH.,405,372,368,103,265
MALTEPE,FEYZULLAH MAH.,406,358,354,90,264
MALTEPE,FEYZULLAH MAH.,406,386,382,93,289
MALTEPE,FEYZULLAH MAH.,406,368,362,81,281
MALTEPE,FEYZULLAH MAH.,405,363,355,78,277
MALTEPE,FEYZULLAH MAH.,406,380,373,88,285
MALTEPE,FEYZULLAH MAH.,405,371,364,78,286
MALTEPE,FEYZULLAH MAH.,407,368,365,79,286
MALTEPE,FEYZULLAH MAH.,406,374,368,92,276
MALTEPE,FEYZULLAH MAH.,405,372,367,108,259
MALTEPE,FEYZULLAH MAH.,406,379,375,95,280
MALTEPE,FEYZULLAH MAH.,406,370,367,88,279
MALTEPE,FEYZULLAH MAH.,405,362,359,89,270
MALTEPE,FEYZULLAH MAH.,356,309,307,86,221
MALTEPE,FEYZULLAH MAH.,358,322,317,73,244
MALTEPE,FEYZULLAH MAH.,357,320,317,77,240
MALTEPE,FEYZULLAH MAH.,357,329,329,63,266
MALTEPE,FEYZULLAH MAH.,357,324,323,85,238
MALTEPE,FEYZULLAH MAH.,356,322,320,63,257
MALTEPE,FEYZULLAH MAH.,390,333,332,62,270
MALTEPE,FEYZULLAH MAH.,387,350,347,98,249
MALTEPE,FEYZULLAH MAH.,388,368,363,95,268
MALTEPE,FEYZULLAH MAH.,387,356,352,101,251
MALTEPE,FEYZULLAH MAH.,388,365,361,100,261
MALTEPE,FEYZULLAH MAH.,387,347,341,96,245
MALTEPE,FEYZULLAH MAH.,388,347,342,108,234
MALTEPE,FEYZULLAH MAH.,388,349,348,87,261
MALTEPE,GIRNE MAH.,415,360,358,136,222
MALTEPE,GIRNE MAH.,414,365,364,131,233
MALTEPE,GIRNE MAH.,415,387,379,166,213
MALTEPE,GIRNE MAH.,413,379,373,135,238
MALTEPE,GIRNE MAH.,414,375,375,171,204
MALTEPE,GIRNE MAH.,414,379,374,130,244
MALTEPE,GIRNE MAH.,415,382,374,158,216
MALTEPE,GIRNE MAH.,414,395,393,162,231
MALTEPE,GIRNE MAH.,415,382,381,168,213
MALTEPE,GIRNE MAH.,414,381,376,144,232
MALTEPE,GIRNE MAH.,414,375,371,136,235
MALTEPE,GIRNE MAH.,414,381,369,154,215
MALTEPE,GIRNE MAH.,415,377,370,123,247
MALTEPE,GIRNE MAH.,383,342,338,199,139
MALTEPE,GIRNE MAH.,382,343,339,165,174
MALTEPE,GIRNE MAH.,384,359,356,195,161
MALTEPE,GIRNE MAH.,385,361,356,149,207
MALTEPE,GIRNE MAH.,383,354,350,174,176
MALTEPE,GIRNE MAH.,383,354,342,173,169
MALTEPE,GIRNE MAH.,379,330,328,89,239
MALTEPE,GIRNE MAH.,381,354,348,88,260
MALTEPE,GIRNE MAH.,379,345,341,82,259
MALTEPE,GIRNE MAH.,379,354,352,96,256
MALTEPE,GIRNE MAH.,379,337,335,104,231
MALTEPE,GIRNE MAH.,382,343,338,129,209
MALTEPE,GIRNE MAH.,379,342,339,112,227
MALTEPE,GIRNE MAH.,379,362,358,106,252
MALTEPE,GIRNE MAH.,378,352,347,119,228
MALTEPE,GIRNE MAH.,379,353,349,116,233
MALTEPE,GIRNE MAH.,380,347,343,118,225
MALTEPE,YALI MAH.,410,366,365,69,296
MALTEPE,YALI MAH.,410,361,357,89,268
MALTEPE,YALI MAH.,410,373,368,75,293
MALTEPE,YALI MAH.,410,375,373,72,301
MALTEPE,YALI MAH.,415,376,375,61,314
MALTEPE,YALI MAH.,410,388,383,80,303
MALTEPE,YALI MAH.,409,370,370,64,306
MALTEPE,YALI MAH.,410,381,379,58,321
MALTEPE,YALI MAH.,409,370,368,81,287
MALTEPE,YALI MAH.,410,375,371,97,274
MALTEPE,YALI MAH.,388,323,316,87,229
MALTEPE,YALI MAH.,388,333,332,102,230
MALTEPE,YALI MAH.,388,338,337,80,257
MALTEPE,YALI MAH.,387,323,321,101,220
MALTEPE,YALI MAH.,394,335,328,106,222
MALTEPE,YALI MAH.,397,355,353,116,237
MALTEPE,YALI MAH.,399,365,360,96,264
MALTEPE,YALI MAH.,396,358,353,125,228
MALTEPE,YALI MAH.,395,371,366,130,236
MALTEPE,YALI MAH.,394,366,362,134,228
MALTEPE,YALI MAH.,395,355,349,114,235
MALTEPE,YALI MAH.,394,348,343,118,225
MALTEPE,YALI MAH.,394,352,350,105,245
MALTEPE,YALI MAH.,395,358,354,126,228
MALTEPE,YALI MAH.,395,360,358,130,228
MALTEPE,ZUMRUTEVLER MAH.,409,353,351,157,194
MALTEPE,ZUMRUTEVLER MAH.,415,336,328,145,183
MALTEPE,ZUMRUTEVLER MAH.,415,314,311,132,179
MALTEPE,ZUMRUTEVLER MAH.,408,350,344,155,189
MALTEPE,ZUMRUTEVLER MAH.,411,370,368,200,168
MALTEPE,ZUMRUTEVLER MAH.,409,356,348,153,195
MALTEPE,ZUMRUTEVLER MAH.,410,375,368,208,160
MALTEPE,ZUMRUTEVLER MAH.,408,371,367,186,181
MALTEPE,ZUMRUTEVLER MAH.,409,367,363,178,185
MALTEPE,ZUMRUTEVLER MAH.,409,363,359,177,182
MALTEPE,ZUMRUTEVLER MAH.,409,365,361,183,178
MALTEPE,ZUMRUTEVLER MAH.,408,374,369,183,186
MALTEPE,ZUMRUTEVLER MAH.,409,365,360,175,185
MALTEPE,ZUMRUTEVLER MAH.,409,379,376,195,181
MALTEPE,ZUMRUTEVLER MAH.,410,378,369,196,173
MALTEPE,ZUMRUTEVLER MAH.,409,368,363,192,171
MALTEPE,ZUMRUTEVLER MAH.,409,370,369,188,181
MALTEPE,ZUMRUTEVLER MAH.,409,369,360,158,202
MALTEPE,ZUMRUTEVLER MAH.,408,369,363,156,207
MALTEPE,ZUMRUTEVLER MAH.,409,371,369,182,187
MALTEPE,ZUMRUTEVLER MAH.,410,365,363,179,184
MALTEPE,ZUMRUTEVLER MAH.,411,379,376,179,197
MALTEPE,ZUMRUTEVLER MAH.,409,376,365,157,208
MALTEPE,ZUMRUTEVLER MAH.,408,372,369,160,209
MALTEPE,ZUMRUTEVLER MAH.,409,369,363,157,206
MALTEPE,ZUMRUTEVLER MAH.,409,361,354,203,151
MALTEPE,ZUMRUTEVLER MAH.,408,369,366,207,159
MALTEPE,ZUMRUTEVLER MAH.,409,366,362,173,189
MALTEPE,ZUMRUTEVLER MAH.,408,354,351,159,192
MALTEPE,ZUMRUTEVLER MAH.,409,360,356,202,154
MALTEPE,ZUMRUTEVLER MAH.,409,348,347,178,169
MALTEPE,ZUMRUTEVLER MAH.,409,380,374,169,205
MALTEPE,ZUMRUTEVLER MAH.,410,372,369,191,178
MALTEPE,ZUMRUTEVLER MAH.,408,378,376,183,193
MALTEPE,ZUMRUTEVLER MAH.,409,374,372,190,182
MALTEPE,ZUMRUTEVLER MAH.,266,212,204,93,111
MALTEPE,ZUMRUTEVLER MAH.,412,366,363,100,263
MALTEPE,ZUMRUTEVLER MAH.,414,368,364,125,239
MALTEPE,ZUMRUTEVLER MAH.,415,392,386,131,255
MALTEPE,ZUMRUTEVLER MAH.,414,372,368,148,220
MALTEPE,ZUMRUTEVLER MAH.,415,391,387,96,291
MALTEPE,ZUMRUTEVLER MAH.,415,375,371,119,252
MALTEPE,ZUMRUTEVLER MAH.,415,358,352,92,260
MALTEPE,ZUMRUTEVLER MAH.,415,384,380,107,273
MALTEPE,ZUMRUTEVLER MAH.,414,385,381,98,283
MALTEPE,ZUMRUTEVLER MAH.,414,373,371,100,271
MALTEPE,ZUMRUTEVLER MAH.,414,380,375,121,254
MALTEPE,ZUMRUTEVLER MAH.,414,385,378,110,268
MALTEPE,ZUMRUTEVLER MAH.,415,394,392,101,291
MALTEPE,ZUMRUTEVLER MAH.,414,372,368,88,280
MALTEPE,ZUMRUTEVLER MAH.,415,379,375,107,268
MALTEPE,ZUMRUTEVLER MAH.,415,375,371,117,254
MALTEPE,ZUMRUTEVLER MAH.,415,386,385,102,283
MALTEPE,ZUMRUTEVLER MAH.,415,380,377,112,265
MALTEPE,ZUMRUTEVLER MAH.,415,379,378,106,272
MALTEPE,ZUMRUTEVLER MAH.,415,384,381,133,248
MALTEPE,ZUMRUTEVLER MAH.,415,381,372,119,253
MALTEPE,ZUMRUTEVLER MAH.,414,376,373,107,266
MALTEPE,ZUMRUTEVLER MAH.,404,356,349,186,163
MALTEPE,ZUMRUTEVLER MAH.,403,336,334,163,171
MALTEPE,ZUMRUTEVLER MAH.,404,353,347,166,181
MALTEPE,ZUMRUTEVLER MAH.,404,359,354,145,209
MALTEPE,ZUMRUTEVLER MAH.,404,369,364,151,213
MALTEPE,ZUMRUTEVLER MAH.,405,362,355,167,188
MALTEPE,ZUMRUTEVLER MAH.,404,358,352,179,173
MALTEPE,ZUMRUTEVLER MAH.,403,354,349,161,188
MALTEPE,ZUMRUTEVLER MAH.,403,366,362,183,179
MALTEPE,ZUMRUTEVLER MAH.,404,358,354,171,183
MALTEPE,ZUMRUTEVLER MAH.,404,372,366,168,198
MALTEPE,ZUMRUTEVLER MAH.,403,363,361,161,200
MALTEPE,ZUMRUTEVLER MAH.,405,354,346,146,200
MALTEPE,ZUMRUTEVLER MAH.,415,375,370,177,193
MALTEPE,ZUMRUTEVLER MAH.,403,381,377,182,195
MALTEPE,ZUMRUTEVLER MAH.,404,367,366,141,225
MALTEPE,ZUMRUTEVLER MAH.,403,375,371,144,227
MALTEPE,ZUMRUTEVLER MAH.,404,367,362,175,187
MALTEPE,ZUMRUTEVLER MAH.,403,376,374,194,180
MALTEPE,ZUMRUTEVLER MAH.,403,361,359,146,213
MALTEPE,ZUMRUTEVLER MAH.,404,361,354,188,166
MALTEPE,ZUMRUTEVLER MAH.,403,377,364,188,176
MALTEPE,ZUMRUTEVLER MAH.,404,371,368,169,199
MALTEPE,ZUMRUTEVLER MAH.,404,383,381,179,202
MALTEPE,ZUMRUTEVLER MAH.,403,359,355,144,211
MALTEPE,ZUMRUTEVLER MAH.,404,364,360,171,189
MALTEPE,ZUMRUTEVLER MAH.,404,354,350,161,189
MALTEPE,ZUMRUTEVLER MAH.,403,364,361,153,208
MALTEPE,ZUMRUTEVLER MAH.,404,358,356,154,202
MALTEPE,ZUMRUTEVLER MAH.,404,362,356,162,194
MALTEPE,ZUMRUTEVLER MAH.,404,351,346,138,208
MALTEPE,ZUMRUTEVLER MAH.,405,355,350,159,191
MALTEPE,ZUMRUTEVLER MAH.,405,352,347,136,211
MALTEPE,ZUMRUTEVLER MAH.,404,360,356,148,208
MALTEPE,ZUMRUTEVLER MAH.,405,347,337,160,177
MALTEPE,ZUMRUTEVLER MAH.,407,356,354,143,211
MALTEPE,ZUMRUTEVLER MAH.,405,370,366,167,199
MALTEPE,ZUMRUTEVLER MAH.,405,356,355,163,192
MALTEPE,ZUMRUTEVLER MAH.,405,374,367,137,230
MALTEPE,ZUMRUTEVLER MAH.,406,375,369,155,214
MALTEPE,ZUMRUTEVLER MAH.,406,360,355,161,194
MALTEPE,ZUMRUTEVLER MAH.,405,366,361,156,205
MALTEPE,ZUMRUTEVLER MAH.,406,369,365,140,225
MALTEPE,ZUMRUTEVLER MAH.,405,366,360,164,196
MALTEPE,ZUMRUTEVLER MAH.,405,370,368,149,219
MALTEPE,ZUMRUTEVLER MAH.,405,365,356,174,182
MALTEPE,ZUMRUTEVLER MAH.,405,364,360,169,191
MALTEPE,ZUMRUTEVLER MAH.,405,369,365,182,183
MALTEPE,ZUMRUTEVLER MAH.,405,364,357,145,212
MALTEPE,ZUMRUTEVLER MAH.,405,376,371,168,203
MALTEPE,ZUMRUTEVLER MAH.,405,378,372,172,200
MALTEPE,ZUMRUTEVLER MAH.,405,357,352,174,178
MALTEPE,ZUMRUTEVLER MAH.,407,372,365,172,193
MALTEPE,ZUMRUTEVLER MAH.,405,364,361,163,198
MALTEPE,ZUMRUTEVLER MAH.,405,361,358,170,188
MALTEPE,ZUMRUTEVLER MAH.,411,357,352,168,184
MALTEPE,ZUMRUTEVLER MAH.,408,358,353,165,188
MALTEPE,ZUMRUTEVLER MAH.,408,365,359,179,180
MALTEPE,ZUMRUTEVLER MAH.,408,354,349,155,194
MALTEPE,ZUMRUTEVLER MAH.,410,371,365,179,186
MALTEPE,ZUMRUTEVLER MAH.,408,350,346,172,174
MALTEPE,ZUMRUTEVLER MAH.,408,372,365,162,203
MALTEPE,ZUMRUTEVLER MAH.,409,359,350,181,169
MALTEPE,ZUMRUTEVLER MAH.,408,373,370,175,195
MALTEPE,ZUMRUTEVLER MAH.,409,375,374,172,202
MALTEPE,ZUMRUTEVLER MAH.,407,372,362,170,192
MALTEPE,ZUMRUTEVLER MAH.,407,351,344,166,178
MALTEPE,ZUMRUTEVLER MAH.,408,359,354,160,194
MALTEPE,ZUMRUTEVLER MAH.,407,344,339,183,156
MALTEPE,ZUMRUTEVLER MAH.,407,368,364,195,169
MALTEPE,ZUMRUTEVLER MAH.,407,355,351,166,185
MALTEPE,ZUMRUTEVLER MAH.,407,346,339,143,196
MALTEPE,ZUMRUTEVLER MAH.,408,358,356,213,143
MALTEPE,ZUMRUTEVLER MAH.,407,371,367,186,181
MALTEPE,ZUMRUTEVLER MAH.,408,359,355,202,153
MALTEPE,ZUMRUTEVLER MAH.,408,360,353,183,170
MALTEPE,ZUMRUTEVLER MAH.,408,356,354,173,181
MALTEPE,ZUMRUTEVLER MAH.,408,361,359,161,198
MALTEPE,ZUMRUTEVLER MAH.,408,363,357,196,161
MALTEPE,ALTINTEPE MAH.,406,328,324,71,253
MALTEPE,ALTINTEPE MAH.,407,350,345,68,277
MALTEPE,ALTINTEPE MAH.,408,333,326,63,263
MALTEPE,ALTINTEPE MAH.,409,367,364,61,303
MALTEPE,ALTINTEPE MAH.,405,368,364,65,299
MALTEPE,ALTINTEPE MAH.,406,361,358,63,295
MALTEPE,ALTINTEPE MAH.,407,370,369,62,307
MALTEPE,ALTINTEPE MAH.,406,363,357,64,293
MALTEPE,ALTINTEPE MAH.,407,368,358,60,298
MALTEPE,ALTINTEPE MAH.,407,359,358,73,285
MALTEPE,ALTINTEPE MAH.,407,383,379,83,296
MALTEPE,ALTINTEPE MAH.,407,383,381,78,303
MALTEPE,ALTINTEPE MAH.,408,374,367,74,293
MALTEPE,ALTINTEPE MAH.,407,377,375,61,314
MALTEPE,ALTINTEPE MAH.,407,362,358,76,282
MALTEPE,ALTINTEPE MAH.,406,365,361,73,288
MALTEPE,ALTINTEPE MAH.,406,367,364,62,302
MALTEPE,ALTINTEPE MAH.,406,378,375,86,289
MALTEPE,ALTINTEPE MAH.,406,378,372,65,307
MALTEPE,ALTINTEPE MAH.,407,376,374,63,311
MALTEPE,ALTINTEPE MAH.,407,361,361,60,301
MALTEPE,ALTINTEPE MAH.,400,323,318,95,223
MALTEPE,ALTINTEPE MAH.,400,343,339,79,260
MALTEPE,ALTINTEPE MAH.,399,360,355,109,246
MALTEPE,ALTINTEPE MAH.,400,367,364,104,260
MALTEPE,ALTINTEPE MAH.,401,365,364,100,264
MALTEPE,ALTINTEPE MAH.,404,372,370,90,280
MALTEPE,ALTINTEPE MAH.,401,366,361,104,257
MALTEPE,ALTINTEPE MAH.,400,368,360,99,261
MALTEPE,ALTINTEPE MAH.,400,350,346,102,244
MALTEPE,ALTINTEPE MAH.,400,356,353,100,253
MALTEPE,ALTINTEPE MAH.,400,366,365,102,263
MALTEPE,ALTINTEPE MAH.,400,363,358,101,257
MALTEPE,ALTINTEPE MAH.,400,360,352,88,264
MALTEPE,ALTINTEPE MAH.,400,361,357,89,268
MALTEPE,ALTINTEPE MAH.,400,367,363,115,248
MALTEPE,ALTINTEPE MAH.,401,378,374,93,281
MALTEPE,ALTINTEPE MAH.,409,340,331,83,248
MALTEPE,ALTINTEPE MAH.,409,304,299,93,206
MALTEPE,ALTINTEPE MAH.,411,322,318,75,243
MALTEPE,ALTINTEPE MAH.,409,333,330,97,233
MALTEPE,ALTINTEPE MAH.,409,371,368,93,275
MALTEPE,ALTINTEPE MAH.,409,378,375,90,285
MALTEPE,ALTINTEPE MAH.,409,383,380,96,284
MALTEPE,ALTINTEPE MAH.,409,370,367,89,278
MALTEPE,ALTINTEPE MAH.,409,373,370,93,277
MALTEPE,ALTINTEPE MAH.,409,368,363,103,260
MALTEPE,ALTINTEPE MAH.,409,370,368,86,282
MALTEPE,ALTINTEPE MAH.,409,365,361,91,270
MALTEPE,ALTINTEPE MAH.,409,377,373,102,271
MALTEPE,ALTINTEPE MAH.,409,385,381,119,262
MALTEPE,ALTINTEPE MAH.,409,368,363,102,261
MALTEPE,ALTINTEPE MAH.,409,367,365,96,269
MALTEPE,ALTINTEPE MAH.,409,369,367,104,263
MALTEPE,ALTINTEPE MAH.,409,379,375,103,272
MALTEPE,ALTINTEPE MAH.,410,370,367,81,286
MALTEPE,ALTINTEPE MAH.,409,380,377,102,275
MALTEPE,ALTINTEPE MAH.,409,369,360,109,251
MALTEPE,ALTINTEPE MAH.,409,358,352,98,254
MALTEPE,ALTINTEPE MAH.,411,365,363,111,252
MALTEPE,ALTINTEPE MAH.,409,377,372,104,268
MALTEPE,ALTINTEPE MAH.,409,371,367,99,268
MALTEPE,ALTINTEPE MAH.,409,377,369,89,280
MALTEPE,AYDINEVLER MAH.,411,335,327,148,179
MALTEPE,AYDINEVLER MAH.,408,380,374,152,222
MALTEPE,AYDINEVLER MAH.,408,367,361,143,218
MALTEPE,AYDINEVLER MAH.,408,382,377,154,223
MALTEPE,AYDINEVLER MAH.,409,377,371,159,212
MALTEPE,AYDINEVLER MAH.,408,358,353,170,183
MALTEPE,AYDINEVLER MAH.,407,377,370,156,214
MALTEPE,AYDINEVLER MAH.,407,382,378,160,218
MALTEPE,AYDINEVLER MAH.,407,362,360,114,246
MALTEPE,AYDINEVLER MAH.,408,359,359,144,215
MALTEPE,AYDINEVLER MAH.,408,368,365,157,208
MALTEPE,AYDINEVLER MAH.,407,358,358,155,203
MALTEPE,AYDINEVLER MAH.,407,358,354,138,216
MALTEPE,AYDINEVLER MAH.,407,369,364,158,206
MALTEPE,AYDINEVLER MAH.,407,370,368,173,195
MALTEPE,AYDINEVLER MAH.,408,357,350,146,204
MALTEPE,AYDINEVLER MAH.,408,373,368,175,193
MALTEPE,AYDINEVLER MAH.,398,325,319,139,180
MALTEPE,AYDINEVLER MAH.,398,345,337,115,222
MALTEPE,AYDINEVLER MAH.,396,360,350,138,212
MALTEPE,AYDINEVLER MAH.,400,366,362,141,221
MALTEPE,AYDINEVLER MAH.,398,371,370,168,202
MALTEPE,AYDINEVLER MAH.,397,366,364,132,232
MALTEPE,AYDINEVLER MAH.,398,368,364,151,213
MALTEPE,AYDINEVLER MAH.,398,378,376,156,220
MALTEPE,AYDINEVLER MAH.,398,380,375,140,235
MALTEPE,AYDINEVLER MAH.,398,365,360,149,211
MALTEPE,AYDINEVLER MAH.,397,371,365,142,223
MALTEPE,AYDINEVLER MAH.,398,359,355,136,219
MALTEPE,AYDINEVLER MAH.,397,365,363,144,219
MALTEPE,AYDINEVLER MAH.,397,360,356,130,226
MALTEPE,AYDINEVLER MAH.,398,372,366,122,244
MALTEPE,AYDINEVLER MAH.,397,374,369,149,220
MALTEPE,AYDINEVLER MAH.,397,370,366,149,217
MALTEPE,AYDINEVLER MAH.,397,370,366,144,222
MALTEPE,BASIBUYUK MAH.,420,356,346,255,91
MALTEPE,BASIBUYUK MAH.,415,354,349,256,93
MALTEPE,BASIBUYUK MAH.,415,362,353,241,112
MALTEPE,BASIBUYUK MAH.,417,363,359,242,117
MALTEPE,BASIBUYUK MAH.,414,356,349,254,95
MALTEPE,BASIBUYUK MAH.,415,360,356,263,93
MALTEPE,BASIBUYUK MAH.,415,356,350,253,97
MALTEPE,BASIBUYUK MAH.,415,352,351,266,85
MALTEPE,BASIBUYUK MAH.,415,381,378,264,114
MALTEPE,BASIBUYUK MAH.,414,364,352,263,89
MALTEPE,BASIBUYUK MAH.,414,367,361,255,106
MALTEPE,BASIBUYUK MAH.,414,359,355,261,94
MALTEPE,BASIBUYUK MAH.,416,359,353,253,100
MALTEPE,BASIBUYUK MAH.,416,371,364,251,113
MALTEPE,BASIBUYUK MAH.,382,356,349,37,312
MALTEPE,BASIBUYUK MAH.,381,364,362,47,315
MALTEPE,BASIBUYUK MAH.,382,362,356,33,323
MALTEPE,BASIBUYUK MAH.,382,370,362,30,332
MALTEPE,BASIBUYUK MAH.,382,370,365,27,338
MALTEPE,BASIBUYUK MAH.,382,363,360,33,327
MALTEPE,BASIBUYUK MAH.,382,366,364,27,337
MALTEPE,BASIBUYUK MAH.,381,358,354,30,324
MALTEPE,BASIBUYUK MAH.,403,320,313,232,81
MALTEPE,BASIBUYUK MAH.,404,340,330,209,121
MALTEPE,BASIBUYUK MAH.,404,366,362,243,119
MALTEPE,BASIBUYUK MAH.,407,355,346,225,121
MALTEPE,BASIBUYUK MAH.,404,356,351,217,134
MALTEPE,BASIBUYUK MAH.,405,350,345,221,124
MALTEPE,BASIBUYUK MAH.,404,368,360,221,139
MALTEPE,BASIBUYUK MAH.,404,360,358,234,124
MALTEPE,BASIBUYUK MAH.,403,352,350,212,138
MALTEPE,BASIBUYUK MAH.,403,342,336,216,120
MALTEPE,BASIBUYUK MAH.,404,345,337,234,103
MALTEPE,BASIBUYUK MAH.,403,348,342,235,107
MALTEPE,BASIBUYUK MAH.,403,366,364,244,120
MALTEPE,BASIBUYUK MAH.,403,351,344,244,100
MALTEPE,BASIBUYUK MAH.,403,358,358,242,116
MALTEPE,BASIBUYUK MAH.,403,361,356,225,131
MALTEPE,BASIBUYUK MAH.,403,348,343,213,130
MALTEPE,BUYUKBAKKALKOY MAH.,346,258,255,124,131
MALTEPE,BUYUKBAKKALKOY MAH.,342,300,296,162,134
MALTEPE,BUYUKBAKKALKOY MAH.,342,266,263,135,128
MALTEPE,BUYUKBAKKALKOY MAH.,343,287,283,142,141
MALTEPE,CINAR MAH.,405,345,344,81,263
MALTEPE,CINAR MAH.,405,341,336,65,271
MALTEPE,CINAR MAH.,404,329,325,83,242
MALTEPE,CINAR MAH.,406,343,341,83,258
MALTEPE,CINAR MAH.,405,365,360,66,294
MALTEPE,CINAR MAH.,406,365,363,89,274
MALTEPE,CINAR MAH.,405,379,376,87,289
MALTEPE,CINAR MAH.,407,372,365,70,295
MALTEPE,CINAR MAH.,405,379,371,85,286
MALTEPE,CINAR MAH.,405,369,367,90,277
MALTEPE,CINAR MAH.,405,364,360,88,272
MALTEPE,CINAR MAH.,406,378,376,84,292
MALTEPE,CINAR MAH.,405,378,375,91,284
MALTEPE,CINAR MAH.,406,369,368,97,271
MALTEPE,CINAR MAH.,405,355,353,68,285
MALTEPE,CINAR MAH.,407,360,355,79,276
MALTEPE,CINAR MAH.,405,370,368,85,283
MALTEPE,CINAR MAH.,405,364,356,79,277
MALTEPE,CINAR MAH.,405,353,350,87,263
MALTEPE,CINAR MAH.,406,369,365,94,271
MALTEPE,CINAR MAH.,405,380,379,109,270
MALTEPE,CINAR MAH.,405,381,377,71,306
MALTEPE,CINAR MAH.,405,369,367,93,274
MALTEPE,CINAR MAH.,405,368,365,104,261
MALTEPE,CINAR MAH.,405,349,346,79,267
MALTEPE,CINAR MAH.,400,343,339,85,254
MALTEPE,CINAR MAH.,401,335,335,73,262
MALTEPE,CINAR MAH.,400,368,364,126,238
MALTEPE,CINAR MAH.,401,377,376,103,273
MALTEPE,CINAR MAH.,401,376,370,106,264
MALTEPE,CINAR MAH.,401,368,364,117,247
MALTEPE,CINAR MAH.,399,368,364,95,269
MALTEPE,CINAR MAH.,401,364,360,91,269
MALTEPE,CINAR MAH.,400,363,361,106,255
MALTEPE,CINAR MAH.,402,368,363,94,269
MALTEPE,CINAR MAH.,400,367,362,98,264
MALTEPE,CINAR MAH.,400,361,357,92,265
MALTEPE,CINAR MAH.,401,368,361,109,252
MALTEPE,CINAR MAH.,401,379,376,107,269
MALTEPE,FINDIKLI MAH.,409,338,332,198,134
MALTEPE,FINDIKLI MAH.,410,333,326,180,146
MALTEPE,FINDIKLI MAH.,409,347,337,162,175
MALTEPE,FINDIKLI MAH.,408,358,349,199,150
MALTEPE,FINDIKLI MAH.,407,356,349,210,139
MALTEPE,FINDIKLI MAH.,410,351,347,183,164
MALTEPE,FINDIKLI MAH.,408,357,357,197,160
MALTEPE,FINDIKLI MAH.,408,368,368,204,164
MALTEPE,FINDIKLI MAH.,409,366,361,225,136
MALTEPE,FINDIKLI MAH.,408,371,366,181,185
MALTEPE,FINDIKLI MAH.,409,362,360,199,161
MALTEPE,FINDIKLI MAH.,408,350,346,185,161
MALTEPE,FINDIKLI MAH.,410,365,359,210,149
MALTEPE,FINDIKLI MAH.,408,368,364,219,145
MALTEPE,FINDIKLI MAH.,408,362,356,214,142
MALTEPE,FINDIKLI MAH.,409,358,352,218,134
MALTEPE,FINDIKLI MAH.,408,362,356,194,162
MALTEPE,FINDIKLI MAH.,410,353,351,171,180
MALTEPE,FINDIKLI MAH.,409,357,354,216,138
MALTEPE,FINDIKLI MAH.,408,357,354,195,159
MALTEPE,FINDIKLI MAH.,410,344,337,190,147
MALTEPE,FINDIKLI MAH.,408,361,357,199,158
MALTEPE,FINDIKLI MAH.,408,369,363,202,161
MALTEPE,FINDIKLI MAH.,407,358,356,187,169
MALTEPE,FINDIKLI MAH.,410,358,357,213,144
MALTEPE,FINDIKLI MAH.,410,365,364,213,151
MALTEPE,FINDIKLI MAH.,409,372,368,189,179
MALTEPE,FINDIKLI MAH.,409,359,352,204,148
MALTEPE,FINDIKLI MAH.,409,350,349,199,150
MALTEPE,FINDIKLI MAH.,408,360,359,219,140
MALTEPE,FINDIKLI MAH.,408,353,351,183,168
MALTEPE,FINDIKLI MAH.,407,351,345,192,153
MALTEPE,FINDIKLI MAH.,407,341,339,176,163
MALTEPE,FINDIKLI MAH.,408,358,352,179,173
MALTEPE,FINDIKLI MAH.,408,354,349,195,154
MALTEPE,FINDIKLI MAH.,407,348,343,165,178
MALTEPE,FINDIKLI MAH.,408,338,335,166,169
MALTEPE,FINDIKLI MAH.,418,360,357,199,158
MALTEPE,FINDIKLI MAH.,415,319,313,206,107
MALTEPE,FINDIKLI MAH.,415,338,329,208,121
MALTEPE,FINDIKLI MAH.,415,362,358,209,149
MALTEPE,FINDIKLI MAH.,415,352,348,200,148
MALTEPE,FINDIKLI MAH.,415,372,367,207,160
MALTEPE,FINDIKLI MAH.,415,350,346,190,156
MALTEPE,FINDIKLI MAH.,416,351,345,202,143
MALTEPE,FINDIKLI MAH.,416,369,365,233,132
MALTEPE,FINDIKLI MAH.,415,363,358,195,163
MALTEPE,FINDIKLI MAH.,415,368,366,197,169
MALTEPE,FINDIKLI MAH.,415,361,358,207,151
MALTEPE,FINDIKLI MAH.,415,352,346,192,154
MALTEPE,FINDIKLI MAH.,416,348,344,203,141
MALTEPE,FINDIKLI MAH.,415,363,357,202,155
MALTEPE,FINDIKLI MAH.,414,356,351,204,147
MALTEPE,FINDIKLI MAH.,416,362,360,217,143
MALTEPE,FINDIKLI MAH.,415,343,341,182,159
MALTEPE,FINDIKLI MAH.,416,357,352,187,165
MALTEPE,FINDIKLI MAH.,415,343,339,208,131
MALTEPE,FINDIKLI MAH.,415,355,349,207,142
MALTEPE,FINDIKLI MAH.,416,356,349,183,166
MALTEPE,FINDIKLI MAH.,417,360,357,218,139
MALTEPE,FINDIKLI MAH.,414,354,347,219,128
MALTEPE,FINDIKLI MAH.,415,349,344,183,161
MALTEPE,FINDIKLI MAH.,415,363,359,227,132
MALTEPE,FINDIKLI MAH.,415,351,349,223,126
MALTEPE,FINDIKLI MAH.,414,352,351,215,136
MALTEPE,FINDIKLI MAH.,416,368,365,209,156
MALTEPE,FINDIKLI MAH.,415,360,358,214,144
MALTEPE,FINDIKLI MAH.,415,353,345,183,162
MALTEPE,FINDIKLI MAH.,415,346,340,190,150
MALTEPE,FINDIKLI MAH.,415,364,359,239,120
MALTEPE,FINDIKLI MAH.,417,360,355,224,131
MALTEPE,FINDIKLI MAH.,418,369,366,223,143
MALTEPE,FINDIKLI MAH.,416,354,350,215,135
MALTEPE,FINDIKLI MAH.,414,357,355,204,151
MALTEPE,FINDIKLI MAH.,415,364,353,198,155
MALTEPE,FINDIKLI MAH.,414,363,360,214,146
MALTEPE,FINDIKLI MAH.,415,354,352,211,141
MALTEPE,FINDIKLI MAH.,414,340,335,187,148
MALTEPE,FINDIKLI MAH.,414,354,347,181,166
MALTEPE,FINDIKLI MAH.,415,357,351,204,147
MALTEPE,FINDIKLI MAH.,415,357,351,208,143
MALTEPE,FINDIKLI MAH.,414,366,356,215,141
MALTEPE,FINDIKLI MAH.,415,357,354,224,130
MALTEPE,FINDIKLI MAH.,415,352,347,219,128
MALTEPE,FINDIKLI MAH.,417,349,334,205,129
MALTEPE,FINDIKLI MAH.,415,338,335,164,171
MALTEPE,FINDIKLI MAH.,416,338,337,196,141
MALTEPE,FINDIKLI MAH.,416,377,376,226,150
MALTEPE,FINDIKLI MAH.,415,351,350,178,172
MALTEPE,FINDIKLI MAH.,414,372,365,207,158
MALTEPE,FINDIKLI MAH.,416,376,370,232,138
MALTEPE,FINDIKLI MAH.,415,364,361,193,168
MALTEPE,FINDIKLI MAH.,415,373,370,184,186
MALTEPE,FINDIKLI MAH.,415,367,364,200,164
MALTEPE,FINDIKLI MAH.,414,359,351,169,182
MALTEPE,FINDIKLI MAH.,415,372,370,201,169
MALTEPE,FINDIKLI MAH.,417,361,357,194,163
MALTEPE,FINDIKLI MAH.,414,360,359,183,176
MALTEPE,FINDIKLI MAH.,415,360,355,210,145
MALTEPE,FINDIKLI MAH.,414,374,373,191,182
MALTEPE,FINDIKLI MAH.,414,370,367,195,172
MALTEPE,FINDIKLI MAH.,417,362,360,206,154
MALTEPE,GULENSU MAH.,395,349,336,81,255
MALTEPE,GULENSU MAH.,396,343,336,64,272
MALTEPE,GULENSU MAH.,396,362,359,106,253
MALTEPE,GULENSU MAH.,394,354,351,97,254
MALTEPE,GULENSU MAH.,396,358,356,80,276
MALTEPE,GULENSU MAH.,396,356,351,89,262
MALTEPE,GULENSU MAH.,395,352,351,96,255
MALTEPE,GULENSU MAH.,395,361,358,103,255
MALTEPE,GULENSU MAH.,395,372,370,121,249
MALTEPE,GULENSU MAH.,395,357,353,86,267
MALTEPE,GULENSU MAH.,396,352,347,102,245
MALTEPE,GULENSU MAH.,396,356,353,103,250
MALTEPE,GULENSU MAH.,396,359,354,100,254
MALTEPE,GULENSU MAH.,395,344,342,103,239
MALTEPE,GULENSU MAH.,396,344,341,90,251
MALTEPE,GULENSU MAH.,396,353,349,100,249
MALTEPE,GULENSU MAH.,396,353,349,95,254
MALTEPE,GULENSU MAH.,395,365,358,104,254
MALTEPE,GULENSU MAH.,402,359,351,46,305
MALTEPE,GULENSU MAH.,401,357,352,51,301
MALTEPE,GULENSU MAH.,402,366,364,48,316
MALTEPE,GULENSU MAH.,403,377,372,43,329
MALTEPE,GULENSU MAH.,402,373,371,56,315
MALTEPE,GULENSU MAH.,402,366,362,53,309
MALTEPE,GULENSU MAH.,405,370,365,63,302
MALTEPE,GULENSU MAH.,401,368,364,42,322
MALTEPE,GULENSU MAH.,402,360,357,42,315
MALTEPE,GULENSU MAH.,403,378,371,72,299
MALTEPE,GULENSU MAH.,402,366,363,45,318
MALTEPE,GULENSU MAH.,400,363,363,50,313
MALTEPE,GULSUYU MAH.,398,341,340,126,214
MALTEPE,GULSUYU MAH.,397,324,318,125,193
MALTEPE,GULSUYU MAH.,398,352,344,153,191
MALTEPE,GULSUYU MAH.,397,357,354,149,205
MALTEPE,GULSUYU MAH.,397,349,347,132,215
MALTEPE,GULSUYU MAH.,399,352,349,161,188
MALTEPE,GULSUYU MAH.,400,356,352,166,186
MALTEPE,GULSUYU MAH.,397,360,357,154,203
MALTEPE,GULSUYU MAH.,400,364,362,168,194
MALTEPE,GULSUYU MAH.,396,355,353,197,156
MALTEPE,GULSUYU MAH.,396,346,344,183,161
MALTEPE,GULSUYU MAH.,398,363,360,185,175
MALTEPE,GULSUYU MAH.,396,352,331,144,187
MALTEPE,GULSUYU MAH.,396,362,359,177,182
MALTEPE,GULSUYU MAH.,397,343,336,153,183
MALTEPE,GULSUYU MAH.,397,359,356,157,199
MALTEPE,GULSUYU MAH.,406,365,356,186,170
MALTEPE,GULSUYU MAH.,407,353,350,176,174
MALTEPE,GULSUYU MAH.,406,369,364,140,224
MALTEPE,GULSUYU MAH.,406,358,353,149,204
MALTEPE,GULSUYU MAH.,407,362,360,169,191
MALTEPE,GULSUYU MAH.,405,364,355,154,201
MALTEPE,GULSUYU MAH.,404,347,345,131,214
MALTEPE,GULSUYU MAH.,406,348,345,141,204
MALTEPE,GULSUYU MAH.,405,367,363,173,190
MALTEPE,GULSUYU MAH.,406,346,340,159,181
MALTEPE,GULSUYU MAH.,405,366,362,161,201
MALTEPE,GULSUYU MAH.,405,347,343,159,184
MALTEPE,GULSUYU MAH.,405,358,353,139,214
MALTEPE,IDEALTEPE MAH.,388,333,329,108,221
MALTEPE,IDEALTEPE MAH.,387,333,326,107,219
MALTEPE,IDEALTEPE MAH.,388,362,359,81,278
MALTEPE,IDEALTEPE MAH.,388,354,349,86,263
MALTEPE,IDEALTEPE MAH.,388,365,363,87,276
MALTEPE,IDEALTEPE MAH.,389,357,350,90,260
MALTEPE,IDEALTEPE MAH.,389,356,354,75,279
MALTEPE,IDEALTEPE MAH.,388,373,371,100,271
MALTEPE,IDEALTEPE MAH.,387,349,345,82,263
MALTEPE,IDEALTEPE MAH.,389,358,356,62,294
MALTEPE,IDEALTEPE MAH.,388,365,363,97,266
MALTEPE,IDEALTEPE MAH.,388,364,363,94,269
MALTEPE,IDEALTEPE MAH.,388,338,333,86,247
MALTEPE,IDEALTEPE MAH.,412,341,338,96,242
MALTEPE,IDEALTEPE MAH.,415,342,336,100,236
MALTEPE,IDEALTEPE MAH.,412,383,379,78,301
MALTEPE,IDEALTEPE MAH.,415,393,388,100,288
MALTEPE,IDEALTEPE MAH.,415,375,371,96,275
MALTEPE,IDEALTEPE MAH.,415,383,372,106,266
MALTEPE,IDEALTEPE MAH.,415,370,366,115,251
MALTEPE,IDEALTEPE MAH.,411,379,375,117,258
MALTEPE,IDEALTEPE MAH.,415,376,374,78,296
MALTEPE,IDEALTEPE MAH.,412,386,380,111,269
MALTEPE,IDEALTEPE MAH.,411,377,372,101,271
MALTEPE,IDEALTEPE MAH.,413,381,379,102,277
MALTEPE,IDEALTEPE MAH.,413,389,382,121,261
MALTEPE,IDEALTEPE MAH.,415,360,355,67,288
MALTEPE,IDEALTEPE MAH.,411,352,350,78,272
MALTEPE,IDEALTEPE MAH.,412,382,375,90,285
MALTEPE,IDEALTEPE MAH.,411,385,381,72,309
MALTEPE,IDEALTEPE MAH.,412,393,392,67,325
MALTEPE,IDEALTEPE MAH.,412,380,377,75,302
MALTEPE,IDEALTEPE MAH.,412,379,377,71,306
MALTEPE,IDEALTEPE MAH.,412,381,376,61,315
MALTEPE,IDEALTEPE MAH.,412,381,379,71,308
MALTEPE,IDEALTEPE MAH.,411,377,371,68,303
MALTEPE,IDEALTEPE MAH.,412,379,376,37,339
MALTEPE,IDEALTEPE MAH.,412,390,388,72,316
MALTEPE,IDEALTEPE MAH.,412,380,373,75,298
MALTEPE,IDEALTEPE MAH.,412,381,379,77,302
MALTEPE,IDEALTEPE MAH.,411,386,384,67,317
MALTEPE,IDEALTEPE MAH.,412,393,390,65,325
MALTEPE,KUCUKYALI MERKEZ MAH.,405,327,322,113,209
MALTEPE,KUCUKYALI MERKEZ MAH.,407,345,337,95,242
MALTEPE,KUCUKYALI MERKEZ MAH.,405,356,353,143,210
MALTEPE,KUCUKYALI MERKEZ MAH.,407,371,367,137,230
MALTEPE,KUCUKYALI MERKEZ MAH.,407,367,365,131,234
MALTEPE,KUCUKYALI MERKEZ MAH.,405,364,358,138,220
MALTEPE,KUCUKYALI MERKEZ MAH.,405,371,364,152,212
MALTEPE,KUCUKYALI MERKEZ MAH.,405,366,359,118,241
MALTEPE,KUCUKYALI MERKEZ MAH.,404,362,358,133,225
MALTEPE,KUCUKYALI MERKEZ MAH.,404,358,354,118,236
MALTEPE,KUCUKYALI MERKEZ MAH.,405,365,363,143,220
MALTEPE,KUCUKYALI MERKEZ MAH.,405,374,371,152,219
MALTEPE,KUCUKYALI MERKEZ MAH.,404,364,362,113,249
MALTEPE,KUCUKYALI MERKEZ MAH.,406,343,340,117,223
MALTEPE,KUCUKYALI MERKEZ MAH.,408,339,330,105,225
MALTEPE,KUCUKYALI MERKEZ MAH.,405,364,361,103,258
MALTEPE,KUCUKYALI MERKEZ MAH.,404,350,350,141,209
MALTEPE,KUCUKYALI MERKEZ MAH.,404,363,357,145,212
MALTEPE,KUCUKYALI MERKEZ MAH.,406,367,364,140,224
MALTEPE,KUCUKYALI MERKEZ MAH.,404,371,369,118,251
MALTEPE,KUCUKYALI MERKEZ MAH.,405,381,377,111,266
MALTEPE,KUCUKYALI MERKEZ MAH.,404,357,356,122,234
MALTEPE,KUCUKYALI MERKEZ MAH.,405,373,369,134,235
MALTEPE,KUCUKYALI MERKEZ MAH.,405,364,362,128,234
MALTEPE,KUCUKYALI MERKEZ MAH.,405,370,367,145,222
MALTEPE,KUCUKYALI MERKEZ MAH.,404,365,362,128,234
MALTEPE,KUCUKYALI MERKEZ MAH.,415,356,347,66,281
MALTEPE,KUCUKYALI MERKEZ MAH.,415,345,334,54,280
MALTEPE,KUCUKYALI MERKEZ MAH.,412,312,308,52,256
MALTEPE,KUCUKYALI MERKEZ MAH.,412,336,332,62,270
MALTEPE,KUCUKYALI MERKEZ MAH.,412,346,342,61,281
MALTEPE,KUCUKYALI MERKEZ MAH.,411,383,378,80,298
MALTEPE,KUCUKYALI MERKEZ MAH.,411,381,374,90,284
MALTEPE,KUCUKYALI MERKEZ MAH.,411,378,375,70,305
MALTEPE,KUCUKYALI MERKEZ MAH.,412,383,379,91,288
MALTEPE,KUCUKYALI MERKEZ MAH.,412,378,376,83,293
MALTEPE,KUCUKYALI MERKEZ MAH.,412,387,384,80,304
MALTEPE,KUCUKYALI MERKEZ MAH.,411,384,382,90,292
MALTEPE,KUCUKYALI MERKEZ MAH.,412,375,371,94,277
MALTEPE,KUCUKYALI MERKEZ MAH.,411,376,372,101,271
MALTEPE,KUCUKYALI MERKEZ MAH.,411,377,372,86,286
MALTEPE,KUCUKYALI MERKEZ MAH.,411,390,385,83,302
MALTEPE,KUCUKYALI MERKEZ MAH.,412,371,364,82,282
MALTEPE,KUCUKYALI MERKEZ MAH.,411,373,367,73,294
MALTEPE,KUCUKYALI MERKEZ MAH.,412,388,382,66,316
MALTEPE,KUCUKYALI MERKEZ MAH.,411,380,375,87,288
MALTEPE,KUCUKYALI MERKEZ MAH.,412,379,376,128,248
MALTEPE,KUCUKYALI MERKEZ MAH.,412,389,383,80,303
MALTEPE,KUCUKYALI MERKEZ MAH.,412,366,361,84,277
MALTEPE,KUCUKYALI MERKEZ MAH.,410,377,374,85,289
MALTEPE,KUCUKYALI MERKEZ MAH.,411,364,361,96,265
MALTEPE,MALTEPE ACIK CEZA INFAZ KURUMU,8,11,11,7,4
MALTEPE,MALTEPE 1 NOLU L TIPI KAPALI CEZA INFAZ KURUMU,349,354,350,166,184
MALTEPE,MALTEPE 1 NOLU L TIPI KAPALI CEZA INFAZ KURUMU,349,353,344,194,150
MALTEPE,MALTEPE 2 NOLU L TIPI KAPALI CEZA INFAZ KURUMU,240,243,241,139,102
MALTEPE,MALTEPE 2 NOLU L TIPI KAPALI CEZA INFAZ KURUMU,240,241,238,147,91
TUZLA,AKFIRAT MAH.,335,297,295,284,11
TUZLA,AKFIRAT MAH.,335,317,314,296,18
TUZLA,AKFIRAT MAH.,337,329,325,314,11
TUZLA,AKFIRAT MAH.,335,317,311,300,11
TUZLA,AKFIRAT MAH.,334,310,304,290,14
TUZLA,ANADOLU MAH.,310,292,286,188,98
TUZLA,ANADOLU MAH.,308,297,288,206,82
TUZLA,AYDINLI MAH.,395,345,334,129,205
TUZLA,AYDINLI MAH.,394,359,354,135,219
TUZLA,AYDINLI MAH.,394,353,349,131,218
TUZLA,AYDINLI MAH.,394,361,359,129,230
TUZLA,AYDINLI MAH.,393,364,362,124,238
TUZLA,AYDINLI MAH.,394,366,361,130,231
TUZLA,AYDINLI MAH.,394,369,363,126,237
TUZLA,AYDINLI MAH.,394,355,354,104,250
TUZLA,AYDINLI MAH.,393,357,355,118,237
TUZLA,AYDINLI MAH.,394,363,362,135,227
TUZLA,AYDINLI MAH.,394,358,355,137,218
TUZLA,AYDINLI MAH.,393,371,366,133,233
TUZLA,AYDINLI MAH.,404,353,347,248,99
TUZLA,AYDINLI MAH.,403,359,358,194,164
TUZLA,AYDINLI MAH.,404,356,355,233,122
TUZLA,AYDINLI MAH.,407,360,353,215,138
TUZLA,AYDINLI MAH.,404,363,360,236,124
TUZLA,AYDINLI MAH.,404,355,351,218,133
TUZLA,AYDINLI MAH.,405,352,351,227,124
TUZLA,AYDINLI MAH.,403,353,346,207,139
TUZLA,AYDINLI MAH.,404,360,356,218,138
TUZLA,AYDINLI MAH.,406,362,357,229,128
TUZLA,AYDINLI MAH.,403,350,347,205,142
TUZLA,AYDINLI MAH.,399,361,353,197,156
TUZLA,AYDINLI MAH.,400,366,363,183,180
TUZLA,AYDINLI MAH.,399,347,336,185,151
TUZLA,AYDINLI MAH.,399,364,361,188,173
TUZLA,AYDINLI MAH.,399,363,362,208,154
TUZLA,AYDINLI MAH.,400,355,347,189,158
TUZLA,AYDINLI MAH.,399,357,349,173,176
TUZLA,AYDINLI MAH.,400,353,348,157,191
TUZLA,AYDINLI MAH.,400,363,352,199,153
TUZLA,AYDINLI MAH.,399,361,354,205,149
TUZLA,AYDINLI MAH.,400,374,371,207,164
TUZLA,AYDINLI MAH.,399,371,367,197,170
TUZLA,AYDINLI MAH.,398,370,365,169,196
TUZLA,AYDINLI MAH.,402,365,360,206,154
TUZLA,AYDINLI MAH.,398,351,350,165,185
TUZLA,AYDINLI MAH.,398,328,321,150,171
TUZLA,AYDINLI MAH.,400,353,350,172,178
TUZLA,AYDINLI MAH.,398,367,358,171,187
TUZLA,AYDINLI MAH.,398,366,362,171,191
TUZLA,AYDINLI MAH.,398,364,364,167,197
TUZLA,AYDINLI MAH.,398,364,357,161,196
TUZLA,AYDINLI MAH.,398,368,364,174,190
TUZLA,AYDINLI MAH.,398,375,370,163,207
TUZLA,AYDINLI MAH.,400,371,366,151,215
TUZLA,AYDINLI MAH.,397,361,357,139,218
TUZLA,AYDINLI MAH.,397,356,355,146,209
TUZLA,AYDINLI MAH.,398,355,351,181,170
TUZLA,AYDINLI MAH.,398,369,364,164,200
TUZLA,AYDINLI MAH.,397,359,357,158,199
TUZLA,AYDINLI MAH.,398,353,350,169,181
TUZLA,AYDINLI MAH.,398,364,360,175,185
TUZLA,AYDINLI MAH.,400,357,355,171,184
TUZLA,AYDINLI MAH.,404,356,351,159,192
TUZLA,AYDINLI MAH.,405,370,368,130,238
TUZLA,AYDINLI MAH.,403,369,364,121,243
TUZLA,AYDINLI MAH.,406,365,361,145,216
TUZLA,AYDINLI MAH.,405,369,367,159,208
TUZLA,AYDINLI MAH.,404,360,356,165,191
TUZLA,AYDINLI MAH.,403,361,353,142,211
TUZLA,AYDINLI MAH.,407,365,360,148,212
TUZLA,AYDINLI MAH.,403,364,358,151,207
TUZLA,AYDINLI MAH.,404,367,356,123,233
TUZLA,AYDINLI MAH.,406,369,365,142,223
TUZLA,AYDINLI MAH.,403,377,371,119,252
TUZLA,AYDINLI MAH.,404,360,359,140,219
TUZLA,AYDINLI MAH.,404,380,376,136,240
TUZLA,AYDINLI MAH.,393,339,331,222,109
TUZLA,AYDINLI MAH.,392,355,345,224,121
TUZLA,AYDINLI MAH.,392,352,346,234,112
TUZLA,AYDINLI MAH.,393,345,337,218,119
TUZLA,AYDINLI MAH.,393,349,342,192,150
TUZLA,AYDINLI MAH.,392,353,347,225,122
TUZLA,AYDINLI MAH.,392,347,343,203,140
TUZLA,AYDINLI MAH.,392,346,340,225,115
TUZLA,AYDINLI MAH.,394,346,344,225,119
TUZLA,AYDINLI MAH.,392,352,343,211,132
TUZLA,AYDINLI MAH.,392,358,353,217,136
TUZLA,AYDINLI MAH.,392,349,347,228,119
TUZLA,AYDINLI MAH.,392,357,352,244,108
TUZLA,AYDINLI MAH.,409,370,358,202,156
TUZLA,AYDINLI MAH.,409,381,377,190,187
TUZLA,AYDINLI MAH.,415,366,358,183,175
TUZLA,AYDINLI MAH.,408,370,362,204,158
TUZLA,AYDINLI MAH.,408,380,374,208,166
TUZLA,AYDINLI MAH.,408,357,354,195,159
TUZLA,AYDINLI MAH.,409,365,363,210,153
TUZLA,AYDINLI MAH.,409,384,372,209,163
TUZLA,AYDINLI MAH.,408,379,374,182,192
TUZLA,AYDINLI MAH.,408,370,363,202,161
TUZLA,AYDINLI MAH.,408,363,358,200,158
TUZLA,AYDINTEPE MAH.,415,362,351,249,102
TUZLA,AYDINTEPE MAH.,415,357,346,238,108
TUZLA,AYDINTEPE MAH.,415,371,367,248,119
TUZLA,AYDINTEPE MAH.,415,353,350,244,106
TUZLA,AYDINTEPE MAH.,414,382,376,277,99
TUZLA,AYDINTEPE MAH.,415,378,373,278,95
TUZLA,AYDINTEPE MAH.,415,360,354,250,104
TUZLA,AYDINTEPE MAH.,415,353,349,253,96
TUZLA,AYDINTEPE MAH.,415,377,374,273,101
TUZLA,AYDINTEPE MAH.,415,370,364,265,99
TUZLA,AYDINTEPE MAH.,415,374,365,262,103
TUZLA,AYDINTEPE MAH.,414,359,356,239,117
TUZLA,AYDINTEPE MAH.,414,363,357,256,101
TUZLA,AYDINTEPE MAH.,415,371,369,251,118
TUZLA,AYDINTEPE MAH.,415,372,370,259,111
TUZLA,AYDINTEPE MAH.,414,358,354,258,96
TUZLA,AYDINTEPE MAH.,415,368,358,240,118
TUZLA,AYDINTEPE MAH.,415,367,358,250,108
TUZLA,AYDINTEPE MAH.,402,342,337,176,161
TUZLA,AYDINTEPE MAH.,403,340,335,137,198
TUZLA,AYDINTEPE MAH.,403,357,353,145,208
TUZLA,AYDINTEPE MAH.,401,355,348,142,206
TUZLA,AYDINTEPE MAH.,401,354,351,153,198
TUZLA,AYDINTEPE MAH.,401,365,361,154,207
TUZLA,AYDINTEPE MAH.,401,357,352,174,178
TUZLA,AYDINTEPE MAH.,401,354,350,146,204
TUZLA,AYDINTEPE MAH.,401,349,347,150,197
TUZLA,AYDINTEPE MAH.,401,363,362,153,209
TUZLA,AYDINTEPE MAH.,401,355,348,115,233
TUZLA,AYDINTEPE MAH.,404,361,353,159,194
TUZLA,AYDINTEPE MAH.,401,357,349,129,220
TUZLA,AYDINTEPE MAH.,401,354,350,150,200
TUZLA,AYDINTEPE MAH.,401,363,361,136,225
TUZLA,AYDINTEPE MAH.,401,368,362,148,214
TUZLA,AYDINTEPE MAH.,402,361,355,157,198
TUZLA,AYDINTEPE MAH.,401,350,347,140,207
TUZLA,AYDINTEPE MAH.,402,368,367,152,215
TUZLA,AYDINTEPE MAH.,401,371,366,145,221
TUZLA,AYDINTEPE MAH.,401,359,358,146,212
TUZLA,AYDINTEPE MAH.,401,369,369,161,208
TUZLA,AYDINTEPE MAH.,401,356,351,148,203
TUZLA,CAMI MAH.,384,321,317,57,260
TUZLA,CAMI MAH.,384,344,336,98,238
TUZLA,CAMI MAH.,383,332,329,86,243
TUZLA,CAMI MAH.,385,352,349,119,230
TUZLA,CAMI MAH.,383,338,334,114,220
TUZLA,CAMI MAH.,384,347,342,87,255
TUZLA,CAMI MAH.,384,351,346,90,256
TUZLA,CAMI MAH.,384,346,342,102,240
TUZLA,CAMI MAH.,384,341,334,93,241
TUZLA,CAMI MAH.,384,341,333,63,270
TUZLA,EVLIYA CELEBI MAH.,405,346,340,169,171
TUZLA,EVLIYA CELEBI MAH.,404,370,364,198,166
TUZLA,EVLIYA CELEBI MAH.,405,358,354,167,187
TUZLA,EVLIYA CELEBI MAH.,405,382,379,208,171
TUZLA,EVLIYA CELEBI MAH.,404,353,350,191,159
TUZLA,EVLIYA CELEBI MAH.,404,374,369,181,188
TUZLA,EVLIYA CELEBI MAH.,405,356,353,215,138
TUZLA,EVLIYA CELEBI MAH.,405,365,361,189,172
TUZLA,EVLIYA CELEBI MAH.,404,380,377,200,177
TUZLA,EVLIYA CELEBI MAH.,405,372,365,200,165
TUZLA,EVLIYA CELEBI MAH.,405,352,345,179,166
TUZLA,EVLIYA CELEBI MAH.,405,356,352,204,148
TUZLA,EVLIYA CELEBI MAH.,404,360,357,197,160
TUZLA,EVLIYA CELEBI MAH.,405,359,355,193,162
TUZLA,EVLIYA CELEBI MAH.,405,360,351,192,159
TUZLA,EVLIYA CELEBI MAH.,405,364,360,202,158
TUZLA,EVLIYA CELEBI MAH.,405,370,367,200,167
TUZLA,EVLIYA CELEBI MAH.,404,363,361,185,176
TUZLA,FATIH MAH.,371,341,338,152,186
TUZLA,FATIH MAH.,370,341,338,134,204
TUZLA,ICMELER MAH.,400,336,332,160,172
TUZLA,ICMELER MAH.,403,361,356,201,155
TUZLA,ICMELER MAH.,398,360,356,233,123
TUZLA,ICMELER MAH.,400,363,357,207,150
TUZLA,ICMELER MAH.,399,364,359,227,132
TUZLA,ICMELER MAH.,400,349,345,198,147
TUZLA,ICMELER MAH.,399,362,353,197,156
TUZLA,ICMELER MAH.,399,339,328,195,133
TUZLA,ICMELER MAH.,400,350,347,191,156
TUZLA,ICMELER MAH.,400,358,350,190,160
TUZLA,ICMELER MAH.,400,350,343,192,151
TUZLA,ICMELER MAH.,400,361,358,211,147
TUZLA,ICMELER MAH.,415,341,337,226,111
TUZLA,ICMELER MAH.,414,362,356,224,132
TUZLA,ICMELER MAH.,413,346,340,211,129
TUZLA,ICMELER MAH.,413,364,358,251,107
TUZLA,ICMELER MAH.,413,369,366,216,150
TUZLA,ICMELER MAH.,413,360,354,221,133
TUZLA,ICMELER MAH.,415,375,371,273,98
TUZLA,ISTASYON MAH.,399,335,327,137,190
TUZLA,ISTASYON MAH.,399,344,344,127,217
TUZLA,ISTASYON MAH.,399,367,362,111,251
TUZLA,ISTASYON MAH.,401,366,361,103,258
TUZLA,ISTASYON MAH.,399,367,361,129,232
TUZLA,ISTASYON MAH.,400,359,354,101,253
TUZLA,ISTASYON MAH.,399,369,365,106,259
TUZLA,ISTASYON MAH.,399,366,360,115,245
TUZLA,ISTASYON MAH.,401,370,363,103,260
TUZLA,ISTASYON MAH.,399,352,348,121,227
TUZLA,ISTASYON MAH.,400,366,360,131,229
TUZLA,ISTASYON MAH.,399,349,343,118,225
TUZLA,ISTASYON MAH.,399,363,355,116,239
TUZLA,ISTASYON MAH.,399,353,347,124,223
TUZLA,ISTASYON MAH.,400,367,364,111,253
TUZLA,ISTASYON MAH.,399,367,362,130,232
TUZLA,ISTASYON MAH.,399,361,355,109,246
TUZLA,ISTASYON MAH.,398,369,368,105,263
TUZLA,ISTASYON MAH.,398,372,371,125,246
TUZLA,ISTASYON MAH.,400,360,359,117,242
TUZLA,ISTASYON MAH.,393,343,341,150,191
TUZLA,ISTASYON MAH.,395,353,346,139,207
TUZLA,ISTASYON MAH.,396,360,357,148,209
TUZLA,ISTASYON MAH.,392,364,362,156,206
TUZLA,ISTASYON MAH.,393,354,346,144,202
TUZLA,ISTASYON MAH.,393,351,349,129,220
TUZLA,ISTASYON MAH.,393,350,346,146,200
TUZLA,ISTASYON MAH.,392,343,339,123,216
TUZLA,ISTASYON MAH.,392,362,359,118,241
TUZLA,ISTASYON MAH.,392,349,346,120,226
TUZLA,ISTASYON MAH.,392,361,355,148,207
TUZLA,ISTASYON MAH.,392,350,346,133,213
TUZLA,ISTASYON MAH.,392,372,369,138,231
TUZLA,ISTASYON MAH.,392,353,352,117,235
TUZLA,ISTASYON MAH.,393,364,361,143,218
TUZLA,MESCIT MAH.,374,325,321,180,141
TUZLA,MESCIT MAH.,374,335,330,208,122
TUZLA,MESCIT MAH.,374,338,335,207,128
TUZLA,MESCIT MAH.,373,335,332,217,115
TUZLA,MESCIT MAH.,373,338,334,222,112
TUZLA,MESCIT MAH.,375,331,324,199,125
TUZLA,MESCIT MAH.,376,344,339,221,118
TUZLA,MESCIT MAH.,372,322,312,211,101
TUZLA,MIMAR SINAN MAH.,415,373,367,222,145
TUZLA,MIMAR SINAN MAH.,415,352,344,207,137
TUZLA,MIMAR SINAN MAH.,415,370,351,249,102
TUZLA,MIMAR SINAN MAH.,415,391,382,231,151
TUZLA,MIMAR SINAN MAH.,415,373,369,237,132
TUZLA,MIMAR SINAN MAH.,415,373,364,232,132
TUZLA,MIMAR SINAN MAH.,411,361,357,204,153
TUZLA,MIMAR SINAN MAH.,415,360,358,213,145
TUZLA,MIMAR SINAN MAH.,415,374,368,232,136
TUZLA,MIMAR SINAN MAH.,412,358,355,241,114
TUZLA,MIMAR SINAN MAH.,411,380,371,221,150
TUZLA,MIMAR SINAN MAH.,412,369,365,236,129
TUZLA,MIMAR SINAN MAH.,412,382,379,234,145
TUZLA,MIMAR SINAN MAH.,412,377,373,229,144
TUZLA,MIMAR SINAN MAH.,412,362,357,223,134
TUZLA,MIMAR SINAN MAH.,415,362,353,217,136
TUZLA,MIMAR SINAN MAH.,411,351,344,177,167
TUZLA,MIMAR SINAN MAH.,412,368,355,216,139
TUZLA,MIMAR SINAN MAH.,412,378,373,213,160
TUZLA,MIMAR SINAN MAH.,412,368,355,219,136
TUZLA,MIMAR SINAN MAH.,411,385,378,244,134
TUZLA,MIMAR SINAN MAH.,411,386,383,227,156
TUZLA,MIMAR SINAN MAH.,412,367,363,213,150
TUZLA,MIMAR SINAN MAH.,411,369,364,246,118
TUZLA,MIMAR SINAN MAH.,412,382,379,236,143
TUZLA,MIMAR SINAN MAH.,411,357,350,197,153
TUZLA,MIMAR SINAN MAH.,411,376,369,235,134
TUZLA,MIMAR SINAN MAH.,412,386,385,243,142
TUZLA,MIMAR SINAN MAH.,412,365,360,226,134
TUZLA,MIMAR SINAN MAH.,412,369,361,221,140
TUZLA,MIMAR SINAN MAH.,412,362,353,193,160
TUZLA,MIMAR SINAN MAH.,411,366,360,204,156
TUZLA,MIMAR SINAN MAH.,412,377,370,244,126
TUZLA,MIMAR SINAN MAH.,411,352,349,223,126
TUZLA,MIMAR SINAN MAH.,412,366,364,208,156
TUZLA,MIMAR SINAN MAH.,412,377,372,233,139
TUZLA,MIMAR SINAN MAH.,412,362,358,215,143
TUZLA,MIMAR SINAN MAH.,411,359,354,224,130
TUZLA,MIMAR SINAN MAH.,411,374,365,219,146
TUZLA,ORHANLI MAH.,333,291,281,180,101
TUZLA,ORHANLI MAH.,333,304,299,225,74
TUZLA,ORHANLI MAH.,333,312,310,203,107
TUZLA,ORHANLI MAH.,333,290,284,211,73
TUZLA,ORTA MAH.,388,326,320,219,101
TUZLA,ORTA MAH.,385,347,344,205,139
TUZLA,ORTA MAH.,385,341,336,209,127
TUZLA,ORTA MAH.,385,355,350,197,153
TUZLA,ORTA MAH.,384,348,343,217,126
TUZLA,ORTA MAH.,384,350,346,216,130
TUZLA,ORTA MAH.,385,340,338,209,129
TUZLA,ORTA MAH.,386,360,357,213,144
TUZLA,ORTA MAH.,385,349,339,199,140
TUZLA,ORTA MAH.,385,343,335,202,133
TUZLA,ORTA MAH.,386,357,352,226,126
TUZLA,ORTA MAH.,387,348,342,181,161
TUZLA,ORTA MAH.,384,341,330,184,146
TUZLA,POSTANE MAH.,404,349,344,91,253
TUZLA,POSTANE MAH.,404,353,346,86,260
TUZLA,POSTANE MAH.,405,362,361,104,257
TUZLA,POSTANE MAH.,406,377,373,55,318
TUZLA,POSTANE MAH.,404,373,369,70,299
TUZLA,POSTANE MAH.,404,369,366,82,284
TUZLA,POSTANE MAH.,404,375,375,82,293
TUZLA,POSTANE MAH.,404,369,365,72,293
TUZLA,POSTANE MAH.,404,366,360,79,281
TUZLA,POSTANE MAH.,404,368,363,82,281
TUZLA,POSTANE MAH.,404,379,379,74,305
TUZLA,POSTANE MAH.,404,375,371,99,272
TUZLA,POSTANE MAH.,404,358,351,73,278
TUZLA,POSTANE MAH.,404,372,366,90,276
TUZLA,POSTANE MAH.,407,378,371,74,297
TUZLA,POSTANE MAH.,403,378,376,80,296
TUZLA,POSTANE MAH.,404,364,364,74,290
TUZLA,POSTANE MAH.,383,319,311,92,219
TUZLA,POSTANE MAH.,385,345,337,108,229
TUZLA,POSTANE MAH.,380,341,339,99,240
TUZLA,POSTANE MAH.,380,351,348,95,253
TUZLA,POSTANE MAH.,380,356,347,106,241
TUZLA,POSTANE MAH.,380,361,359,110,249
TUZLA,POSTANE MAH.,381,351,347,107,240
TUZLA,POSTANE MAH.,381,360,355,114,241
TUZLA,POSTANE MAH.,415,365,363,128,235
TUZLA,POSTANE MAH.,412,370,369,158,211
TUZLA,POSTANE MAH.,412,387,384,137,247
TUZLA,POSTANE MAH.,412,393,386,114,272
TUZLA,POSTANE MAH.,413,379,377,117,260
TUZLA,POSTANE MAH.,413,379,376,114,262
TUZLA,POSTANE MAH.,412,376,371,123,248
TUZLA,POSTANE MAH.,411,374,373,135,238
TUZLA,SIFA MAH.,401,352,346,194,152
TUZLA,SIFA MAH.,400,348,336,249,87
TUZLA,SIFA MAH.,399,369,356,236,120
TUZLA,SIFA MAH.,399,365,358,221,137
TUZLA,SIFA MAH.,401,345,337,221,116
TUZLA,SIFA MAH.,400,358,348,245,103
TUZLA,SIFA MAH.,400,357,351,234,117
TUZLA,SIFA MAH.,400,362,353,215,138
TUZLA,SIFA MAH.,398,359,352,220,132
TUZLA,SIFA MAH.,399,368,361,251,110
TUZLA,SIFA MAH.,398,359,356,238,118
TUZLA,SIFA MAH.,399,360,359,230,129
TUZLA,SIFA MAH.,399,360,358,244,114
TUZLA,SIFA MAH.,399,363,362,263,99
TUZLA,SIFA MAH.,398,360,357,256,101
TUZLA,SIFA MAH.,398,362,362,273,89
TUZLA,SIFA MAH.,399,355,348,219,129
TUZLA,SIFA MAH.,399,352,341,232,109
TUZLA,SIFA MAH.,399,350,347,255,92
TUZLA,SIFA MAH.,399,364,355,234,121
TUZLA,SIFA MAH.,398,358,355,239,116
TUZLA,SIFA MAH.,401,358,356,232,124
TUZLA,SIFA MAH.,408,359,348,236,112
TUZLA,SIFA MAH.,408,352,345,214,131
TUZLA,SIFA MAH.,407,365,360,249,111
TUZLA,SIFA MAH.,408,378,374,239,135
TUZLA,SIFA MAH.,408,379,374,257,117
TUZLA,SIFA MAH.,408,372,366,248,118
TUZLA,SIFA MAH.,408,359,355,229,126
TUZLA,SIFA MAH.,408,378,370,229,141
TUZLA,SIFA MAH.,408,368,362,217,145
TUZLA,SIFA MAH.,411,367,363,217,146
TUZLA,SIFA MAH.,408,360,351,216,135
TUZLA,SIFA MAH.,408,376,370,238,132
TUZLA,SIFA MAH.,408,373,367,207,160
TUZLA,SIFA MAH.,409,372,368,213,155
TUZLA,SIFA MAH.,410,363,359,201,158
TUZLA,SIFA MAH.,408,365,360,233,127
TUZLA,SIFA MAH.,415,360,355,239,116
TUZLA,SIFA MAH.,408,359,352,217,135
TUZLA,SIFA MAH.,409,366,360,226,134
TUZLA,SIFA MAH.,408,369,365,237,128
TUZLA,SIFA MAH.,409,361,354,235,119
TUZLA,SIFA MAH.,407,369,364,226,138
TUZLA,SIFA MAH.,407,375,372,230,142
TUZLA,SIFA MAH.,407,361,351,214,137
TUZLA,TEPEOREN MAH.,393,335,329,171,158
TUZLA,TEPEOREN MAH.,393,354,351,140,211
TUZLA,TEPEOREN MAH.,393,348,343,146,197
TUZLA,TEPEOREN MAH.,393,360,356,150,206
TUZLA,TEPEOREN MAH.,398,348,346,128,218
TUZLA,TEPEOREN MAH.,394,361,357,122,235
TUZLA,TEPEOREN MAH.,392,342,334,118,216
TUZLA,TEPEOREN MAH.,393,354,342,129,213
TUZLA,TEPEOREN MAH.,392,369,361,168,193
TUZLA,YAYLA MAH.,410,332,327,131,196
TUZLA,YAYLA MAH.,411,343,338,134,204
TUZLA,YAYLA MAH.,410,354,351,179,172
TUZLA,YAYLA MAH.,408,375,369,162,207
TUZLA,YAYLA MAH.,409,372,369,174,195
TUZLA,YAYLA MAH.,407,375,366,156,210
TUZLA,YAYLA MAH.,408,360,359,161,198
TUZLA,YAYLA MAH.,408,378,368,175,193
TUZLA,YAYLA MAH.,408,376,373,190,183
TUZLA,YAYLA MAH.,408,369,362,177,185
TUZLA,YAYLA MAH.,407,369,366,172,194
TUZLA,YAYLA MAH.,407,355,351,184,167
TUZLA,YAYLA MAH.,408,372,364,182,182
TUZLA,YAYLA MAH.,407,356,350,190,160
TUZLA,YAYLA MAH.,407,368,360,169,191
TUZLA,YAYLA MAH.,408,376,371,171,200
TUZLA,YAYLA MAH.,408,370,360,167,193
TUZLA,YAYLA MAH.,408,360,354,194,160
TUZLA,YAYLA MAH.,408,364,362,184,178
TUZLA,YAYLA MAH.,408,381,376,177,199
TUZLA,YAYLA MAH.,408,374,368,182,186
TUZLA,YAYLA MAH.,407,373,368,174,194
TUZLA,YAYLA MAH.,408,362,357,200,157
TUZLA,YAYLA MAH.,407,361,357,184,173
TUZLA,YAYLA MAH.,408,364,359,163,196
TUZLA,YAYLA MAH.,408,350,349,183,166
TUZLA,YAYLA MAH.,408,366,360,193,167
TUZLA,YAYLA MAH.,407,361,359,184,175
TUZLA,YAYLA MAH.,415,359,354,133,221
TUZLA,YAYLA MAH.,415,376,371,146,225
TUZLA,YAYLA MAH.,415,392,383,141,242
TUZLA,YAYLA MAH.,414,382,368,126,242
TUZLA,YAYLA MAH.,415,378,374,151,223
TUZLA,YAYLA MAH.,412,363,359,135,224
TUZLA,YAYLA MAH.,411,382,379,155,224
TUZLA,YAYLA MAH.,415,386,381,130,251
TUZLA,YAYLA MAH.,414,369,366,134,232
TUZLA,YAYLA MAH.,415,369,363,129,234
TUZLA,YAYLA MAH.,414,370,361,148,213
TUZLA,YAYLA MAH.,415,395,388,157,231
TUZLA,YAYLA MAH.,413,377,371,144,227
TUZLA,YAYLA MAH.,411,376,374,147,227
TUZLA,YAYLA MAH.,413,386,381,135,246
TUZLA,YAYLA MAH.,412,380,372,141,231
TUZLA,YAYLA MAH.,414,365,361,132,229
TUZLA,YAYLA MAH.,413,381,378,145,233
ZEYTINBURNU,GOKALP MAH.,403,330,322,133,189
ZEYTINBURNU,GOKALP MAH.,401,314,307,165,142
ZEYTINBURNU,GOKALP MAH.,402,340,336,169,167
ZEYTINBURNU,GOKALP MAH.,401,331,327,173,154
ZEYTINBURNU,GOKALP MAH.,401,347,337,171,166
ZEYTINBURNU,GOKALP MAH.,404,337,333,182,151
ZEYTINBURNU,GOKALP MAH.,400,366,356,153,203
ZEYTINBURNU,GOKALP MAH.,403,371,366,158,208
ZEYTINBURNU,GOKALP MAH.,401,352,347,155,192
ZEYTINBURNU,GOKALP MAH.,400,345,340,174,166
ZEYTINBURNU,GOKALP MAH.,400,345,340,173,167
ZEYTINBURNU,GOKALP MAH.,399,354,354,162,192
ZEYTINBURNU,GOKALP MAH.,400,348,346,155,191
ZEYTINBURNU,GOKALP MAH.,401,350,344,152,192
ZEYTINBURNU,GOKALP MAH.,400,347,345,156,189
ZEYTINBURNU,GOKALP MAH.,400,348,343,147,196
ZEYTINBURNU,GOKALP MAH.,401,359,353,185,168
ZEYTINBURNU,GOKALP MAH.,401,334,327,157,170
ZEYTINBURNU,GOKALP MAH.,400,366,361,178,183
ZEYTINBURNU,GOKALP MAH.,400,368,365,186,179
ZEYTINBURNU,GOKALP MAH.,394,325,320,138,182
ZEYTINBURNU,GOKALP MAH.,393,323,314,122,192
ZEYTINBURNU,GOKALP MAH.,394,338,333,139,194
ZEYTINBURNU,GOKALP MAH.,394,343,338,140,198
ZEYTINBURNU,GOKALP MAH.,394,333,325,141,184
ZEYTINBURNU,GOKALP MAH.,394,334,333,143,190
ZEYTINBURNU,GOKALP MAH.,396,348,344,138,206
ZEYTINBURNU,GOKALP MAH.,395,335,330,151,179
ZEYTINBURNU,GOKALP MAH.,394,353,350,139,211
ZEYTINBURNU,GOKALP MAH.,395,352,345,128,217
ZEYTINBURNU,GOKALP MAH.,394,349,344,156,188
ZEYTINBURNU,GOKALP MAH.,395,348,346,134,212
ZEYTINBURNU,GOKALP MAH.,394,332,330,144,186
ZEYTINBURNU,GOKALP MAH.,394,327,324,117,207
ZEYTINBURNU,GOKALP MAH.,394,345,342,148,194
ZEYTINBURNU,GOKALP MAH.,393,354,351,149,202
ZEYTINBURNU,KAZLICESME MAH.,172,84,83,23,60
ZEYTINBURNU,KAZLICESME MAH.,166,149,147,83,64
ZEYTINBURNU,KAZLICESME MAH.,370,290,283,134,149
ZEYTINBURNU,KAZLICESME MAH.,369,331,324,185,139
ZEYTINBURNU,KAZLICESME MAH.,115,64,62,18,44
ZEYTINBURNU,NURIPASA MAH.,415,302,299,163,136
ZEYTINBURNU,NURIPASA MAH.,415,333,330,166,164
ZEYTINBURNU,NURIPASA MAH.,415,345,340,163,177
ZEYTINBURNU,NURIPASA MAH.,412,346,340,174,166
ZEYTINBURNU,NURIPASA MAH.,415,356,355,202,153
ZEYTINBURNU,NURIPASA MAH.,415,342,336,178,158
ZEYTINBURNU,NURIPASA MAH.,415,359,352,197,155
ZEYTINBURNU,NURIPASA MAH.,415,363,360,230,130
ZEYTINBURNU,NURIPASA MAH.,412,353,349,205,144
ZEYTINBURNU,NURIPASA MAH.,412,363,357,185,172
ZEYTINBURNU,NURIPASA MAH.,415,353,343,196,147
ZEYTINBURNU,NURIPASA MAH.,415,332,330,180,150
ZEYTINBURNU,NURIPASA MAH.,413,362,356,179,177
ZEYTINBURNU,NURIPASA MAH.,415,344,338,165,173
ZEYTINBURNU,NURIPASA MAH.,414,359,355,200,155
ZEYTINBURNU,NURIPASA MAH.,413,356,352,193,159
ZEYTINBURNU,NURIPASA MAH.,413,359,356,158,198
ZEYTINBURNU,NURIPASA MAH.,414,360,359,203,156
ZEYTINBURNU,NURIPASA MAH.,414,351,347,171,176
ZEYTINBURNU,NURIPASA MAH.,411,322,319,168,151
ZEYTINBURNU,NURIPASA MAH.,415,320,315,171,144
ZEYTINBURNU,NURIPASA MAH.,411,350,344,232,112
ZEYTINBURNU,NURIPASA MAH.,411,361,355,220,135
ZEYTINBURNU,NURIPASA MAH.,412,359,356,165,191
ZEYTINBURNU,NURIPASA MAH.,412,347,344,205,139
ZEYTINBURNU,NURIPASA MAH.,411,360,355,197,158
ZEYTINBURNU,NURIPASA MAH.,411,369,365,228,137
ZEYTINBURNU,NURIPASA MAH.,411,360,356,194,162
ZEYTINBURNU,NURIPASA MAH.,411,360,356,190,166
ZEYTINBURNU,NURIPASA MAH.,412,324,320,172,148
ZEYTINBURNU,NURIPASA MAH.,410,354,348,182,166
ZEYTINBURNU,NURIPASA MAH.,411,356,351,220,131
ZEYTINBURNU,NURIPASA MAH.,410,336,332,184,148
ZEYTINBURNU,NURIPASA MAH.,415,345,337,218,119
ZEYTINBURNU,NURIPASA MAH.,415,353,342,211,131
ZEYTINBURNU,NURIPASA MAH.,414,343,335,186,149
ZEYTINBURNU,NURIPASA MAH.,411,339,334,196,138
ZEYTINBURNU,NURIPASA MAH.,412,348,343,218,125
ZEYTINBURNU,NURIPASA MAH.,412,353,347,195,152
ZEYTINBURNU,NURIPASA MAH.,415,352,346,194,152
ZEYTINBURNU,NURIPASA MAH.,411,339,338,202,136
ZEYTINBURNU,NURIPASA MAH.,412,344,337,224,113
ZEYTINBURNU,NURIPASA MAH.,415,349,344,200,144
ZEYTINBURNU,SUMER MAH.,373,323,313,137,176
ZEYTINBURNU,SUMER MAH.,373,331,329,140,189
ZEYTINBURNU,SUMER MAH.,372,337,336,132,204
ZEYTINBURNU,SUMER MAH.,372,339,335,147,188
ZEYTINBURNU,SUMER MAH.,372,337,327,167,160
ZEYTINBURNU,SUMER MAH.,372,323,316,155,161
ZEYTINBURNU,SUMER MAH.,372,327,323,146,177
ZEYTINBURNU,SUMER MAH.,372,327,322,144,178
ZEYTINBURNU,SUMER MAH.,374,294,290,150,140
ZEYTINBURNU,SUMER MAH.,373,331,325,162,163
ZEYTINBURNU,SUMER MAH.,376,336,328,161,167
ZEYTINBURNU,SUMER MAH.,373,314,309,171,138
ZEYTINBURNU,SUMER MAH.,373,314,307,173,134
ZEYTINBURNU,SUMER MAH.,373,322,309,171,138
ZEYTINBURNU,SUMER MAH.,373,323,317,144,173
ZEYTINBURNU,SUMER MAH.,376,332,328,180,148
ZEYTINBURNU,SUMER MAH.,373,346,344,150,194
ZEYTINBURNU,SUMER MAH.,405,330,323,158,165
ZEYTINBURNU,SUMER MAH.,406,351,347,174,173
ZEYTINBURNU,SUMER MAH.,406,353,351,171,180
ZEYTINBURNU,SUMER MAH.,415,361,355,174,181
ZEYTINBURNU,SUMER MAH.,405,344,338,177,161
ZEYTINBURNU,SUMER MAH.,403,333,329,171,158
ZEYTINBURNU,SUMER MAH.,405,343,338,144,194
ZEYTINBURNU,SUMER MAH.,405,349,342,194,148
ZEYTINBURNU,SUMER MAH.,404,358,355,177,178
ZEYTINBURNU,SUMER MAH.,403,331,322,151,171
ZEYTINBURNU,SUMER MAH.,404,349,341,152,189
ZEYTINBURNU,SUMER MAH.,405,348,344,166,178
ZEYTINBURNU,SUMER MAH.,403,335,330,152,178
ZEYTINBURNU,SUMER MAH.,404,367,360,174,186
ZEYTINBURNU,SUMER MAH.,403,339,333,163,170
ZEYTINBURNU,SUMER MAH.,403,361,356,168,188
ZEYTINBURNU,SUMER MAH.,402,353,345,174,171
ZEYTINBURNU,SUMER MAH.,403,342,338,171,167
ZEYTINBURNU,SUMER MAH.,403,342,336,144,192
ZEYTINBURNU,SUMER MAH.,404,362,360,188,172
ZEYTINBURNU,SUMER MAH.,402,347,340,168,172
ZEYTINBURNU,SUMER MAH.,404,349,346,129,217
ZEYTINBURNU,SUMER MAH.,386,316,311,116,195
ZEYTINBURNU,SUMER MAH.,386,341,338,109,229
ZEYTINBURNU,SUMER MAH.,387,330,327,119,208
ZEYTINBURNU,SUMER MAH.,386,339,338,109,229
ZEYTINBURNU,SUMER MAH.,387,351,346,115,231
ZEYTINBURNU,SUMER MAH.,386,347,342,119,223
ZEYTINBURNU,SUMER MAH.,387,351,349,134,215
ZEYTINBURNU,SUMER MAH.,387,346,344,137,207
ZEYTINBURNU,SUMER MAH.,389,344,338,136,202
ZEYTINBURNU,SUMER MAH.,385,345,342,140,202
ZEYTINBURNU,SUMER MAH.,386,326,323,130,193
ZEYTINBURNU,SUMER MAH.,386,347,342,114,228
ZEYTINBURNU,SUMER MAH.,387,337,336,133,203
ZEYTINBURNU,SUMER MAH.,415,329,323,176,147
ZEYTINBURNU,SUMER MAH.,415,350,347,192,155
ZEYTINBURNU,SUMER MAH.,413,365,362,148,214
ZEYTINBURNU,SUMER MAH.,413,362,355,182,173
ZEYTINBURNU,SUMER MAH.,415,348,339,157,182
ZEYTINBURNU,SUMER MAH.,415,364,357,187,170
ZEYTINBURNU,SUMER MAH.,415,348,347,167,180
ZEYTINBURNU,SUMER MAH.,415,364,361,177,184
ZEYTINBURNU,SUMER MAH.,414,371,367,178,189
ZEYTINBURNU,SUMER MAH.,414,370,368,182,186
ZEYTINBURNU,SUMER MAH.,415,360,355,157,198
ZEYTINBURNU,VELIEFENDI MAH.,405,329,316,135,181
ZEYTINBURNU,VELIEFENDI MAH.,404,315,306,167,139
ZEYTINBURNU,VELIEFENDI MAH.,404,337,330,132,198
ZEYTINBURNU,VELIEFENDI MAH.,405,346,343,191,152
ZEYTINBURNU,VELIEFENDI MAH.,407,354,350,157,193
ZEYTINBURNU,VELIEFENDI MAH.,404,351,345,147,198
ZEYTINBURNU,VELIEFENDI MAH.,404,363,361,159,202
ZEYTINBURNU,VELIEFENDI MAH.,405,354,347,153,194
ZEYTINBURNU,VELIEFENDI MAH.,404,345,343,162,181
ZEYTINBURNU,VELIEFENDI MAH.,406,357,352,138,214
ZEYTINBURNU,VELIEFENDI MAH.,404,360,353,153,200
ZEYTINBURNU,VELIEFENDI MAH.,404,360,351,159,192
ZEYTINBURNU,VELIEFENDI MAH.,405,340,335,152,183
ZEYTINBURNU,VELIEFENDI MAH.,405,354,350,149,201
ZEYTINBURNU,VELIEFENDI MAH.,405,353,350,172,178
ZEYTINBURNU,VELIEFENDI MAH.,404,343,339,148,191
ZEYTINBURNU,VELIEFENDI MAH.,404,350,345,160,185
ZEYTINBURNU,VELIEFENDI MAH.,404,351,346,167,179
ZEYTINBURNU,VELIEFENDI MAH.,405,356,346,170,176
ZEYTINBURNU,VELIEFENDI MAH.,406,353,343,186,157
ZEYTINBURNU,VELIEFENDI MAH.,405,352,344,175,169
ZEYTINBURNU,VELIEFENDI MAH.,404,352,336,184,152
ZEYTINBURNU,VELIEFENDI MAH.,409,320,315,155,160
ZEYTINBURNU,VELIEFENDI MAH.,415,328,315,145,170
ZEYTINBURNU,VELIEFENDI MAH.,408,320,310,152,158
ZEYTINBURNU,VELIEFENDI MAH.,408,360,357,173,184
ZEYTINBURNU,VELIEFENDI MAH.,410,367,363,177,186
ZEYTINBURNU,VELIEFENDI MAH.,408,372,365,163,202
ZEYTINBURNU,VELIEFENDI MAH.,408,360,357,169,188
ZEYTINBURNU,VELIEFENDI MAH.,409,339,332,146,186
ZEYTINBURNU,VELIEFENDI MAH.,407,365,363,185,178
ZEYTINBURNU,VELIEFENDI MAH.,408,357,350,185,165
ZEYTINBURNU,VELIEFENDI MAH.,407,360,357,177,180
ZEYTINBURNU,VELIEFENDI MAH.,407,352,349,175,174
ZEYTINBURNU,VELIEFENDI MAH.,408,355,347,163,184
ZEYTINBURNU,VELIEFENDI MAH.,407,353,346,167,179
ZEYTINBURNU,VELIEFENDI MAH.,410,353,350,163,187
ZEYTINBURNU,VELIEFENDI MAH.,407,355,350,164,186
ZEYTINBURNU,VELIEFENDI MAH.,415,355,348,157,191
ZEYTINBURNU,VELIEFENDI MAH.,408,362,356,185,171
ZEYTINBURNU,VELIEFENDI MAH.,408,354,340,174,166
ZEYTINBURNU,VELIEFENDI MAH.,407,358,353,159,194
ZEYTINBURNU,VELIEFENDI MAH.,407,342,339,167,172
ZEYTINBURNU,VELIEFENDI MAH.,408,348,337,135,202
ZEYTINBURNU,VELIEFENDI MAH.,407,348,342,163,179
ZEYTINBURNU,VELIEFENDI MAH.,408,338,335,178,157
ZEYTINBURNU,VELIEFENDI MAH.,408,362,357,154,203
ZEYTINBURNU,VELIEFENDI MAH.,407,338,335,146,189
ZEYTINBURNU,VELIEFENDI MAH.,407,362,359,152,207
ZEYTINBURNU,YENIDOGAN MAH.,411,312,309,155,154
ZEYTINBURNU,YENIDOGAN MAH.,411,330,327,183,144
ZEYTINBURNU,YENIDOGAN MAH.,412,368,359,201,158
ZEYTINBURNU,YENIDOGAN MAH.,410,354,344,177,167
ZEYTINBURNU,YENIDOGAN MAH.,411,359,355,192,163
ZEYTINBURNU,YENIDOGAN MAH.,411,325,320,187,133
ZEYTINBURNU,YENIDOGAN MAH.,411,330,328,171,157
ZEYTINBURNU,YENIDOGAN MAH.,410,364,360,184,176
ZEYTINBURNU,YENIDOGAN MAH.,411,361,355,191,164
ZEYTINBURNU,YENIDOGAN MAH.,411,352,347,175,172
ZEYTINBURNU,YENIDOGAN MAH.,410,362,358,211,147
ZEYTINBURNU,YENIDOGAN MAH.,410,351,343,181,162
ZEYTINBURNU,YENIDOGAN MAH.,410,357,353,190,163
ZEYTINBURNU,YENIDOGAN MAH.,411,348,340,176,164
ZEYTINBURNU,YENIDOGAN MAH.,415,349,345,214,131
ZEYTINBURNU,YENIDOGAN MAH.,411,351,343,203,140
ZEYTINBURNU,YENIDOGAN MAH.,410,363,361,183,178
ZEYTINBURNU,YESILTEPE MAH.,415,332,328,192,136
ZEYTINBURNU,YESILTEPE MAH.,408,336,330,163,167
ZEYTINBURNU,YESILTEPE MAH.,408,326,320,163,157
ZEYTINBURNU,YESILTEPE MAH.,411,338,331,182,149
ZEYTINBURNU,YESILTEPE MAH.,415,354,345,177,168
ZEYTINBURNU,YESILTEPE MAH.,410,374,367,210,157
ZEYTINBURNU,YESILTEPE MAH.,410,341,332,191,141
ZEYTINBURNU,YESILTEPE MAH.,410,344,339,202,137
ZEYTINBURNU,YESILTEPE MAH.,409,348,342,184,158
ZEYTINBURNU,YESILTEPE MAH.,408,346,342,158,184
ZEYTINBURNU,YESILTEPE MAH.,409,360,356,197,159
ZEYTINBURNU,YESILTEPE MAH.,408,366,362,172,190
ZEYTINBURNU,YESILTEPE MAH.,408,358,355,158,197
ZEYTINBURNU,YESILTEPE MAH.,410,361,350,199,151
ZEYTINBURNU,YESILTEPE MAH.,409,366,358,194,164
ZEYTINBURNU,YESILTEPE MAH.,409,353,348,161,187
ZEYTINBURNU,YESILTEPE MAH.,409,360,355,180,175
ZEYTINBURNU,YESILTEPE MAH.,410,358,352,185,167
ZEYTINBURNU,YESILTEPE MAH.,409,359,354,186,168
ZEYTINBURNU,YESILTEPE MAH.,410,352,346,194,152
ZEYTINBURNU,YESILTEPE MAH.,409,357,353,182,171
ZEYTINBURNU,YESILTEPE MAH.,409,342,340,150,190
ZEYTINBURNU,YESILTEPE MAH.,410,360,354,186,168
ZEYTINBURNU,YESILTEPE MAH.,410,359,354,182,172
ZEYTINBURNU,YESILTEPE MAH.,409,339,332,174,158
ZEYTINBURNU,YESILTEPE MAH.,409,346,341,163,178
ZEYTINBURNU,YESILTEPE MAH.,410,344,332,164,168
ZEYTINBURNU,YESILTEPE MAH.,410,362,359,184,175
ZEYTINBURNU,YESILTEPE MAH.,409,370,364,193,171
ZEYTINBURNU,YESILTEPE MAH.,359,294,290,138,152
ZEYTINBURNU,YESILTEPE MAH.,358,308,302,175,127
ZEYTINBURNU,YESILTEPE MAH.,358,317,313,147,166
ZEYTINBURNU,YESILTEPE MAH.,359,308,305,158,147
ZEYTINBURNU,YESILTEPE MAH.,361,312,309,164,145
ZEYTINBURNU,YESILTEPE MAH.,357,300,296,151,145
ZEYTINBURNU,YESILTEPE MAH.,359,331,322,192,130
ZEYTINBURNU,BESTELSIZ MAH.,408,326,321,158,163
ZEYTINBURNU,BESTELSIZ MAH.,408,343,339,156,183
ZEYTINBURNU,BESTELSIZ MAH.,408,360,356,179,177
ZEYTINBURNU,BESTELSIZ MAH.,408,371,367,199,168
ZEYTINBURNU,BESTELSIZ MAH.,408,374,367,223,144
ZEYTINBURNU,BESTELSIZ MAH.,408,364,360,204,156
ZEYTINBURNU,BESTELSIZ MAH.,408,357,351,194,157
ZEYTINBURNU,BESTELSIZ MAH.,409,360,354,173,181
ZEYTINBURNU,BESTELSIZ MAH.,409,365,360,175,185
ZEYTINBURNU,BESTELSIZ MAH.,408,368,361,166,195
ZEYTINBURNU,BESTELSIZ MAH.,409,362,358,175,183
ZEYTINBURNU,BESTELSIZ MAH.,408,365,358,169,189
ZEYTINBURNU,BESTELSIZ MAH.,409,352,344,171,173
ZEYTINBURNU,BESTELSIZ MAH.,409,372,365,171,194
ZEYTINBURNU,BESTELSIZ MAH.,409,371,367,137,230
ZEYTINBURNU,BESTELSIZ MAH.,411,368,363,193,170
ZEYTINBURNU,BESTELSIZ MAH.,412,363,357,178,179
ZEYTINBURNU,BESTELSIZ MAH.,408,364,356,165,191
ZEYTINBURNU,BESTELSIZ MAH.,408,364,363,208,155
ZEYTINBURNU,BESTELSIZ MAH.,408,359,354,171,183
ZEYTINBURNU,BESTELSIZ MAH.,409,371,368,201,167
ZEYTINBURNU,BESTELSIZ MAH.,408,368,361,199,162
ZEYTINBURNU,BESTELSIZ MAH.,410,312,307,142,165
ZEYTINBURNU,BESTELSIZ MAH.,415,369,367,194,173
ZEYTINBURNU,BESTELSIZ MAH.,411,348,342,161,181
ZEYTINBURNU,BESTELSIZ MAH.,410,354,352,176,176
ZEYTINBURNU,BESTELSIZ MAH.,415,360,347,186,161
ZEYTINBURNU,BESTELSIZ MAH.,409,357,348,173,175
ZEYTINBURNU,BESTELSIZ MAH.,410,357,354,173,181
ZEYTINBURNU,BESTELSIZ MAH.,410,361,354,190,164
ZEYTINBURNU,BESTELSIZ MAH.,410,358,352,172,180
ZEYTINBURNU,BESTELSIZ MAH.,410,366,359,161,198
ZEYTINBURNU,BESTELSIZ MAH.,411,349,345,165,180
ZEYTINBURNU,BESTELSIZ MAH.,402,326,315,179,136
ZEYTINBURNU,BESTELSIZ MAH.,402,368,361,202,159
ZEYTINBURNU,BESTELSIZ MAH.,402,362,354,184,170
ZEYTINBURNU,BESTELSIZ MAH.,402,336,326,149,177
ZEYTINBURNU,BESTELSIZ MAH.,401,339,333,162,171
ZEYTINBURNU,BESTELSIZ MAH.,401,361,353,181,172
ZEYTINBURNU,BESTELSIZ MAH.,402,346,343,179,164
ZEYTINBURNU,BESTELSIZ MAH.,401,362,356,176,180
ZEYTINBURNU,BESTELSIZ MAH.,402,370,361,153,208
ZEYTINBURNU,CIRPICI MAH.,415,329,324,152,172
ZEYTINBURNU,CIRPICI MAH.,415,324,320,130,190
ZEYTINBURNU,CIRPICI MAH.,415,354,344,157,187
ZEYTINBURNU,CIRPICI MAH.,415,364,361,184,177
ZEYTINBURNU,CIRPICI MAH.,416,349,344,152,192
ZEYTINBURNU,CIRPICI MAH.,415,374,369,174,195
ZEYTINBURNU,CIRPICI MAH.,415,363,356,156,200
ZEYTINBURNU,CIRPICI MAH.,415,345,339,150,189
ZEYTINBURNU,CIRPICI MAH.,415,368,362,192,170
ZEYTINBURNU,CIRPICI MAH.,416,372,364,159,205
ZEYTINBURNU,CIRPICI MAH.,415,356,345,153,192
ZEYTINBURNU,CIRPICI MAH.,415,364,356,175,181
ZEYTINBURNU,CIRPICI MAH.,415,366,361,162,199
ZEYTINBURNU,CIRPICI MAH.,415,374,365,169,196
ZEYTINBURNU,CIRPICI MAH.,415,377,366,158,208
ZEYTINBURNU,CIRPICI MAH.,415,359,352,153,199
ZEYTINBURNU,CIRPICI MAH.,414,346,343,152,191
ZEYTINBURNU,CIRPICI MAH.,415,363,359,168,191
ZEYTINBURNU,CIRPICI MAH.,414,371,365,198,167
ZEYTINBURNU,CIRPICI MAH.,409,332,329,196,133
ZEYTINBURNU,CIRPICI MAH.,415,325,323,196,127
ZEYTINBURNU,CIRPICI MAH.,415,354,350,183,167
ZEYTINBURNU,CIRPICI MAH.,415,366,357,184,173
ZEYTINBURNU,CIRPICI MAH.,415,369,361,181,180
ZEYTINBURNU,CIRPICI MAH.,412,359,353,186,167
ZEYTINBURNU,CIRPICI MAH.,410,362,356,174,182
ZEYTINBURNU,CIRPICI MAH.,412,372,362,175,187
ZEYTINBURNU,CIRPICI MAH.,410,368,366,194,172
ZEYTINBURNU,CIRPICI MAH.,412,362,358,188,170
ZEYTINBURNU,CIRPICI MAH.,411,366,363,199,164
ZEYTINBURNU,CIRPICI MAH.,412,359,353,188,165
ZEYTINBURNU,CIRPICI MAH.,412,350,342,196,146
ZEYTINBURNU,CIRPICI MAH.,409,368,365,178,187
ZEYTINBURNU,CIRPICI MAH.,410,351,347,187,160
ZEYTINBURNU,CIRPICI MAH.,410,359,355,156,199
ZEYTINBURNU,CIRPICI MAH.,410,370,362,191,171
ZEYTINBURNU,CIRPICI MAH.,412,358,354,201,153
ZEYTINBURNU,CIRPICI MAH.,412,357,351,207,144
ZEYTINBURNU,CIRPICI MAH.,410,369,366,186,180
ZEYTINBURNU,CIRPICI MAH.,411,365,359,189,170
ZEYTINBURNU,CIRPICI MAH.,407,339,333,168,165
ZEYTINBURNU,CIRPICI MAH.,407,346,342,159,183
ZEYTINBURNU,CIRPICI MAH.,408,371,365,172,193
ZEYTINBURNU,CIRPICI MAH.,408,361,357,161,196
ZEYTINBURNU,CIRPICI MAH.,407,353,352,182,170
ZEYTINBURNU,CIRPICI MAH.,407,350,348,179,169
ZEYTINBURNU,CIRPICI MAH.,407,361,360,201,159
ZEYTINBURNU,CIRPICI MAH.,407,366,360,209,151
ZEYTINBURNU,CIRPICI MAH.,407,362,359,177,182
ZEYTINBURNU,CIRPICI MAH.,407,368,363,204,159
ZEYTINBURNU,MALTEPE MAH.,372,348,343,124,219
ZEYTINBURNU,MALTEPE MAH.,372,328,324,119,205
ZEYTINBURNU,MALTEPE MAH.,371,346,342,129,213
ZEYTINBURNU,MERKEZEFENDI MAH.,405,310,302,168,134
ZEYTINBURNU,MERKEZEFENDI MAH.,406,358,353,223,130
ZEYTINBURNU,MERKEZEFENDI MAH.,405,361,355,219,136
ZEYTINBURNU,MERKEZEFENDI MAH.,404,369,364,207,157
ZEYTINBURNU,MERKEZEFENDI MAH.,405,354,347,220,127
ZEYTINBURNU,MERKEZEFENDI MAH.,404,362,357,203,154
ZEYTINBURNU,MERKEZEFENDI MAH.,405,371,364,211,153
ZEYTINBURNU,MERKEZEFENDI MAH.,404,361,358,204,154
ZEYTINBURNU,MERKEZEFENDI MAH.,405,368,361,215,146
ZEYTINBURNU,MERKEZEFENDI MAH.,373,332,329,134,195
ZEYTINBURNU,MERKEZEFENDI MAH.,372,335,331,128,203
ZEYTINBURNU,MERKEZEFENDI MAH.,371,335,328,139,189
ZEYTINBURNU,MERKEZEFENDI MAH.,371,350,347,146,201
ZEYTINBURNU,MERKEZEFENDI MAH.,371,337,333,131,202
ZEYTINBURNU,MERKEZEFENDI MAH.,371,338,333,105,228
ZEYTINBURNU,MERKEZEFENDI MAH.,371,334,328,120,208
ZEYTINBURNU,MERKEZEFENDI MAH.,382,315,311,214,97
ZEYTINBURNU,MERKEZEFENDI MAH.,382,334,330,196,134
ZEYTINBURNU,MERKEZEFENDI MAH.,382,345,342,189,153
ZEYTINBURNU,MERKEZEFENDI MAH.,381,350,348,211,137
ZEYTINBURNU,MERKEZEFENDI MAH.,381,325,323,180,143
ZEYTINBURNU,MERKEZEFENDI MAH.,382,338,331,199,132
ZEYTINBURNU,MERKEZEFENDI MAH.,382,330,326,177,149
ZEYTINBURNU,MERKEZEFENDI MAH.,383,364,361,98,263
ZEYTINBURNU,MERKEZEFENDI MAH.,382,334,330,208,122
ZEYTINBURNU,MERKEZEFENDI MAH.,382,333,329,181,148
ZEYTINBURNU,MERKEZEFENDI MAH.,381,337,332,203,129
ZEYTINBURNU,MERKEZEFENDI MAH.,382,331,322,205,117
ZEYTINBURNU,MERKEZEFENDI MAH.,376,319,314,186,128
ZEYTINBURNU,MERKEZEFENDI MAH.,377,334,331,195,136
ZEYTINBURNU,MERKEZEFENDI MAH.,377,339,332,183,149
ZEYTINBURNU,MERKEZEFENDI MAH.,377,342,339,205,134
ZEYTINBURNU,MERKEZEFENDI MAH.,379,342,337,199,138
ZEYTINBURNU,MERKEZEFENDI MAH.,377,346,340,181,159
ZEYTINBURNU,MERKEZEFENDI MAH.,376,333,328,173,155
ZEYTINBURNU,MERKEZEFENDI MAH.,377,341,337,185,152
ZEYTINBURNU,MERKEZEFENDI MAH.,377,334,327,193,134
ZEYTINBURNU,SEYITNIZAM MAH.,384,320,314,187,127
ZEYTINBURNU,SEYITNIZAM MAH.,385,331,323,192,131
ZEYTINBURNU,SEYITNIZAM MAH.,384,350,345,197,148
ZEYTINBURNU,SEYITNIZAM MAH.,384,340,333,186,147
ZEYTINBURNU,SEYITNIZAM MAH.,388,350,342,191,151
ZEYTINBURNU,SEYITNIZAM MAH.,384,345,324,184,140
ZEYTINBURNU,SEYITNIZAM MAH.,384,346,338,186,152
ZEYTINBURNU,SEYITNIZAM MAH.,387,345,342,189,153
ZEYTINBURNU,SEYITNIZAM MAH.,384,346,340,207,133
ZEYTINBURNU,SEYITNIZAM MAH.,386,335,331,207,124
ZEYTINBURNU,SEYITNIZAM MAH.,385,339,335,188,147
ZEYTINBURNU,SEYITNIZAM MAH.,385,354,351,208,143
ZEYTINBURNU,SEYITNIZAM MAH.,407,358,352,194,158
ZEYTINBURNU,SEYITNIZAM MAH.,407,357,351,169,182
ZEYTINBURNU,SEYITNIZAM MAH.,408,383,376,210,166
ZEYTINBURNU,SEYITNIZAM MAH.,406,358,351,154,197
ZEYTINBURNU,SEYITNIZAM MAH.,407,363,355,178,177
ZEYTINBURNU,SEYITNIZAM MAH.,407,361,353,188,165
ZEYTINBURNU,SEYITNIZAM MAH.,407,363,358,206,152
ZEYTINBURNU,SEYITNIZAM MAH.,405,310,295,157,138
ZEYTINBURNU,SEYITNIZAM MAH.,404,306,303,174,129
ZEYTINBURNU,SEYITNIZAM MAH.,404,343,341,205,136
ZEYTINBURNU,SEYITNIZAM MAH.,404,338,334,170,164
ZEYTINBURNU,SEYITNIZAM MAH.,406,359,353,195,158
ZEYTINBURNU,SEYITNIZAM MAH.,404,359,353,185,168
ZEYTINBURNU,SEYITNIZAM MAH.,404,369,364,205,159
ZEYTINBURNU,SEYITNIZAM MAH.,404,365,360,199,161
ZEYTINBURNU,SEYITNIZAM MAH.,406,368,364,198,166
ZEYTINBURNU,SEYITNIZAM MAH.,404,355,353,208,145
ZEYTINBURNU,SEYITNIZAM MAH.,404,350,347,212,135
ZEYTINBURNU,SEYITNIZAM MAH.,404,356,349,180,169
ZEYTINBURNU,SEYITNIZAM MAH.,404,370,364,193,171
ZEYTINBURNU,SEYITNIZAM MAH.,407,351,348,212,136
ZEYTINBURNU,SEYITNIZAM MAH.,404,344,341,184,157
ZEYTINBURNU,SEYITNIZAM MAH.,404,355,351,198,153
ZEYTINBURNU,SEYITNIZAM MAH.,404,348,344,208,136
ZEYTINBURNU,SEYITNIZAM MAH.,404,348,342,205,137
ZEYTINBURNU,SEYITNIZAM MAH.,406,360,356,219,137
ZEYTINBURNU,SEYITNIZAM MAH.,404,354,350,183,167
ZEYTINBURNU,SEYITNIZAM MAH.,404,352,349,208,141
ZEYTINBURNU,SEYITNIZAM MAH.,404,339,336,198,138
ZEYTINBURNU,SEYITNIZAM MAH.,404,359,351,200,151
ZEYTINBURNU,TELSIZ MAH.,403,288,285,147,138
ZEYTINBURNU,TELSIZ MAH.,404,317,312,169,143
ZEYTINBURNU,TELSIZ MAH.,402,333,321,175,146
ZEYTINBURNU,TELSIZ MAH.,402,333,327,181,146
ZEYTINBURNU,TELSIZ MAH.,404,345,339,160,179
ZEYTINBURNU,TELSIZ MAH.,403,363,360,187,173
ZEYTINBURNU,TELSIZ MAH.,403,368,358,171,187
ZEYTINBURNU,TELSIZ MAH.,403,358,351,176,175
ZEYTINBURNU,TELSIZ MAH.,403,352,348,189,159
ZEYTINBURNU,TELSIZ MAH.,402,351,343,147,196
ZEYTINBURNU,TELSIZ MAH.,403,357,354,190,164
ZEYTINBURNU,TELSIZ MAH.,403,352,344,153,191
ZEYTINBURNU,TELSIZ MAH.,403,350,343,178,165
ZEYTINBURNU,TELSIZ MAH.,402,366,361,173,188
ZEYTINBURNU,TELSIZ MAH.,404,336,330,165,165
ZEYTINBURNU,TELSIZ MAH.,402,353,349,177,172
ZEYTINBURNU,TELSIZ MAH.,402,338,331,191,140
ZEYTINBURNU,TELSIZ MAH.,403,361,357,180,177
ZEYTINBURNU,TELSIZ MAH.,402,347,343,199,144
ZEYTINBURNU,TELSIZ MAH.,402,357,348,180,168
ZEYTINBURNU,TELSIZ MAH.,403,348,342,172,170
ZEYTINBURNU,TELSIZ MAH.,403,347,341,194,147
ZEYTINBURNU,TELSIZ MAH.,403,351,347,177,170
ZEYTINBURNU,TELSIZ MAH.,403,350,341,194,147
ZEYTINBURNU,TELSIZ MAH.,403,362,360,183,177
ZEYTINBURNU,TELSIZ MAH.,403,348,339,176,163
ZEYTINBURNU,TELSIZ MAH.,403,350,349,165,184
ZEYTINBURNU,TELSIZ MAH.,406,323,317,181,136
ZEYTINBURNU,TELSIZ MAH.,406,325,310,176,134
ZEYTINBURNU,TELSIZ MAH.,406,370,368,226,142
ZEYTINBURNU,TELSIZ MAH.,406,369,363,216,147
ZEYTINBURNU,TELSIZ MAH.,406,366,359,203,156
ZEYTINBURNU,TELSIZ MAH.,406,348,347,211,136
ZEYTINBURNU,TELSIZ MAH.,407,370,366,208,158
ZEYTINBURNU,TELSIZ MAH.,406,358,352,209,143
ZEYTINBURNU,TELSIZ MAH.,405,367,358,194,164
ZEYTINBURNU,TELSIZ MAH.,406,368,363,232,131
ZEYTINBURNU,TELSIZ MAH.,405,370,364,199,165
ZEYTINBURNU,TELSIZ MAH.,407,347,341,192,149
ZEYTINBURNU,TELSIZ MAH.,406,351,344,185,159
ZEYTINBURNU,TELSIZ MAH.,406,362,358,195,163
ZEYTINBURNU,TELSIZ MAH.,406,376,370,244,126
ZEYTINBURNU,TELSIZ MAH.,406,370,364,199,165
ZEYTINBURNU,TELSIZ MAH.,406,348,341,208,133
ZEYTINBURNU,TELSIZ MAH.,406,337,331,185,146
ZEYTINBURNU,TELSIZ MAH.,405,364,362,201,161
ZEYTINBURNU,TELSIZ MAH.,405,340,333,131,202
ZEYTINBURNU,TELSIZ MAH.,403,309,304,143,161
ZEYTINBURNU,TELSIZ MAH.,404,352,349,179,170
ZEYTINBURNU,TELSIZ MAH.,403,352,343,132,211
ZEYTINBURNU,TELSIZ MAH.,403,352,348,182,166
ZEYTINBURNU,TELSIZ MAH.,404,347,340,162,178
ZEYTINBURNU,TELSIZ MAH.,405,365,363,179,184
ZEYTINBURNU,TELSIZ MAH.,403,350,346,183,163
ZEYTINBURNU,TELSIZ MAH.,403,353,349,192,157
ZEYTINBURNU,TELSIZ MAH.,403,354,340,192,148
ZEYTINBURNU,TELSIZ MAH.,406,361,354,178,176
ZEYTINBURNU,TELSIZ MAH.,403,352,348,177,171
ZEYTINBURNU,TELSIZ MAH.,402,350,341,169,172
ZEYTINBURNU,TELSIZ MAH.,403,345,338,180,158
ZEYTINBURNU,TELSIZ MAH.,404,344,339,192,147
ZEYTINBURNU,TELSIZ MAH.,404,362,355,175,180
ZEYTINBURNU,TELSIZ MAH.,403,326,321,173,148
ZEYTINBURNU,TELSIZ MAH.,403,362,353,190,163
ZEYTINBURNU,TELSIZ MAH.,404,344,339,187,152
BEYOGLU,ARAP CAMI  MAH.,52,47,47,25,22
BEYOGLU,ASMALI MESCIT  MAH.,344,257,254,51,203
BEYOGLU,BEREKETZADE  MAH.,277,234,231,70,161
BEYOGLU,BOSTAN  MAH.,411,310,307,123,184
BEYOGLU,BOSTAN  MAH.,415,325,322,87,235
BEYOGLU,BOSTAN  MAH.,412,334,330,143,187
BEYOGLU,BOSTAN  MAH.,415,368,357,121,236
BEYOGLU,BULBUL  MAH.,382,275,271,74,197
BEYOGLU,BULBUL  MAH.,381,287,276,80,196
BEYOGLU,BULBUL  MAH.,380,296,292,112,180
BEYOGLU,BULBUL  MAH.,380,290,288,95,193
BEYOGLU,BULBUL  MAH.,381,299,293,75,218
BEYOGLU,BULBUL  MAH.,381,285,279,82,197
BEYOGLU,BULBUL  MAH.,384,307,306,112,194
BEYOGLU,CIHANGIR  MAH.,377,291,285,70,215
BEYOGLU,CIHANGIR  MAH.,378,329,328,48,280
BEYOGLU,CIHANGIR  MAH.,378,326,326,65,261
BEYOGLU,CIHANGIR  MAH.,378,341,340,53,287
BEYOGLU,CIHANGIR  MAH.,378,335,330,45,285
BEYOGLU,CIHANGIR  MAH.,378,315,309,36,273
BEYOGLU,CIHANGIR  MAH.,377,323,320,58,262
BEYOGLU,CUKUR  MAH.,366,286,275,79,196
BEYOGLU,CUKUR  MAH.,366,278,274,72,202
BEYOGLU,CUKUR  MAH.,366,281,270,72,198
BEYOGLU,CUKUR  MAH.,366,281,279,72,207
BEYOGLU,CUKUR  MAH.,365,281,275,62,213
BEYOGLU,EMEKYEMEZ  MAH.,107,75,70,32,38
BEYOGLU,EVLIYA CELEBI  MAH.,215,180,176,65,111
BEYOGLU,FIRUZAGA  MAH.,400,309,304,129,175
BEYOGLU,FIRUZAGA  MAH.,401,331,329,105,224
BEYOGLU,FIRUZAGA  MAH.,402,351,342,101,241
BEYOGLU,FIRUZAGA  MAH.,400,351,345,97,248
BEYOGLU,FIRUZAGA  MAH.,400,355,343,121,222
BEYOGLU,FIRUZAGA  MAH.,400,349,342,112,230
BEYOGLU,FIRUZAGA  MAH.,400,338,334,115,219
BEYOGLU,FIRUZAGA  MAH.,400,337,333,100,233
BEYOGLU,GUMUSSUYU  MAH.,368,304,299,25,274
BEYOGLU,GUMUSSUYU  MAH.,367,321,317,45,272
BEYOGLU,GUMUSSUYU  MAH.,368,318,313,37,276
BEYOGLU,GUMUSSUYU  MAH.,368,314,314,51,263
BEYOGLU,HACIAHMET  MAH.,400,321,317,98,219
BEYOGLU,HACIAHMET  MAH.,399,310,305,98,207
BEYOGLU,HACIAHMET  MAH.,399,318,306,93,213
BEYOGLU,HACIAHMET  MAH.,400,356,353,80,273
BEYOGLU,HACIAHMET  MAH.,400,348,347,81,266
BEYOGLU,HACIAHMET  MAH.,399,332,330,93,237
BEYOGLU,HACIAHMET  MAH.,400,346,337,89,248
BEYOGLU,HACIAHMET  MAH.,399,329,324,105,219
BEYOGLU,HACIAHMET  MAH.,400,361,351,86,265
BEYOGLU,HACIAHMET  MAH.,401,354,350,87,263
BEYOGLU,HACIAHMET  MAH.,400,350,344,107,237
BEYOGLU,HACIAHMET  MAH.,404,364,356,87,269
BEYOGLU,HACIAHMET  MAH.,401,332,328,117,211
BEYOGLU,HACIAHMET  MAH.,399,344,335,68,267
BEYOGLU,HACIAHMET  MAH.,400,335,330,99,231
BEYOGLU,HACIAHMET  MAH.,400,339,330,111,219
BEYOGLU,HACIAHMET  MAH.,399,352,347,84,263
BEYOGLU,HACIAHMET  MAH.,400,351,350,81,269
BEYOGLU,HACIAHMET  MAH.,400,353,349,79,270
BEYOGLU,HACIAHMET  MAH.,400,353,347,87,260
BEYOGLU,HACIAHMET  MAH.,403,348,348,78,270
BEYOGLU,HACIAHMET  MAH.,400,328,322,112,210
BEYOGLU,HACIAHMET  MAH.,400,344,341,73,268
BEYOGLU,HACIAHMET  MAH.,399,348,346,108,238
BEYOGLU,HACIAHMET  MAH.,399,362,354,109,245
BEYOGLU,HACIAHMET  MAH.,399,342,334,77,257
BEYOGLU,HACIMIMI  MAH.,321,237,233,101,132
BEYOGLU,HACIMIMI  MAH.,321,274,271,119,152
BEYOGLU,HACIMIMI  MAH.,322,269,263,117,146
BEYOGLU,HUSEYINAGA  MAH.,267,151,149,61,88
BEYOGLU,KALYONCU KULLUGU MAH.,369,272,268,99,169
BEYOGLU,KALYONCU KULLUGU MAH.,369,283,277,69,208
BEYOGLU,KALYONCU KULLUGU MAH.,368,285,283,101,182
BEYOGLU,KALYONCU KULLUGU MAH.,369,294,292,103,189
BEYOGLU,KALYONCU KULLUGU MAH.,369,274,269,93,176
BEYOGLU,KALYONCU KULLUGU MAH.,368,274,271,83,188
BEYOGLU,KAMER HATUN  MAH.,316,239,238,77,161
BEYOGLU,KAMER HATUN  MAH.,315,241,237,82,155
BEYOGLU,KATIPMUSTAFA CELEBI MAH.,331,245,243,58,185
BEYOGLU,KATIPMUSTAFA CELEBI MAH.,331,257,256,46,210
BEYOGLU,KEMANKES KARAMUSTAFAPASA MAH.,77,65,65,25,40
BEYOGLU,KILICALI PASA  MAH.,384,296,293,55,238
BEYOGLU,KILICALI PASA  MAH.,384,349,346,59,287
BEYOGLU,KILICALI PASA  MAH.,384,338,337,50,287
BEYOGLU,KILICALI PASA  MAH.,384,339,334,50,284
BEYOGLU,KILICALI PASA  MAH.,384,344,342,57,285
BEYOGLU,KOCATEPE  MAH.,342,246,239,84,155
BEYOGLU,KOCATEPE  MAH.,341,255,247,75,172
BEYOGLU,KOCATEPE  MAH.,342,254,247,106,141
BEYOGLU,KOCATEPE  MAH.,341,260,257,86,171
BEYOGLU,KULOGLU  MAH.,371,308,305,87,218
BEYOGLU,KULOGLU  MAH.,371,311,310,52,258
BEYOGLU,KULOGLU  MAH.,370,297,293,75,218
BEYOGLU,MUEYYETZADE MAH.,361,302,297,91,206
BEYOGLU,OMER AVNI  MAH.,408,337,331,59,272
BEYOGLU,OMER AVNI  MAH.,408,361,355,41,314
BEYOGLU,OMER AVNI  MAH.,407,362,360,53,307
BEYOGLU,OMER AVNI  MAH.,408,365,359,62,297
BEYOGLU,PURTELAS HASAN EFENDI  MAH.,365,296,292,40,252
BEYOGLU,PURTELAS HASAN EFENDI  MAH.,365,310,306,33,273
BEYOGLU,PURTELAS HASAN EFENDI  MAH.,365,308,305,53,252
BEYOGLU,PURTELAS HASAN EFENDI  MAH.,365,319,316,44,272
BEYOGLU,SAHKULU  MAH.,324,271,264,107,157
BEYOGLU,SAHKULU  MAH.,324,265,261,75,186
BEYOGLU,SEHIT MUHTAR  MAH.,348,243,241,76,165
BEYOGLU,SEHIT MUHTAR  MAH.,349,251,250,77,173
BEYOGLU,SEHIT MUHTAR  MAH.,347,248,245,76,169
BEYOGLU,TOMTOM  MAH.,393,317,313,179,134
BEYOGLU,TOMTOM  MAH.,392,317,315,167,148
BEYOGLU,TOMTOM  MAH.,393,324,322,176,146
BEYOGLU,TOMTOM  MAH.,393,327,323,181,142
BEYOGLU,TOMTOM  MAH.,393,304,298,151,147
BEYOGLU,YENISEHIR  MAH.,415,308,294,112,182
BEYOGLU,YENISEHIR  MAH.,411,334,329,116,213
BEYOGLU,YENISEHIR  MAH.,412,339,338,110,228
BEYOGLU,YENISEHIR  MAH.,412,336,325,100,225
BEYOGLU,YENISEHIR  MAH.,413,347,343,125,218
BEYOGLU,YENISEHIR  MAH.,411,347,346,127,219
BEYOGLU,YENISEHIR  MAH.,411,332,331,113,218
BEYOGLU,YENISEHIR  MAH.,411,335,327,118,209
BEYOGLU,YENISEHIR  MAH.,411,345,344,119,225
BEYOGLU,YENISEHIR  MAH.,412,322,317,101,216
BEYOGLU,BEDRETTIN  MAH.,284,221,211,110,101
BEYOGLU,BEDRETTIN  MAH.,282,226,224,105,119
BEYOGLU,CAMIIKEBIR  MAH.,387,317,309,179,130
BEYOGLU,CAMIIKEBIR  MAH.,387,336,335,190,145
BEYOGLU,CAMIIKEBIR  MAH.,386,336,330,170,160
BEYOGLU,CAMIIKEBIR  MAH.,387,329,323,182,141
BEYOGLU,CAMIIKEBIR  MAH.,389,348,344,200,144
BEYOGLU,CATMA MESCIT  MAH.,336,279,274,126,148
BEYOGLU,CATMA MESCIT  MAH.,336,301,297,142,155
BEYOGLU,CATMA MESCIT  MAH.,335,286,284,123,161
BEYOGLU,CATMA MESCIT  MAH.,335,292,288,117,171
BEYOGLU,CATMA MESCIT  MAH.,336,305,300,122,178
BEYOGLU,FETIHTEPE  MAH.,405,353,350,169,181
BEYOGLU,FETIHTEPE  MAH.,404,322,320,169,151
BEYOGLU,FETIHTEPE  MAH.,404,349,343,205,138
BEYOGLU,FETIHTEPE  MAH.,404,360,349,218,131
BEYOGLU,FETIHTEPE  MAH.,403,359,359,194,165
BEYOGLU,FETIHTEPE  MAH.,404,367,363,191,172
BEYOGLU,FETIHTEPE  MAH.,404,354,350,208,142
BEYOGLU,FETIHTEPE  MAH.,403,363,362,191,171
BEYOGLU,FETIHTEPE  MAH.,404,353,352,229,123
BEYOGLU,FETIHTEPE  MAH.,404,353,350,195,155
BEYOGLU,FETIHTEPE  MAH.,404,360,355,207,148
BEYOGLU,FETIHTEPE  MAH.,403,359,355,210,145
BEYOGLU,FETIHTEPE  MAH.,404,350,344,200,144
BEYOGLU,FETIHTEPE  MAH.,403,356,354,225,129
BEYOGLU,FETIHTEPE  MAH.,403,369,364,215,149
BEYOGLU,FETIHTEPE  MAH.,404,365,365,232,133
BEYOGLU,FETIHTEPE  MAH.,404,366,366,225,141
BEYOGLU,FETIHTEPE  MAH.,404,359,353,187,166
BEYOGLU,FETIHTEPE  MAH.,403,361,356,192,164
BEYOGLU,FETIHTEPE  MAH.,404,350,346,206,140
BEYOGLU,FETIHTEPE  MAH.,402,357,351,207,144
BEYOGLU,FETIHTEPE  MAH.,403,365,361,194,167
BEYOGLU,FETIHTEPE  MAH.,403,358,355,200,155
BEYOGLU,FETIHTEPE  MAH.,404,361,356,211,145
BEYOGLU,FETIHTEPE  MAH.,404,352,347,193,154
BEYOGLU,FETIHTEPE  MAH.,404,354,352,210,142
BEYOGLU,FETIHTEPE  MAH.,404,371,368,209,159
BEYOGLU,FETIHTEPE  MAH.,404,363,359,203,156
BEYOGLU,FETIHTEPE  MAH.,403,367,366,220,146
BEYOGLU,HALICIOGLU  MAH.,412,320,313,176,137
BEYOGLU,HALICIOGLU  MAH.,410,340,335,177,158
BEYOGLU,HALICIOGLU  MAH.,412,372,369,209,160
BEYOGLU,HALICIOGLU  MAH.,415,382,380,221,159
BEYOGLU,HALICIOGLU  MAH.,415,380,376,195,181
BEYOGLU,HALICIOGLU  MAH.,413,373,367,204,163
BEYOGLU,HALICIOGLU  MAH.,412,366,362,204,158
BEYOGLU,HALICIOGLU  MAH.,415,375,373,183,190
BEYOGLU,HALICIOGLU  MAH.,413,367,363,171,192
BEYOGLU,HALICIOGLU  MAH.,415,354,346,193,153
BEYOGLU,HALICIOGLU  MAH.,415,375,370,178,192
BEYOGLU,HALICIOGLU  MAH.,412,378,375,216,159
BEYOGLU,HALICIOGLU  MAH.,412,370,368,207,161
BEYOGLU,HALICIOGLU  MAH.,410,373,370,181,189
BEYOGLU,HALICIOGLU  MAH.,403,312,304,171,133
BEYOGLU,HALICIOGLU  MAH.,402,354,346,193,153
BEYOGLU,HALICIOGLU  MAH.,402,347,344,193,151
BEYOGLU,HALICIOGLU  MAH.,403,357,355,206,149
BEYOGLU,HALICIOGLU  MAH.,403,369,366,194,172
BEYOGLU,HALICIOGLU  MAH.,403,348,347,200,147
BEYOGLU,HALICIOGLU  MAH.,403,349,346,177,169
BEYOGLU,HALICIOGLU  MAH.,402,361,358,181,177
BEYOGLU,HALICIOGLU  MAH.,402,362,356,196,160
BEYOGLU,HALICIOGLU  MAH.,402,346,342,158,184
BEYOGLU,HALICIOGLU  MAH.,403,352,347,201,146
BEYOGLU,ISTIKLAL  MAH.,391,284,272,147,125
BEYOGLU,ISTIKLAL  MAH.,390,296,293,161,132
BEYOGLU,ISTIKLAL  MAH.,392,288,282,134,148
BEYOGLU,ISTIKLAL  MAH.,391,289,287,142,145
BEYOGLU,ISTIKLAL  MAH.,391,303,299,149,150
BEYOGLU,ISTIKLAL  MAH.,392,296,290,130,160
BEYOGLU,ISTIKLAL  MAH.,392,303,300,142,158
BEYOGLU,ISTIKLAL  MAH.,391,302,298,141,157
BEYOGLU,ISTIKLAL  MAH.,390,270,262,114,148
BEYOGLU,KADIMEHMET EFENDI MAH.,391,316,306,194,112
BEYOGLU,KADIMEHMET EFENDI MAH.,392,343,341,219,122
BEYOGLU,KADIMEHMET EFENDI MAH.,393,347,342,221,121
BEYOGLU,KADIMEHMET EFENDI MAH.,394,364,359,206,153
BEYOGLU,KADIMEHMET EFENDI MAH.,392,340,336,221,115
BEYOGLU,KADIMEHMET EFENDI MAH.,390,356,355,218,137
BEYOGLU,KADIMEHMET EFENDI MAH.,402,340,329,147,182
BEYOGLU,KADIMEHMET EFENDI MAH.,403,353,351,203,148
BEYOGLU,KADIMEHMET EFENDI MAH.,402,331,324,188,136
BEYOGLU,KADIMEHMET EFENDI MAH.,402,358,355,187,168
BEYOGLU,KADIMEHMET EFENDI MAH.,377,303,297,198,99
BEYOGLU,KADIMEHMET EFENDI MAH.,377,325,315,213,102
BEYOGLU,KADIMEHMET EFENDI MAH.,377,344,340,218,122
BEYOGLU,KADIMEHMET EFENDI MAH.,379,344,342,211,131
BEYOGLU,KADIMEHMET EFENDI MAH.,376,334,327,191,136
BEYOGLU,KADIMEHMET EFENDI MAH.,376,340,338,227,111
BEYOGLU,KADIMEHMET EFENDI MAH.,377,339,336,219,117
BEYOGLU,KADIMEHMET EFENDI MAH.,376,348,343,190,153
BEYOGLU,KADIMEHMET EFENDI MAH.,377,345,341,216,125
BEYOGLU,KADIMEHMET EFENDI MAH.,376,334,328,236,92
BEYOGLU,KAPTANPASA  MAH.,408,332,326,207,119
BEYOGLU,KAPTANPASA  MAH.,408,328,318,184,134
BEYOGLU,KAPTANPASA  MAH.,408,328,320,239,81
BEYOGLU,KAPTANPASA  MAH.,408,332,323,201,122
BEYOGLU,KAPTANPASA  MAH.,415,355,350,206,144
BEYOGLU,KAPTANPASA  MAH.,407,370,364,226,138
BEYOGLU,KAPTANPASA  MAH.,409,358,351,220,131
BEYOGLU,KAPTANPASA  MAH.,408,356,354,228,126
BEYOGLU,KAPTANPASA  MAH.,409,357,353,241,112
BEYOGLU,KAPTANPASA  MAH.,408,353,347,234,113
BEYOGLU,KAPTANPASA  MAH.,408,365,361,214,147
BEYOGLU,KAPTANPASA  MAH.,407,348,344,219,125
BEYOGLU,KAPTANPASA  MAH.,407,349,348,235,113
BEYOGLU,KAPTANPASA  MAH.,407,352,348,211,137
BEYOGLU,KAPTANPASA  MAH.,407,367,367,233,134
BEYOGLU,KAPTANPASA  MAH.,408,362,355,228,127
BEYOGLU,KAPTANPASA  MAH.,407,371,363,239,124
BEYOGLU,KAPTANPASA  MAH.,408,348,342,190,152
BEYOGLU,KAPTANPASA  MAH.,409,356,352,207,145
BEYOGLU,KAPTANPASA  MAH.,407,363,361,238,123
BEYOGLU,KAPTANPASA  MAH.,408,367,365,249,116
BEYOGLU,KAPTANPASA  MAH.,408,362,345,219,126
BEYOGLU,KAPTANPASA  MAH.,408,356,342,234,108
BEYOGLU,KAPTANPASA  MAH.,408,347,338,226,112
BEYOGLU,KAPTANPASA  MAH.,408,365,361,248,113
BEYOGLU,KAPTANPASA  MAH.,408,370,367,253,114
BEYOGLU,KAPTANPASA  MAH.,408,363,353,215,138
BEYOGLU,KAPTANPASA  MAH.,407,349,343,220,123
BEYOGLU,KAPTANPASA  MAH.,407,364,356,217,139
BEYOGLU,KAPTANPASA  MAH.,408,372,364,248,116
BEYOGLU,KAPTANPASA  MAH.,406,360,353,226,127
BEYOGLU,KAPTANPASA  MAH.,407,352,343,225,118
BEYOGLU,KAPTANPASA  MAH.,406,355,351,219,132
BEYOGLU,KAPTANPASA  MAH.,408,371,364,221,143
BEYOGLU,KAPTANPASA  MAH.,407,353,348,235,113
BEYOGLU,KAPTANPASA  MAH.,408,371,362,234,128
BEYOGLU,KECECI PIRI  MAH.,408,309,301,189,112
BEYOGLU,KECECI PIRI  MAH.,415,335,328,187,141
BEYOGLU,KECECI PIRI  MAH.,415,311,307,185,122
BEYOGLU,KECECI PIRI  MAH.,412,367,364,241,123
BEYOGLU,KECECI PIRI  MAH.,412,379,376,235,141
BEYOGLU,KECECI PIRI  MAH.,415,381,375,233,142
BEYOGLU,KECECI PIRI  MAH.,415,354,346,202,144
BEYOGLU,KECECI PIRI  MAH.,415,380,374,244,130
BEYOGLU,KECECI PIRI  MAH.,412,371,367,244,123
BEYOGLU,KECECI PIRI  MAH.,415,372,370,258,112
BEYOGLU,KECECI PIRI  MAH.,411,378,373,253,120
BEYOGLU,KECECI PIRI  MAH.,415,369,367,230,137
BEYOGLU,KECECI PIRI  MAH.,410,377,369,247,122
BEYOGLU,KECECI PIRI  MAH.,412,360,355,235,120
BEYOGLU,KECECI PIRI  MAH.,412,360,356,222,134
BEYOGLU,KECECI PIRI  MAH.,415,378,376,246,130
BEYOGLU,KECECI PIRI  MAH.,415,374,369,272,97
BEYOGLU,KECECI PIRI  MAH.,411,377,372,256,116
BEYOGLU,KECECI PIRI  MAH.,411,351,344,217,127
BEYOGLU,KECECI PIRI  MAH.,411,358,349,231,118
BEYOGLU,KECECI PIRI  MAH.,413,384,383,244,139
BEYOGLU,KECECI PIRI  MAH.,411,380,374,230,144
BEYOGLU,KECECI PIRI  MAH.,413,371,366,231,135
BEYOGLU,KECECI PIRI  MAH.,413,377,374,222,152
BEYOGLU,KECECI PIRI  MAH.,413,364,354,220,134
BEYOGLU,KECECI PIRI  MAH.,412,364,358,237,121
BEYOGLU,KULAKSIZ  MAH.,407,308,301,172,129
BEYOGLU,KULAKSIZ  MAH.,407,323,321,209,112
BEYOGLU,KULAKSIZ  MAH.,406,340,336,226,110
BEYOGLU,KULAKSIZ  MAH.,407,359,351,204,147
BEYOGLU,KULAKSIZ  MAH.,407,353,348,229,119
BEYOGLU,KULAKSIZ  MAH.,408,360,354,220,134
BEYOGLU,KULAKSIZ  MAH.,409,354,350,237,113
BEYOGLU,KULAKSIZ  MAH.,408,359,355,230,125
BEYOGLU,KULAKSIZ  MAH.,408,361,355,246,109
BEYOGLU,KULAKSIZ  MAH.,408,362,355,227,128
BEYOGLU,KULAKSIZ  MAH.,407,348,341,222,119
BEYOGLU,KULAKSIZ  MAH.,406,373,368,223,145
BEYOGLU,KULAKSIZ  MAH.,407,352,348,227,121
BEYOGLU,KULAKSIZ  MAH.,407,352,342,215,127
BEYOGLU,KULAKSIZ  MAH.,409,353,349,225,124
BEYOGLU,KULAKSIZ  MAH.,408,361,353,231,122
BEYOGLU,KULAKSIZ  MAH.,407,351,347,214,133
BEYOGLU,KULAKSIZ  MAH.,407,341,337,207,130
BEYOGLU,KUCUK PIYALE  MAH.,408,323,314,154,160
BEYOGLU,KUCUK PIYALE  MAH.,404,315,307,158,149
BEYOGLU,KUCUK PIYALE  MAH.,404,333,325,180,145
BEYOGLU,KUCUK PIYALE  MAH.,403,351,348,197,151
BEYOGLU,KUCUK PIYALE  MAH.,406,356,352,214,138
BEYOGLU,KUCUK PIYALE  MAH.,405,363,359,201,158
BEYOGLU,KUCUK PIYALE  MAH.,404,343,339,190,149
BEYOGLU,KUCUK PIYALE  MAH.,403,347,342,192,150
BEYOGLU,KUCUK PIYALE  MAH.,403,346,342,198,144
BEYOGLU,KUCUK PIYALE  MAH.,404,357,351,169,182
BEYOGLU,KUCUK PIYALE  MAH.,404,353,349,202,147
BEYOGLU,KUCUK PIYALE  MAH.,404,364,360,204,156
BEYOGLU,KUCUK PIYALE  MAH.,404,349,339,188,151
BEYOGLU,KUCUK PIYALE  MAH.,404,374,371,201,170
BEYOGLU,KUCUK PIYALE  MAH.,404,357,355,181,174
BEYOGLU,KUCUK PIYALE  MAH.,404,355,346,216,130
BEYOGLU,KUCUK PIYALE  MAH.,404,364,362,190,172
BEYOGLU,ORNEKTEPE  MAH.,416,360,353,147,206
BEYOGLU,ORNEKTEPE  MAH.,415,346,342,137,205
BEYOGLU,ORNEKTEPE  MAH.,415,367,361,141,220
BEYOGLU,ORNEKTEPE  MAH.,415,363,358,154,204
BEYOGLU,ORNEKTEPE  MAH.,415,374,367,160,207
BEYOGLU,ORNEKTEPE  MAH.,416,357,350,175,175
BEYOGLU,ORNEKTEPE  MAH.,415,375,370,167,203
BEYOGLU,ORNEKTEPE  MAH.,415,377,373,179,194
BEYOGLU,ORNEKTEPE  MAH.,413,373,370,165,205
BEYOGLU,ORNEKTEPE  MAH.,413,362,357,161,196
BEYOGLU,ORNEKTEPE  MAH.,413,364,363,172,191
BEYOGLU,ORNEKTEPE  MAH.,415,363,361,156,205
BEYOGLU,ORNEKTEPE  MAH.,416,372,371,174,197
BEYOGLU,ORNEKTEPE  MAH.,415,352,350,125,225
BEYOGLU,ORNEKTEPE  MAH.,415,365,361,142,219
BEYOGLU,ORNEKTEPE  MAH.,413,364,360,154,206
BEYOGLU,ORNEKTEPE  MAH.,413,377,374,172,202
BEYOGLU,ORNEKTEPE  MAH.,416,360,356,147,209
BEYOGLU,ORNEKTEPE  MAH.,413,371,365,167,198
BEYOGLU,PIRIPASA MAH.,407,308,304,169,135
BEYOGLU,PIRIPASA MAH.,410,322,318,166,152
BEYOGLU,PIRIPASA MAH.,407,340,332,188,144
BEYOGLU,PIRIPASA MAH.,407,356,356,230,126
BEYOGLU,PIRIPASA MAH.,409,376,372,230,142
BEYOGLU,PIRIPASA MAH.,407,357,352,208,144
BEYOGLU,PIRIPASA MAH.,407,360,357,219,138
BEYOGLU,PIRIPASA MAH.,409,351,349,194,155
BEYOGLU,PIRIPASA MAH.,409,361,352,200,152
BEYOGLU,PIRIPASA MAH.,408,369,364,209,155
BEYOGLU,PIRIPASA MAH.,407,349,346,202,144
BEYOGLU,PIRIPASA MAH.,407,374,370,219,151
BEYOGLU,PIRIPASA MAH.,406,362,359,217,142
BEYOGLU,PIRIPASA MAH.,406,353,351,216,135
BEYOGLU,PIRIPASA MAH.,407,362,354,228,126
BEYOGLU,PIRIPASA MAH.,407,373,364,223,141
BEYOGLU,PIRIPASA MAH.,406,356,353,212,141
BEYOGLU,PIRIPASA MAH.,407,360,353,209,144
BEYOGLU,PIRIPASA MAH.,406,366,362,223,139
BEYOGLU,PIRIPASA MAH.,407,355,350,200,150
BEYOGLU,PIRIPASA MAH.,407,355,344,213,131
BEYOGLU,PIRIPASA MAH.,407,353,349,225,124
BEYOGLU,PIRIPASA MAH.,406,351,348,205,143
BEYOGLU,PIRIPASA MAH.,407,352,349,207,142
BEYOGLU,PIRIPASA MAH.,406,360,355,199,156
BEYOGLU,PIRIPASA MAH.,407,347,346,205,141
BEYOGLU,PIRIPASA MAH.,407,363,357,210,147
BEYOGLU,PIRIPASA MAH.,406,340,335,195,140
BEYOGLU,PIYALEPASA  MAH.,414,365,357,164,193
BEYOGLU,PIYALEPASA  MAH.,414,344,335,198,137
BEYOGLU,PIYALEPASA  MAH.,414,353,348,199,149
BEYOGLU,PIYALEPASA  MAH.,415,346,339,156,183
BEYOGLU,PIYALEPASA  MAH.,415,346,338,161,177
BEYOGLU,PIYALEPASA  MAH.,415,368,363,160,203
BEYOGLU,PIYALEPASA  MAH.,414,383,379,191,188
BEYOGLU,PIYALEPASA  MAH.,414,380,377,179,198
BEYOGLU,PIYALEPASA  MAH.,414,371,367,159,208
BEYOGLU,PIYALEPASA  MAH.,411,374,368,177,191
BEYOGLU,PIYALEPASA  MAH.,415,383,380,194,186
BEYOGLU,PIYALEPASA  MAH.,415,384,378,164,214
BEYOGLU,PIYALEPASA  MAH.,414,382,375,200,175
BEYOGLU,PIYALEPASA  MAH.,415,368,365,223,142
BEYOGLU,PIYALEPASA  MAH.,414,360,355,197,158
BEYOGLU,PIYALEPASA  MAH.,412,368,365,187,178
BEYOGLU,PIYALEPASA  MAH.,412,350,348,189,159
BEYOGLU,PIYALEPASA  MAH.,414,375,370,205,165
BEYOGLU,PIYALEPASA  MAH.,415,360,355,195,160
BEYOGLU,PIYALEPASA  MAH.,415,384,381,194,187
BEYOGLU,PIYALEPASA  MAH.,414,391,386,217,169
BEYOGLU,PIYALEPASA  MAH.,413,385,383,232,151
BEYOGLU,PIYALEPASA  MAH.,413,367,363,193,170
BEYOGLU,PIYALEPASA  MAH.,412,365,358,180,178
BEYOGLU,PIYALEPASA  MAH.,413,375,369,191,178
BEYOGLU,PIYALEPASA  MAH.,414,379,375,191,184
BEYOGLU,PIYALEPASA  MAH.,412,364,363,200,163
BEYOGLU,PIYALEPASA  MAH.,412,371,365,211,154
BEYOGLU,PIYALEPASA  MAH.,414,368,362,213,149
BEYOGLU,PIYALEPASA  MAH.,414,386,382,233,149
BEYOGLU,PIYALEPASA  MAH.,412,380,377,208,169
BEYOGLU,PIYALEPASA  MAH.,414,381,373,191,182
BEYOGLU,PIYALEPASA  MAH.,413,361,359,211,148
BEYOGLU,PIYALEPASA  MAH.,414,370,367,203,164
BEYOGLU,PIYALEPASA  MAH.,414,368,359,199,160
BEYOGLU,PIYALEPASA  MAH.,414,365,361,199,162
BEYOGLU,PIYALEPASA  MAH.,413,376,372,190,182
BEYOGLU,PIYALEPASA  MAH.,414,381,370,195,175
BEYOGLU,PIYALEPASA  MAH.,412,362,355,176,179
BEYOGLU,PIYALEPASA  MAH.,414,378,375,206,169
BEYOGLU,PIYALEPASA  MAH.,414,376,371,190,181
BEYOGLU,PIYALEPASA  MAH.,412,384,379,229,150
BEYOGLU,SURURI MEHMET EFENDI  MAH.,415,320,317,158,159
BEYOGLU,SURURI MEHMET EFENDI  MAH.,415,358,356,145,211
BEYOGLU,SURURI MEHMET EFENDI  MAH.,411,364,361,156,205
BEYOGLU,SURURI MEHMET EFENDI  MAH.,414,353,353,141,212
BEYOGLU,SURURI MEHMET EFENDI  MAH.,414,335,332,120,212
BEYOGLU,SURURI MEHMET EFENDI  MAH.,413,351,347,137,210
BEYOGLU,SURURI MEHMET EFENDI  MAH.,414,347,340,132,208
BEYOGLU,SURURI MEHMET EFENDI  MAH.,415,351,346,152,194
BEYOGLU,SUTLUCE  MAH.,397,326,322,211,111
BEYOGLU,SUTLUCE  MAH.,397,326,319,191,128
BEYOGLU,SUTLUCE  MAH.,398,351,348,222,126
BEYOGLU,SUTLUCE  MAH.,397,355,351,220,131
BEYOGLU,SUTLUCE  MAH.,397,359,354,241,113
BEYOGLU,SUTLUCE  MAH.,398,359,353,235,118
BEYOGLU,SUTLUCE  MAH.,397,354,350,220,130
BEYOGLU,SUTLUCE  MAH.,397,347,347,234,113
BEYOGLU,SUTLUCE  MAH.,397,349,349,200,149
BEYOGLU,SUTLUCE  MAH.,397,346,341,224,117
BEYOGLU,SUTLUCE  MAH.,398,363,359,255,104
BEYOGLU,SUTLUCE  MAH.,397,363,360,242,118
BEYOGLU,SUTLUCE  MAH.,398,368,364,218,146
BEYOGLU,SUTLUCE  MAH.,398,364,360,243,117
BEYOGLU,SUTLUCE  MAH.,397,353,351,227,124
BEYOGLU,SUTLUCE  MAH.,398,372,370,229,141
BEYOGLU,SUTLUCE  MAH.,402,355,354,201,153
BEYOGLU,SUTLUCE  MAH.,397,367,365,235,130
BEYOGLU,SUTLUCE  MAH.,396,366,355,225,130
BEYOGLU,SUTLUCE  MAH.,396,364,359,238,121
BEYOGLU,SUTLUCE  MAH.,397,356,352,212,140
BEYOGLU,SUTLUCE  MAH.,396,357,354,217,137
BEYOGLU,SUTLUCE  MAH.,398,363,354,216,138
BEYOGLU,YAHYA KAHYA  MAH.,404,309,301,142,159
BEYOGLU,YAHYA KAHYA  MAH.,403,341,337,177,160
BEYOGLU,YAHYA KAHYA  MAH.,404,333,329,189,140
BEYOGLU,YAHYA KAHYA  MAH.,405,344,339,162,177
BEYOGLU,YAHYA KAHYA  MAH.,403,352,346,162,184
BEYOGLU,YAHYA KAHYA  MAH.,404,336,332,178,154
BEYOGLU,YAHYA KAHYA  MAH.,402,353,348,185,163
UMRANIYE,ATATURK MAH.,401,317,311,151,160
UMRANIYE,ATATURK MAH.,399,322,315,180,135
UMRANIYE,ATATURK MAH.,399,361,357,217,140
UMRANIYE,ATATURK MAH.,399,353,352,219,133
UMRANIYE,ATATURK MAH.,398,364,358,218,140
UMRANIYE,ATATURK MAH.,398,358,351,194,157
UMRANIYE,ATATURK MAH.,399,350,344,196,148
UMRANIYE,ATATURK MAH.,398,359,357,213,144
UMRANIYE,ATATURK MAH.,399,360,352,182,170
UMRANIYE,ATATURK MAH.,398,363,357,216,141
UMRANIYE,ATATURK MAH.,401,363,356,206,150
UMRANIYE,ATATURK MAH.,398,345,342,206,136
UMRANIYE,ATATURK MAH.,398,353,347,189,158
UMRANIYE,ATATURK MAH.,398,358,350,211,139
UMRANIYE,ATATURK MAH.,398,354,349,200,149
UMRANIYE,ATATURK MAH.,399,350,344,201,143
UMRANIYE,ATATURK MAH.,398,362,357,203,154
UMRANIYE,ATATURK MAH.,398,354,347,232,115
UMRANIYE,ATATURK MAH.,404,330,326,162,164
UMRANIYE,ATATURK MAH.,403,343,339,173,166
UMRANIYE,ATATURK MAH.,404,380,376,216,160
UMRANIYE,ATATURK MAH.,404,358,351,203,148
UMRANIYE,ATATURK MAH.,404,368,362,213,149
UMRANIYE,ATATURK MAH.,405,371,362,187,175
UMRANIYE,ATATURK MAH.,405,364,358,200,158
UMRANIYE,ATATURK MAH.,405,374,372,229,143
UMRANIYE,ATATURK MAH.,403,354,349,186,163
UMRANIYE,ATATURK MAH.,403,371,368,189,179
UMRANIYE,ATATURK MAH.,404,366,364,199,165
UMRANIYE,ATATURK MAH.,403,355,350,184,166
UMRANIYE,ATATURK MAH.,407,361,353,198,155
UMRANIYE,ATATURK MAH.,404,359,354,168,186
UMRANIYE,ATATURK MAH.,413,335,328,194,134
UMRANIYE,ATATURK MAH.,415,351,347,227,120
UMRANIYE,ATATURK MAH.,413,362,355,188,167
UMRANIYE,ATATURK MAH.,412,365,363,213,150
UMRANIYE,ATATURK MAH.,412,378,371,243,128
UMRANIYE,ATATURK MAH.,412,367,361,211,150
UMRANIYE,ATATURK MAH.,412,379,374,224,150
UMRANIYE,ATATURK MAH.,413,384,372,207,165
UMRANIYE,ATATURK MAH.,411,383,378,227,151
UMRANIYE,ATATURK MAH.,413,369,363,215,148
UMRANIYE,ATATURK MAH.,410,359,351,225,126
UMRANIYE,ATATURK MAH.,413,362,354,215,139
UMRANIYE,ATATURK MAH.,415,366,360,226,134
UMRANIYE,ATATURK MAH.,412,378,371,207,164
UMRANIYE,DUMLUPINAR MAH.,415,354,345,210,135
UMRANIYE,DUMLUPINAR MAH.,409,363,356,216,140
UMRANIYE,DUMLUPINAR MAH.,415,383,379,267,112
UMRANIYE,DUMLUPINAR MAH.,411,368,356,227,129
UMRANIYE,DUMLUPINAR MAH.,409,359,353,210,143
UMRANIYE,DUMLUPINAR MAH.,415,384,377,229,148
UMRANIYE,DUMLUPINAR MAH.,410,380,375,247,128
UMRANIYE,DUMLUPINAR MAH.,411,370,367,254,113
UMRANIYE,DUMLUPINAR MAH.,409,367,356,218,138
UMRANIYE,DUMLUPINAR MAH.,411,377,368,225,143
UMRANIYE,DUMLUPINAR MAH.,410,377,370,247,123
UMRANIYE,DUMLUPINAR MAH.,409,373,370,224,146
UMRANIYE,DUMLUPINAR MAH.,411,387,380,248,132
UMRANIYE,DUMLUPINAR MAH.,410,376,371,225,146
UMRANIYE,DUMLUPINAR MAH.,410,367,365,225,140
UMRANIYE,DUMLUPINAR MAH.,411,366,364,234,130
UMRANIYE,DUMLUPINAR MAH.,410,377,372,268,104
UMRANIYE,DUMLUPINAR MAH.,410,374,365,244,121
UMRANIYE,DUMLUPINAR MAH.,411,376,376,226,150
UMRANIYE,DUMLUPINAR MAH.,409,362,362,241,121
UMRANIYE,DUMLUPINAR MAH.,410,376,369,214,155
UMRANIYE,DUMLUPINAR MAH.,410,374,372,240,132
UMRANIYE,DUMLUPINAR MAH.,410,359,353,197,156
UMRANIYE,ELMALIKENT MAH.,383,327,314,175,139
UMRANIYE,ELMALIKENT MAH.,381,336,329,196,133
UMRANIYE,ELMALIKENT MAH.,382,334,333,178,155
UMRANIYE,ELMALIKENT MAH.,381,344,338,205,133
UMRANIYE,ELMALIKENT MAH.,383,339,337,195,142
UMRANIYE,ELMALIKENT MAH.,381,348,344,182,162
UMRANIYE,ELMALIKENT MAH.,381,335,331,176,155
UMRANIYE,ELMALIKENT MAH.,380,354,350,190,160
UMRANIYE,ELMALIKENT MAH.,380,342,340,180,160
UMRANIYE,ELMALIKENT MAH.,380,354,354,209,145
UMRANIYE,ELMALIKENT MAH.,409,341,333,177,156
UMRANIYE,ELMALIKENT MAH.,406,348,346,173,173
UMRANIYE,ELMALIKENT MAH.,407,356,350,215,135
UMRANIYE,ELMALIKENT MAH.,407,367,365,194,171
UMRANIYE,ELMALIKENT MAH.,406,371,364,192,172
UMRANIYE,ELMALIKENT MAH.,408,372,366,193,173
UMRANIYE,ELMALIKENT MAH.,406,367,358,198,160
UMRANIYE,ELMALIKENT MAH.,407,374,366,215,151
UMRANIYE,ELMALIKENT MAH.,406,361,358,191,167
UMRANIYE,ELMALIKENT MAH.,406,360,356,189,167
UMRANIYE,ELMALIKENT MAH.,406,369,363,163,200
UMRANIYE,ELMALIKENT MAH.,406,365,361,179,182
UMRANIYE,ELMALIKENT MAH.,406,371,363,194,169
UMRANIYE,ELMALIKENT MAH.,406,363,359,203,156
UMRANIYE,ELMALIKENT MAH.,406,381,376,197,179
UMRANIYE,ELMALIKENT MAH.,406,363,358,176,182
UMRANIYE,ELMALIKENT MAH.,407,366,362,173,189
UMRANIYE,ELMALIKENT MAH.,406,371,363,162,201
UMRANIYE,ELMALIKENT MAH.,406,360,350,197,153
UMRANIYE,ELMALIKENT MAH.,415,359,349,173,176
UMRANIYE,ELMALIKENT MAH.,411,368,362,181,181
UMRANIYE,ELMALIKENT MAH.,410,353,351,185,166
UMRANIYE,ELMALIKENT MAH.,411,360,353,148,205
UMRANIYE,ELMALIKENT MAH.,409,371,365,156,209
UMRANIYE,ELMALIKENT MAH.,409,358,352,160,192
UMRANIYE,ELMALIKENT MAH.,411,368,357,168,189
UMRANIYE,ELMALIKENT MAH.,411,365,362,178,184
UMRANIYE,ELMALIKENT MAH.,410,360,356,183,173
UMRANIYE,ELMALIKENT MAH.,409,356,350,168,182
UMRANIYE,ELMALIKENT MAH.,411,362,362,158,204
UMRANIYE,ESENEVLER MAH.,399,335,329,164,165
UMRANIYE,ESENEVLER MAH.,401,324,319,152,167
UMRANIYE,ESENEVLER MAH.,400,363,356,174,182
UMRANIYE,ESENEVLER MAH.,404,375,373,153,220
UMRANIYE,ESENEVLER MAH.,402,349,336,158,178
UMRANIYE,ESENEVLER MAH.,402,345,336,162,174
UMRANIYE,ESENEVLER MAH.,401,369,360,172,188
UMRANIYE,ESENEVLER MAH.,400,356,349,163,186
UMRANIYE,ESENEVLER MAH.,400,370,365,183,182
UMRANIYE,ESENEVLER MAH.,399,361,358,152,206
UMRANIYE,ESENEVLER MAH.,399,369,366,162,204
UMRANIYE,ESENEVLER MAH.,401,357,354,161,193
UMRANIYE,ESENEVLER MAH.,401,360,354,162,192
UMRANIYE,ESENEVLER MAH.,400,364,357,155,202
UMRANIYE,ESENEVLER MAH.,400,371,367,191,176
UMRANIYE,ESENEVLER MAH.,400,358,353,173,180
UMRANIYE,ESENEVLER MAH.,401,352,346,152,194
UMRANIYE,ESENEVLER MAH.,401,364,361,169,192
UMRANIYE,ESENEVLER MAH.,401,345,336,168,168
UMRANIYE,ESENEVLER MAH.,401,348,347,145,202
UMRANIYE,ESENEVLER MAH.,400,352,347,165,182
UMRANIYE,ESENEVLER MAH.,401,354,351,160,191
UMRANIYE,ESENEVLER MAH.,401,370,366,177,189
UMRANIYE,ESENEVLER MAH.,400,374,367,151,216
UMRANIYE,ESENEVLER MAH.,404,334,328,190,138
UMRANIYE,ESENEVLER MAH.,405,334,331,202,129
UMRANIYE,ESENEVLER MAH.,405,363,356,184,172
UMRANIYE,ESENEVLER MAH.,406,341,336,184,152
UMRANIYE,ESENEVLER MAH.,405,365,358,189,169
UMRANIYE,ESENEVLER MAH.,405,369,367,207,160
UMRANIYE,ESENEVLER MAH.,405,355,353,201,152
UMRANIYE,ESENEVLER MAH.,405,364,356,203,153
UMRANIYE,ESENEVLER MAH.,405,360,354,202,152
UMRANIYE,ESENEVLER MAH.,405,362,355,178,177
UMRANIYE,ESENEVLER MAH.,405,358,350,179,171
UMRANIYE,ESENEVLER MAH.,404,343,340,202,138
UMRANIYE,ESENEVLER MAH.,407,375,367,192,175
UMRANIYE,ESENEVLER MAH.,405,365,358,206,152
UMRANIYE,ESENEVLER MAH.,406,370,370,188,182
UMRANIYE,ESENEVLER MAH.,406,357,353,226,127
UMRANIYE,ESENEVLER MAH.,405,372,369,197,172
UMRANIYE,ESENEVLER MAH.,404,359,354,207,147
UMRANIYE,ESENEVLER MAH.,404,374,371,209,162
UMRANIYE,ESENEVLER MAH.,404,371,368,180,188
UMRANIYE,ESENEVLER MAH.,404,345,341,204,137
UMRANIYE,ESENEVLER MAH.,405,378,372,196,176
UMRANIYE,ESENEVLER MAH.,404,363,357,188,169
UMRANIYE,ESENEVLER MAH.,404,367,365,209,156
UMRANIYE,FATIH SULTAN MEHMET MAH.,397,360,359,201,158
UMRANIYE,FATIH SULTAN MEHMET MAH.,397,364,359,195,164
UMRANIYE,FATIH SULTAN MEHMET MAH.,398,370,363,213,150
UMRANIYE,FATIH SULTAN MEHMET MAH.,398,360,354,206,148
UMRANIYE,FATIH SULTAN MEHMET MAH.,398,357,352,204,148
UMRANIYE,FATIH SULTAN MEHMET MAH.,398,367,361,197,164
UMRANIYE,FATIH SULTAN MEHMET MAH.,400,366,362,193,169
UMRANIYE,HEKIMBASI MAH.,391,339,331,255,76
UMRANIYE,HEKIMBASI MAH.,388,367,357,266,91
UMRANIYE,HEKIMBASI MAH.,386,364,361,261,100
UMRANIYE,HEKIMBASI MAH.,389,351,342,262,80
UMRANIYE,HEKIMBASI MAH.,389,339,338,234,104
UMRANIYE,HEKIMBASI MAH.,389,341,336,238,98
UMRANIYE,HEKIMBASI MAH.,388,342,337,229,108
UMRANIYE,HEKIMBASI MAH.,389,347,342,248,94
UMRANIYE,HEKIMBASI MAH.,389,352,349,247,102
UMRANIYE,HEKIMBASI MAH.,364,306,301,218,83
UMRANIYE,HEKIMBASI MAH.,365,326,319,235,84
UMRANIYE,HEKIMBASI MAH.,365,320,315,234,81
UMRANIYE,HEKIMBASI MAH.,365,327,322,234,88
UMRANIYE,HEKIMBASI MAH.,365,318,310,218,92
UMRANIYE,HEKIMBASI MAH.,365,329,324,215,109
UMRANIYE,HEKIMBASI MAH.,365,321,317,224,93
UMRANIYE,INKILAP MAH.,393,340,329,261,68
UMRANIYE,INKILAP MAH.,393,360,353,263,90
UMRANIYE,INKILAP MAH.,393,354,348,253,95
UMRANIYE,INKILAP MAH.,393,353,348,270,78
UMRANIYE,INKILAP MAH.,393,350,346,240,106
UMRANIYE,INKILAP MAH.,393,349,344,231,113
UMRANIYE,INKILAP MAH.,393,346,341,250,91
UMRANIYE,INKILAP MAH.,393,353,352,281,71
UMRANIYE,INKILAP MAH.,393,357,350,272,78
UMRANIYE,INKILAP MAH.,393,349,346,267,79
UMRANIYE,INKILAP MAH.,396,348,336,247,89
UMRANIYE,INKILAP MAH.,393,352,347,245,102
UMRANIYE,INKILAP MAH.,377,328,323,248,75
UMRANIYE,INKILAP MAH.,378,344,342,261,81
UMRANIYE,INKILAP MAH.,378,345,344,251,93
UMRANIYE,INKILAP MAH.,377,343,341,257,84
UMRANIYE,INKILAP MAH.,377,354,349,266,83
UMRANIYE,INKILAP MAH.,377,348,345,255,90
UMRANIYE,INKILAP MAH.,377,353,348,261,87
UMRANIYE,INKILAP MAH.,379,349,346,246,100
UMRANIYE,INKILAP MAH.,378,356,349,271,78
UMRANIYE,INKILAP MAH.,376,352,350,290,60
UMRANIYE,INKILAP MAH.,408,359,351,290,61
UMRANIYE,INKILAP MAH.,407,373,368,275,93
UMRANIYE,INKILAP MAH.,412,381,378,301,77
UMRANIYE,INKILAP MAH.,408,385,382,296,86
UMRANIYE,INKILAP MAH.,407,378,372,270,102
UMRANIYE,INKILAP MAH.,407,378,374,287,87
UMRANIYE,INKILAP MAH.,408,383,378,274,104
UMRANIYE,INKILAP MAH.,407,365,356,248,108
UMRANIYE,INKILAP MAH.,407,382,380,295,85
UMRANIYE,INKILAP MAH.,407,374,364,255,109
UMRANIYE,INKILAP MAH.,408,383,380,282,98
UMRANIYE,INKILAP MAH.,407,384,381,299,82
UMRANIYE,INKILAP MAH.,408,372,369,253,116
UMRANIYE,INKILAP MAH.,408,367,358,280,78
UMRANIYE,INKILAP MAH.,408,267,265,175,90
UMRANIYE,INKILAP MAH.,407,371,366,275,91
UMRANIYE,INKILAP MAH.,386,300,290,112,178
UMRANIYE,INKILAP MAH.,383,321,311,128,183
UMRANIYE,INKILAP MAH.,383,310,299,135,164
UMRANIYE,INKILAP MAH.,383,324,313,118,195
UMRANIYE,INKILAP MAH.,383,346,335,152,183
UMRANIYE,INKILAP MAH.,384,326,317,100,217
UMRANIYE,INKILAP MAH.,384,317,304,127,177
UMRANIYE,INKILAP MAH.,386,331,319,131,188
UMRANIYE,KAZIM KARABEKIR MAH.,399,319,307,236,71
UMRANIYE,KAZIM KARABEKIR MAH.,399,352,343,272,71
UMRANIYE,KAZIM KARABEKIR MAH.,399,376,368,258,110
UMRANIYE,KAZIM KARABEKIR MAH.,399,372,372,266,106
UMRANIYE,KAZIM KARABEKIR MAH.,399,367,362,264,98
UMRANIYE,KAZIM KARABEKIR MAH.,399,366,356,253,103
UMRANIYE,KAZIM KARABEKIR MAH.,398,376,372,267,105
UMRANIYE,KAZIM KARABEKIR MAH.,398,364,355,259,96
UMRANIYE,KAZIM KARABEKIR MAH.,398,355,350,288,62
UMRANIYE,KAZIM KARABEKIR MAH.,398,355,351,254,97
UMRANIYE,KAZIM KARABEKIR MAH.,399,362,360,280,80
UMRANIYE,KAZIM KARABEKIR MAH.,399,353,350,264,86
UMRANIYE,KAZIM KARABEKIR MAH.,398,371,364,274,90
UMRANIYE,KAZIM KARABEKIR MAH.,399,366,361,266,95
UMRANIYE,KAZIM KARABEKIR MAH.,399,358,354,260,94
UMRANIYE,KAZIM KARABEKIR MAH.,399,346,341,252,89
UMRANIYE,KAZIM KARABEKIR MAH.,397,346,343,241,102
UMRANIYE,KAZIM KARABEKIR MAH.,396,356,350,254,96
UMRANIYE,KAZIM KARABEKIR MAH.,397,353,347,258,89
UMRANIYE,KAZIM KARABEKIR MAH.,397,360,359,260,99
UMRANIYE,KAZIM KARABEKIR MAH.,396,368,364,294,70
UMRANIYE,KAZIM KARABEKIR MAH.,397,375,373,305,68
UMRANIYE,KAZIM KARABEKIR MAH.,397,361,357,275,82
UMRANIYE,KAZIM KARABEKIR MAH.,396,366,361,256,105
UMRANIYE,KAZIM KARABEKIR MAH.,396,362,356,285,71
UMRANIYE,KAZIM KARABEKIR MAH.,398,361,354,282,72
UMRANIYE,KAZIM KARABEKIR MAH.,397,345,342,251,91
UMRANIYE,KAZIM KARABEKIR MAH.,397,360,357,253,104
UMRANIYE,KAZIM KARABEKIR MAH.,397,377,375,301,74
UMRANIYE,KAZIM KARABEKIR MAH.,396,357,354,255,99
UMRANIYE,KAZIM KARABEKIR MAH.,397,362,353,250,103
UMRANIYE,NAMIK KEMAL MAH.,411,338,322,201,121
UMRANIYE,NAMIK KEMAL MAH.,412,348,343,211,132
UMRANIYE,NAMIK KEMAL MAH.,415,375,367,250,117
UMRANIYE,NAMIK KEMAL MAH.,412,357,345,212,133
UMRANIYE,NAMIK KEMAL MAH.,411,373,364,220,144
UMRANIYE,NAMIK KEMAL MAH.,411,357,354,205,149
UMRANIYE,NAMIK KEMAL MAH.,411,364,356,221,135
UMRANIYE,NAMIK KEMAL MAH.,411,371,366,210,156
UMRANIYE,NAMIK KEMAL MAH.,411,375,369,231,138
UMRANIYE,NAMIK KEMAL MAH.,411,376,364,244,120
UMRANIYE,NAMIK KEMAL MAH.,411,356,352,208,144
UMRANIYE,NAMIK KEMAL MAH.,411,370,363,219,144
UMRANIYE,NAMIK KEMAL MAH.,412,373,370,217,153
UMRANIYE,NAMIK KEMAL MAH.,410,364,357,210,147
UMRANIYE,NAMIK KEMAL MAH.,411,372,360,210,150
UMRANIYE,NAMIK KEMAL MAH.,411,361,353,212,141
UMRANIYE,NAMIK KEMAL MAH.,410,372,360,225,135
UMRANIYE,NAMIK KEMAL MAH.,410,376,367,209,158
UMRANIYE,NAMIK KEMAL MAH.,410,315,311,182,129
UMRANIYE,NAMIK KEMAL MAH.,411,340,335,209,126
UMRANIYE,NAMIK KEMAL MAH.,410,339,332,201,131
UMRANIYE,NAMIK KEMAL MAH.,410,383,377,224,153
UMRANIYE,NAMIK KEMAL MAH.,410,373,370,247,123
UMRANIYE,NAMIK KEMAL MAH.,410,366,352,212,140
UMRANIYE,NAMIK KEMAL MAH.,409,375,367,219,148
UMRANIYE,NAMIK KEMAL MAH.,409,366,364,222,142
UMRANIYE,NAMIK KEMAL MAH.,409,365,360,215,145
UMRANIYE,NAMIK KEMAL MAH.,410,361,353,231,122
UMRANIYE,NAMIK KEMAL MAH.,409,360,354,224,130
UMRANIYE,NAMIK KEMAL MAH.,409,365,361,216,145
UMRANIYE,NAMIK KEMAL MAH.,409,380,371,247,124
UMRANIYE,NAMIK KEMAL MAH.,409,382,379,214,165
UMRANIYE,NAMIK KEMAL MAH.,410,365,359,241,118
UMRANIYE,NAMIK KEMAL MAH.,409,366,362,231,131
UMRANIYE,NAMIK KEMAL MAH.,409,366,355,210,145
UMRANIYE,NAMIK KEMAL MAH.,409,365,359,210,149
UMRANIYE,NAMIK KEMAL MAH.,409,366,352,192,160
UMRANIYE,NAMIK KEMAL MAH.,409,374,368,228,140
UMRANIYE,NAMIK KEMAL MAH.,409,364,360,225,135
UMRANIYE,NAMIK KEMAL MAH.,411,368,365,243,122
UMRANIYE,NAMIK KEMAL MAH.,409,366,364,225,139
UMRANIYE,NAMIK KEMAL MAH.,410,349,339,191,148
UMRANIYE,NAMIK KEMAL MAH.,410,373,364,208,156
UMRANIYE,NAMIK KEMAL MAH.,409,361,348,208,140
UMRANIYE,NAMIK KEMAL MAH.,375,305,300,175,125
UMRANIYE,NAMIK KEMAL MAH.,374,346,340,187,153
UMRANIYE,NAMIK KEMAL MAH.,374,334,326,183,143
UMRANIYE,NAMIK KEMAL MAH.,373,334,328,202,126
UMRANIYE,NAMIK KEMAL MAH.,374,341,338,209,129
UMRANIYE,NAMIK KEMAL MAH.,373,345,337,194,143
UMRANIYE,NAMIK KEMAL MAH.,373,338,333,188,145
UMRANIYE,NAMIK KEMAL MAH.,374,330,321,183,138
UMRANIYE,SARAY MAH.,327,307,304,58,246
UMRANIYE,SARAY MAH.,326,301,298,49,249
UMRANIYE,SARAY MAH.,326,299,297,48,249
UMRANIYE,SARAY MAH.,326,298,294,64,230
UMRANIYE,TANTAVI MAH.,395,332,327,163,164
UMRANIYE,TANTAVI MAH.,396,334,327,181,146
UMRANIYE,TANTAVI MAH.,397,364,353,173,180
UMRANIYE,TANTAVI MAH.,396,352,344,178,166
UMRANIYE,TANTAVI MAH.,396,361,358,191,167
UMRANIYE,TANTAVI MAH.,398,398,357,195,162
UMRANIYE,TANTAVI MAH.,397,367,359,178,181
UMRANIYE,TANTAVI MAH.,397,364,354,198,156
UMRANIYE,TANTAVI MAH.,397,352,343,200,143
UMRANIYE,TANTAVI MAH.,397,376,375,200,175
UMRANIYE,TANTAVI MAH.,397,360,358,181,177
UMRANIYE,TANTAVI MAH.,398,356,350,175,175
UMRANIYE,TANTAVI MAH.,395,355,354,191,163
UMRANIYE,TANTAVI MAH.,397,366,365,203,162
UMRANIYE,TANTAVI MAH.,396,363,358,171,187
UMRANIYE,TANTAVI MAH.,397,364,363,190,173
UMRANIYE,TANTAVI MAH.,397,348,344,159,185
UMRANIYE,TANTAVI MAH.,397,366,361,171,190
UMRANIYE,TOPAGACI MAH.,409,356,345,228,117
UMRANIYE,TOPAGACI MAH.,415,353,343,253,90
UMRANIYE,TOPAGACI MAH.,415,375,368,258,110
UMRANIYE,TOPAGACI MAH.,415,373,370,254,116
UMRANIYE,TOPAGACI MAH.,415,371,366,263,103
UMRANIYE,TOPAGACI MAH.,410,369,363,244,119
UMRANIYE,TOPAGACI MAH.,411,355,349,219,130
UMRANIYE,TOPAGACI MAH.,415,371,367,251,116
UMRANIYE,TOPAGACI MAH.,409,354,350,234,116
UMRANIYE,TOPAGACI MAH.,415,373,364,283,81
UMRANIYE,TOPAGACI MAH.,415,372,368,260,108
UMRANIYE,TOPAGACI MAH.,415,379,375,252,123
UMRANIYE,TOPAGACI MAH.,409,365,363,265,98
UMRANIYE,TOPAGACI MAH.,415,370,368,255,113
UMRANIYE,TOPAGACI MAH.,411,362,354,239,115
UMRANIYE,TOPAGACI MAH.,411,365,359,252,107
UMRANIYE,TOPAGACI MAH.,415,388,383,265,118
UMRANIYE,TOPAGACI MAH.,410,363,357,257,100
UMRANIYE,TOPAGACI MAH.,409,378,373,261,112
UMRANIYE,TOPAGACI MAH.,415,392,386,284,102
UMRANIYE,TOPAGACI MAH.,412,361,354,263,91
UMRANIYE,TOPAGACI MAH.,415,385,378,271,107
UMRANIYE,TOPAGACI MAH.,409,358,350,237,113
UMRANIYE,TOPAGACI MAH.,412,372,366,257,109
UMRANIYE,TOPAGACI MAH.,410,367,362,253,109
UMRANIYE,TOPAGACI MAH.,411,375,363,254,109
UMRANIYE,YAMANEVLER MAH.,395,327,320,177,143
UMRANIYE,YAMANEVLER MAH.,395,352,345,218,127
UMRANIYE,YAMANEVLER MAH.,395,358,355,205,150
UMRANIYE,YAMANEVLER MAH.,395,349,340,230,110
UMRANIYE,YAMANEVLER MAH.,394,343,339,215,124
UMRANIYE,YAMANEVLER MAH.,394,345,340,197,143
UMRANIYE,YAMANEVLER MAH.,395,350,344,192,152
UMRANIYE,YAMANEVLER MAH.,395,356,353,224,129
UMRANIYE,YAMANEVLER MAH.,393,353,351,192,159
UMRANIYE,YAMANEVLER MAH.,394,347,344,207,137
UMRANIYE,YAMANEVLER MAH.,394,361,358,198,160
UMRANIYE,YAMANEVLER MAH.,395,361,357,244,113
UMRANIYE,YAMANEVLER MAH.,384,312,303,178,125
UMRANIYE,YAMANEVLER MAH.,383,325,321,188,133
UMRANIYE,YAMANEVLER MAH.,382,344,338,208,130
UMRANIYE,YAMANEVLER MAH.,383,336,332,190,142
UMRANIYE,YAMANEVLER MAH.,384,336,332,180,152
UMRANIYE,YAMANEVLER MAH.,384,356,355,242,113
UMRANIYE,YAMANEVLER MAH.,385,343,339,192,147
UMRANIYE,YAMANEVLER MAH.,383,343,341,190,151
UMRANIYE,YAMANEVLER MAH.,384,349,347,215,132
UMRANIYE,YAMANEVLER MAH.,384,330,328,184,144
UMRANIYE,YAMANEVLER MAH.,383,355,350,199,151
UMRANIYE,YAMANEVLER MAH.,383,345,341,218,123
UMRANIYE,ARMAGANEVLER MAH.,406,339,329,175,154
UMRANIYE,ARMAGANEVLER MAH.,410,354,350,175,175
UMRANIYE,ARMAGANEVLER MAH.,405,338,332,163,169
UMRANIYE,ARMAGANEVLER MAH.,407,365,356,166,190
UMRANIYE,ARMAGANEVLER MAH.,408,363,352,154,198
UMRANIYE,ARMAGANEVLER MAH.,406,365,360,180,180
UMRANIYE,ARMAGANEVLER MAH.,406,370,369,161,208
UMRANIYE,ARMAGANEVLER MAH.,407,341,340,168,172
UMRANIYE,ARMAGANEVLER MAH.,406,358,356,184,172
UMRANIYE,ARMAGANEVLER MAH.,408,358,355,178,177
UMRANIYE,ARMAGANEVLER MAH.,406,351,348,168,180
UMRANIYE,ARMAGANEVLER MAH.,407,362,358,158,200
UMRANIYE,ARMAGANEVLER MAH.,406,346,344,193,151
UMRANIYE,ARMAGANEVLER MAH.,407,369,364,192,172
UMRANIYE,ARMAGANEVLER MAH.,407,369,364,166,198
UMRANIYE,ARMAGANEVLER MAH.,407,353,349,176,173
UMRANIYE,ARMAGANEVLER MAH.,405,362,358,168,190
UMRANIYE,ARMAGANEVLER MAH.,405,358,354,184,170
UMRANIYE,ARMAGANEVLER MAH.,406,362,358,185,173
UMRANIYE,ARMAGANEVLER MAH.,406,370,365,216,149
UMRANIYE,ARMAGANEVLER MAH.,406,364,361,194,167
UMRANIYE,ARMAGANEVLER MAH.,405,356,351,150,201
UMRANIYE,ARMAGANEVLER MAH.,405,371,367,186,181
UMRANIYE,ARMAGANEVLER MAH.,406,351,349,183,166
UMRANIYE,ARMAGANEVLER MAH.,405,373,363,197,166
UMRANIYE,ARMAGANEVLER MAH.,406,357,352,178,174
UMRANIYE,ARMAGANEVLER MAH.,406,360,359,166,193
UMRANIYE,ARMAGANEVLER MAH.,405,361,360,176,184
UMRANIYE,ARMAGANEVLER MAH.,406,359,356,160,196
UMRANIYE,ARMAGANEVLER MAH.,406,363,357,193,164
UMRANIYE,ARMAGANEVLER MAH.,406,371,365,171,194
UMRANIYE,ARMAGANEVLER MAH.,405,363,362,188,174
UMRANIYE,ARMAGANEVLER MAH.,406,370,364,183,181
UMRANIYE,ARMAGANEVLER MAH.,415,338,331,191,140
UMRANIYE,ARMAGANEVLER MAH.,415,349,344,183,161
UMRANIYE,ARMAGANEVLER MAH.,412,368,363,172,191
UMRANIYE,ARMAGANEVLER MAH.,412,374,370,204,166
UMRANIYE,ARMAGANEVLER MAH.,415,363,359,173,186
UMRANIYE,ARMAGANEVLER MAH.,412,355,348,197,151
UMRANIYE,ARMAGANEVLER MAH.,415,380,374,191,183
UMRANIYE,ARMAGANEVLER MAH.,412,376,367,193,174
UMRANIYE,ARMAGANEVLER MAH.,415,364,361,204,157
UMRANIYE,ARMAGANEVLER MAH.,415,367,362,201,161
UMRANIYE,ARMAGANEVLER MAH.,415,358,355,198,157
UMRANIYE,ARMAGANEVLER MAH.,412,364,358,169,189
UMRANIYE,ARMAGANEVLER MAH.,412,368,362,164,198
UMRANIYE,ARMAGANEVLER MAH.,415,368,361,174,187
UMRANIYE,ARMAGANEVLER MAH.,412,373,368,204,164
UMRANIYE,ARMAGANEVLER MAH.,415,363,359,185,174
UMRANIYE,ARMAGANEVLER MAH.,412,368,363,174,189
UMRANIYE,ARMAGANEVLER MAH.,412,363,361,181,180
UMRANIYE,ARMAGANEVLER MAH.,415,363,353,177,176
UMRANIYE,ARMAGANEVLER MAH.,412,355,350,165,185
UMRANIYE,ARMAGANEVLER MAH.,413,368,363,152,211
UMRANIYE,ARMAGANEVLER MAH.,412,372,370,202,168
UMRANIYE,ARMAGANEVLER MAH.,415,381,373,202,171
UMRANIYE,ARMAGANEVLER MAH.,412,366,362,187,175
UMRANIYE,ARMAGANEVLER MAH.,415,370,363,150,213
UMRANIYE,ARMAGANEVLER MAH.,413,356,349,185,164
UMRANIYE,ARMAGANEVLER MAH.,412,366,359,194,165
UMRANIYE,ARMAGANEVLER MAH.,413,345,337,181,156
UMRANIYE,ARMAGANEVLER MAH.,413,350,348,187,161
UMRANIYE,ARMAGANEVLER MAH.,412,381,375,172,203
UMRANIYE,ARMAGANEVLER MAH.,413,373,370,203,167
UMRANIYE,ARMAGANEVLER MAH.,415,359,351,210,141
UMRANIYE,ARMAGANEVLER MAH.,412,384,379,157,222
UMRANIYE,ATAKENT MAH.,415,355,345,131,214
UMRANIYE,ATAKENT MAH.,415,357,348,134,214
UMRANIYE,ATAKENT MAH.,415,360,356,136,220
UMRANIYE,ATAKENT MAH.,415,382,375,138,237
UMRANIYE,ATAKENT MAH.,415,379,375,150,225
UMRANIYE,ATAKENT MAH.,415,374,370,154,216
UMRANIYE,ATAKENT MAH.,411,382,373,156,217
UMRANIYE,ATAKENT MAH.,415,382,372,133,239
UMRANIYE,ATAKENT MAH.,415,374,367,146,221
UMRANIYE,ATAKENT MAH.,412,389,388,133,255
UMRANIYE,ATAKENT MAH.,415,373,370,174,196
UMRANIYE,ATAKENT MAH.,414,371,369,132,237
UMRANIYE,ATAKENT MAH.,415,382,375,166,209
UMRANIYE,ATAKENT MAH.,415,388,384,143,241
UMRANIYE,ATAKENT MAH.,414,379,370,150,220
UMRANIYE,ATAKENT MAH.,414,373,369,135,234
UMRANIYE,ATAKENT MAH.,414,383,381,145,236
UMRANIYE,ATAKENT MAH.,411,384,380,143,237
UMRANIYE,ATAKENT MAH.,414,367,364,176,188
UMRANIYE,ATAKENT MAH.,414,381,379,147,232
UMRANIYE,ATAKENT MAH.,395,321,317,142,175
UMRANIYE,ATAKENT MAH.,395,332,329,147,182
UMRANIYE,ATAKENT MAH.,397,365,361,184,177
UMRANIYE,ATAKENT MAH.,395,360,353,146,207
UMRANIYE,ATAKENT MAH.,395,353,348,180,168
UMRANIYE,ATAKENT MAH.,396,365,359,167,192
UMRANIYE,ATAKENT MAH.,394,360,354,154,200
UMRANIYE,ATAKENT MAH.,395,357,355,163,192
UMRANIYE,ATAKENT MAH.,395,356,355,174,181
UMRANIYE,ATAKENT MAH.,397,352,347,136,211
UMRANIYE,ATAKENT MAH.,395,356,348,168,180
UMRANIYE,ATAKENT MAH.,395,352,345,181,164
UMRANIYE,ATAKENT MAH.,394,357,349,173,176
UMRANIYE,ATAKENT MAH.,396,338,333,144,189
UMRANIYE,ATAKENT MAH.,394,365,361,169,192
UMRANIYE,ATAKENT MAH.,395,367,361,168,193
UMRANIYE,ATAKENT MAH.,394,369,366,146,220
UMRANIYE,ATAKENT MAH.,395,352,338,166,172
UMRANIYE,ATAKENT MAH.,395,365,359,152,207
UMRANIYE,ATAKENT MAH.,394,366,365,170,195
UMRANIYE,CEMIL MERIC MAH.,415,356,348,201,147
UMRANIYE,CEMIL MERIC MAH.,415,357,346,216,130
UMRANIYE,CEMIL MERIC MAH.,416,381,378,211,167
UMRANIYE,CEMIL MERIC MAH.,412,377,374,228,146
UMRANIYE,CEMIL MERIC MAH.,416,378,378,219,159
UMRANIYE,CEMIL MERIC MAH.,415,383,378,246,132
UMRANIYE,CEMIL MERIC MAH.,412,354,351,189,162
UMRANIYE,CEMIL MERIC MAH.,416,372,369,194,175
UMRANIYE,CEMIL MERIC MAH.,416,383,379,217,162
UMRANIYE,CEMIL MERIC MAH.,415,363,359,210,149
UMRANIYE,CEMIL MERIC MAH.,415,375,370,191,179
UMRANIYE,CEMIL MERIC MAH.,414,387,381,218,163
UMRANIYE,CEMIL MERIC MAH.,415,365,357,226,131
UMRANIYE,CEMIL MERIC MAH.,415,376,371,223,148
UMRANIYE,CEMIL MERIC MAH.,413,371,370,220,150
UMRANIYE,CEMIL MERIC MAH.,401,353,345,181,164
UMRANIYE,CEMIL MERIC MAH.,401,334,333,191,142
UMRANIYE,CEMIL MERIC MAH.,402,346,340,208,132
UMRANIYE,CEMIL MERIC MAH.,403,366,361,208,153
UMRANIYE,CEMIL MERIC MAH.,402,357,349,213,136
UMRANIYE,CEMIL MERIC MAH.,401,339,337,193,144
UMRANIYE,CEMIL MERIC MAH.,402,352,345,205,140
UMRANIYE,CEMIL MERIC MAH.,405,371,369,228,141
UMRANIYE,CEMIL MERIC MAH.,401,367,361,215,146
UMRANIYE,CEMIL MERIC MAH.,402,360,357,230,127
UMRANIYE,CEMIL MERIC MAH.,402,342,338,196,142
UMRANIYE,CEMIL MERIC MAH.,400,358,350,226,124
UMRANIYE,CEMIL MERIC MAH.,402,361,358,232,126
UMRANIYE,CEMIL MERIC MAH.,402,357,349,221,128
UMRANIYE,CEMIL MERIC MAH.,400,344,341,221,120
UMRANIYE,CEMIL MERIC MAH.,403,359,356,217,139
UMRANIYE,CEMIL MERIC MAH.,402,368,360,205,155
UMRANIYE,CEMIL MERIC MAH.,401,349,347,213,134
UMRANIYE,CEMIL MERIC MAH.,402,360,358,207,151
UMRANIYE,CEMIL MERIC MAH.,401,357,355,221,134
UMRANIYE,CEMIL MERIC MAH.,402,351,344,219,125
UMRANIYE,CEMIL MERIC MAH.,401,353,343,205,138
UMRANIYE,CEMIL MERIC MAH.,402,356,352,210,142
UMRANIYE,CEMIL MERIC MAH.,402,364,360,248,112
UMRANIYE,CAKMAK MAH.,404,330,326,164,162
UMRANIYE,CAKMAK MAH.,405,358,350,188,162
UMRANIYE,CAKMAK MAH.,406,374,370,219,151
UMRANIYE,CAKMAK MAH.,405,373,369,194,175
UMRANIYE,CAKMAK MAH.,405,366,360,196,164
UMRANIYE,CAKMAK MAH.,404,372,370,191,179
UMRANIYE,CAKMAK MAH.,405,374,370,193,177
UMRANIYE,CAKMAK MAH.,405,367,363,166,197
UMRANIYE,CAKMAK MAH.,405,367,358,180,178
UMRANIYE,CAKMAK MAH.,405,370,366,189,177
UMRANIYE,CAKMAK MAH.,404,364,359,222,137
UMRANIYE,CAKMAK MAH.,404,361,358,187,171
UMRANIYE,CAKMAK MAH.,405,367,362,185,177
UMRANIYE,CAKMAK MAH.,403,363,354,191,163
UMRANIYE,CAKMAK MAH.,405,355,354,177,177
UMRANIYE,CAKMAK MAH.,404,368,365,179,186
UMRANIYE,CAKMAK MAH.,410,354,347,206,141
UMRANIYE,CAKMAK MAH.,409,351,345,190,155
UMRANIYE,CAKMAK MAH.,408,361,355,207,148
UMRANIYE,CAKMAK MAH.,412,373,371,197,174
UMRANIYE,CAKMAK MAH.,409,351,344,151,193
UMRANIYE,CAKMAK MAH.,409,385,381,202,179
UMRANIYE,CAKMAK MAH.,408,368,362,225,137
UMRANIYE,CAKMAK MAH.,409,364,359,219,140
UMRANIYE,CAKMAK MAH.,409,364,361,215,146
UMRANIYE,CAKMAK MAH.,409,349,344,216,128
UMRANIYE,CAKMAK MAH.,409,359,356,200,156
UMRANIYE,CAKMAK MAH.,408,368,357,202,155
UMRANIYE,CAKMAK MAH.,408,371,364,183,181
UMRANIYE,CAKMAK MAH.,408,364,357,177,180
UMRANIYE,CAKMAK MAH.,410,352,350,222,128
UMRANIYE,CAKMAK MAH.,409,374,368,187,181
UMRANIYE,CAKMAK MAH.,409,367,363,182,181
UMRANIYE,CAKMAK MAH.,408,351,346,176,170
UMRANIYE,CAKMAK MAH.,408,359,354,210,144
UMRANIYE,CAKMAK MAH.,409,372,369,223,146
UMRANIYE,CAKMAK MAH.,409,371,365,195,170
UMRANIYE,CAKMAK MAH.,409,361,349,208,141
UMRANIYE,CAKMAK MAH.,408,361,359,199,160
UMRANIYE,CAKMAK MAH.,408,376,369,214,155
UMRANIYE,CAKMAK MAH.,409,378,377,240,137
UMRANIYE,CAKMAK MAH.,409,370,367,222,145
UMRANIYE,CAKMAK MAH.,408,348,346,203,143
UMRANIYE,CAKMAK MAH.,403,331,329,229,100
UMRANIYE,CAKMAK MAH.,403,360,355,223,132
UMRANIYE,CAKMAK MAH.,403,355,353,223,130
UMRANIYE,CAKMAK MAH.,403,368,364,207,157
UMRANIYE,CAKMAK MAH.,404,368,365,240,125
UMRANIYE,CAKMAK MAH.,403,345,343,202,141
UMRANIYE,CAKMAK MAH.,403,365,361,204,157
UMRANIYE,CAKMAK MAH.,405,366,359,193,166
UMRANIYE,CAKMAK MAH.,403,358,347,188,159
UMRANIYE,CAKMAK MAH.,403,352,348,201,147
UMRANIYE,CAKMAK MAH.,403,355,350,189,161
UMRANIYE,CAKMAK MAH.,402,359,354,230,124
UMRANIYE,CAKMAK MAH.,403,346,342,218,124
UMRANIYE,CAKMAK MAH.,402,356,352,220,132
UMRANIYE,CAKMAK MAH.,403,357,353,200,153
UMRANIYE,CAKMAK MAH.,403,383,378,215,163
UMRANIYE,CAKMAK MAH.,402,364,361,218,143
UMRANIYE,CAKMAK MAH.,403,371,368,226,142
UMRANIYE,CAKMAK MAH.,402,362,359,188,171
UMRANIYE,CAKMAK MAH.,402,358,351,198,153
UMRANIYE,CAKMAK MAH.,403,355,347,208,139
UMRANIYE,CAKMAK MAH.,402,357,355,222,133
UMRANIYE,CAMLIK MAH.,415,353,350,147,203
UMRANIYE,CAMLIK MAH.,410,345,330,152,178
UMRANIYE,CAMLIK MAH.,409,366,361,153,208
UMRANIYE,CAMLIK MAH.,413,379,371,167,204
UMRANIYE,CAMLIK MAH.,410,376,370,164,206
UMRANIYE,CAMLIK MAH.,410,380,370,179,191
UMRANIYE,CAMLIK MAH.,410,372,370,168,202
UMRANIYE,CAMLIK MAH.,410,376,369,189,180
UMRANIYE,CAMLIK MAH.,412,370,366,165,201
UMRANIYE,CAMLIK MAH.,410,368,365,205,160
UMRANIYE,CAMLIK MAH.,409,372,369,158,211
UMRANIYE,CAMLIK MAH.,409,373,369,146,223
UMRANIYE,CAMLIK MAH.,410,381,378,167,211
UMRANIYE,CAMLIK MAH.,410,368,366,174,192
UMRANIYE,CAMLIK MAH.,410,378,372,154,218
UMRANIYE,CAMLIK MAH.,410,373,370,189,181
UMRANIYE,CAMLIK MAH.,410,354,352,189,163
UMRANIYE,CAMLIK MAH.,409,375,369,151,218
UMRANIYE,CAMLIK MAH.,410,366,365,170,195
UMRANIYE,CAMLIK MAH.,409,368,365,168,197
UMRANIYE,CAMLIK MAH.,410,366,361,149,212
UMRANIYE,CAMLIK MAH.,409,369,362,160,202
UMRANIYE,CAMLIK MAH.,409,368,362,163,199
UMRANIYE,CAMLIK MAH.,410,376,366,167,199
UMRANIYE,CAMLIK MAH.,410,374,372,174,198
UMRANIYE,CAMLIK MAH.,410,377,373,190,183
UMRANIYE,CAMLIK MAH.,409,382,375,170,205
UMRANIYE,CAMLIK MAH.,409,376,375,184,191
UMRANIYE,CAMLIK MAH.,410,365,360,134,226
UMRANIYE,CAMLIK MAH.,409,365,362,169,193
UMRANIYE,CAMLIK MAH.,410,366,362,181,181
UMRANIYE,CAMLIK MAH.,409,343,338,204,134
UMRANIYE,CAMLIK MAH.,408,361,355,178,177
UMRANIYE,CAMLIK MAH.,408,376,374,196,178
UMRANIYE,CAMLIK MAH.,409,365,354,196,158
UMRANIYE,CAMLIK MAH.,408,360,358,198,160
UMRANIYE,CAMLIK MAH.,409,356,351,193,158
UMRANIYE,CAMLIK MAH.,409,365,359,211,148
UMRANIYE,CAMLIK MAH.,410,369,365,211,154
UMRANIYE,IHLAMURKUYU MAH.,406,333,321,199,122
UMRANIYE,IHLAMURKUYU MAH.,406,352,348,235,113
UMRANIYE,IHLAMURKUYU MAH.,406,344,338,203,135
UMRANIYE,IHLAMURKUYU MAH.,406,351,343,199,144
UMRANIYE,IHLAMURKUYU MAH.,407,366,360,231,129
UMRANIYE,IHLAMURKUYU MAH.,406,357,349,218,131
UMRANIYE,IHLAMURKUYU MAH.,408,358,351,199,152
UMRANIYE,IHLAMURKUYU MAH.,406,365,360,222,138
UMRANIYE,IHLAMURKUYU MAH.,407,368,363,199,164
UMRANIYE,IHLAMURKUYU MAH.,406,365,364,244,120
UMRANIYE,IHLAMURKUYU MAH.,405,371,368,234,134
UMRANIYE,IHLAMURKUYU MAH.,405,357,353,241,112
UMRANIYE,IHLAMURKUYU MAH.,396,335,325,186,139
UMRANIYE,IHLAMURKUYU MAH.,398,342,334,206,128
UMRANIYE,IHLAMURKUYU MAH.,396,362,355,193,162
UMRANIYE,IHLAMURKUYU MAH.,396,362,357,207,150
UMRANIYE,IHLAMURKUYU MAH.,395,333,333,194,139
UMRANIYE,IHLAMURKUYU MAH.,396,347,342,174,168
UMRANIYE,IHLAMURKUYU MAH.,396,352,346,171,175
UMRANIYE,IHLAMURKUYU MAH.,395,343,337,218,119
UMRANIYE,IHLAMURKUYU MAH.,395,360,354,228,126
UMRANIYE,IHLAMURKUYU MAH.,395,341,337,188,149
UMRANIYE,IHLAMURKUYU MAH.,394,352,348,224,124
UMRANIYE,IHLAMURKUYU MAH.,396,348,341,188,153
UMRANIYE,IHLAMURKUYU MAH.,395,340,338,178,160
UMRANIYE,IHLAMURKUYU MAH.,395,344,337,188,149
UMRANIYE,IHLAMURKUYU MAH.,396,332,327,169,158
UMRANIYE,IHLAMURKUYU MAH.,396,354,350,214,136
UMRANIYE,IHLAMURKUYU MAH.,395,356,351,221,130
UMRANIYE,ISTIKLAL MAH.,412,331,322,216,106
UMRANIYE,ISTIKLAL MAH.,415,353,351,227,124
UMRANIYE,ISTIKLAL MAH.,409,356,353,223,130
UMRANIYE,ISTIKLAL MAH.,409,359,353,230,123
UMRANIYE,ISTIKLAL MAH.,410,370,364,219,145
UMRANIYE,ISTIKLAL MAH.,408,352,346,217,129
UMRANIYE,ISTIKLAL MAH.,410,371,358,216,142
UMRANIYE,ISTIKLAL MAH.,409,366,356,255,101
UMRANIYE,ISTIKLAL MAH.,409,362,355,216,139
UMRANIYE,ISTIKLAL MAH.,409,363,358,239,119
UMRANIYE,ISTIKLAL MAH.,409,359,356,215,141
UMRANIYE,ISTIKLAL MAH.,408,369,355,218,137
UMRANIYE,ISTIKLAL MAH.,408,352,350,215,135
UMRANIYE,ISTIKLAL MAH.,409,361,354,233,121
UMRANIYE,ISTIKLAL MAH.,408,354,351,216,135
UMRANIYE,ISTIKLAL MAH.,409,348,343,208,135
UMRANIYE,ISTIKLAL MAH.,406,320,314,184,130
UMRANIYE,ISTIKLAL MAH.,406,337,331,172,159
UMRANIYE,ISTIKLAL MAH.,406,379,375,204,171
UMRANIYE,ISTIKLAL MAH.,406,357,349,167,182
UMRANIYE,ISTIKLAL MAH.,405,378,370,197,173
UMRANIYE,ISTIKLAL MAH.,406,365,354,189,165
UMRANIYE,ISTIKLAL MAH.,406,360,353,190,163
UMRANIYE,ISTIKLAL MAH.,405,363,356,208,148
UMRANIYE,ISTIKLAL MAH.,406,361,354,197,157
UMRANIYE,ISTIKLAL MAH.,406,372,361,204,157
UMRANIYE,ISTIKLAL MAH.,405,367,361,185,176
UMRANIYE,ISTIKLAL MAH.,406,373,361,194,167
UMRANIYE,ISTIKLAL MAH.,405,371,358,212,146
UMRANIYE,ISTIKLAL MAH.,406,360,350,189,161
UMRANIYE,ISTIKLAL MAH.,405,371,361,203,158
UMRANIYE,ISTIKLAL MAH.,406,367,361,205,156
UMRANIYE,ISTIKLAL MAH.,405,367,360,217,143
UMRANIYE,ISTIKLAL MAH.,406,378,372,206,166
UMRANIYE,ISTIKLAL MAH.,406,362,359,183,176
UMRANIYE,ISTIKLAL MAH.,405,367,363,174,189
UMRANIYE,ISTIKLAL MAH.,406,362,354,183,171
UMRANIYE,ISTIKLAL MAH.,406,357,349,199,150
UMRANIYE,ISTIKLAL MAH.,405,353,344,170,174
UMRANIYE,ISTIKLAL MAH.,406,359,350,204,146
UMRANIYE,ISTIKLAL MAH.,406,363,361,211,150
UMRANIYE,ISTIKLAL MAH.,405,376,365,201,164
UMRANIYE,ISTIKLAL MAH.,385,321,313,168,145
UMRANIYE,ISTIKLAL MAH.,385,339,328,178,150
UMRANIYE,ISTIKLAL MAH.,386,352,348,222,126
UMRANIYE,ISTIKLAL MAH.,386,355,351,219,132
UMRANIYE,ISTIKLAL MAH.,386,341,333,232,101
UMRANIYE,ISTIKLAL MAH.,387,344,340,210,130
UMRANIYE,ISTIKLAL MAH.,387,356,351,206,145
UMRANIYE,ISTIKLAL MAH.,386,340,334,203,131
UMRANIYE,ISTIKLAL MAH.,385,334,328,194,134
UMRANIYE,ISTIKLAL MAH.,385,334,326,185,141
UMRANIYE,ISTIKLAL MAH.,386,353,349,200,149
UMRANIYE,ISTIKLAL MAH.,386,349,341,175,166
UMRANIYE,ISTIKLAL MAH.,386,351,345,203,142
UMRANIYE,ISTIKLAL MAH.,396,315,304,178,126
UMRANIYE,ISTIKLAL MAH.,397,337,332,201,131
UMRANIYE,ISTIKLAL MAH.,397,365,360,222,138
UMRANIYE,ISTIKLAL MAH.,397,368,360,216,144
UMRANIYE,ISTIKLAL MAH.,396,360,348,207,141
UMRANIYE,ISTIKLAL MAH.,397,361,357,228,129
UMRANIYE,ISTIKLAL MAH.,395,353,349,232,117
UMRANIYE,ISTIKLAL MAH.,397,353,349,223,126
UMRANIYE,ISTIKLAL MAH.,398,350,342,206,136
UMRANIYE,ISTIKLAL MAH.,396,354,352,204,148
UMRANIYE,ISTIKLAL MAH.,397,342,337,220,117
UMRANIYE,ISTIKLAL MAH.,396,359,356,212,144
UMRANIYE,ISTIKLAL MAH.,397,359,353,214,139
UMRANIYE,ISTIKLAL MAH.,397,344,340,219,121
UMRANIYE,ISTIKLAL MAH.,398,359,355,199,156
UMRANIYE,ISTIKLAL MAH.,397,364,360,232,128
UMRANIYE,ISTIKLAL MAH.,396,358,353,207,146
UMRANIYE,ISTIKLAL MAH.,394,360,355,222,133
UMRANIYE,ISTIKLAL MAH.,404,320,315,174,141
UMRANIYE,ISTIKLAL MAH.,404,354,346,200,146
UMRANIYE,ISTIKLAL MAH.,403,340,333,193,140
UMRANIYE,ISTIKLAL MAH.,404,360,354,222,132
UMRANIYE,ISTIKLAL MAH.,404,364,356,212,144
UMRANIYE,ISTIKLAL MAH.,403,364,363,209,154
UMRANIYE,ISTIKLAL MAH.,404,357,351,171,180
UMRANIYE,ISTIKLAL MAH.,403,346,341,216,125
UMRANIYE,ISTIKLAL MAH.,404,354,349,226,123
UMRANIYE,ISTIKLAL MAH.,403,370,362,207,155
UMRANIYE,ISTIKLAL MAH.,404,360,353,204,149
UMRANIYE,ISTIKLAL MAH.,403,374,367,244,123
UMRANIYE,ISTIKLAL MAH.,403,359,353,227,126
UMRANIYE,SITE MAH.,402,338,338,92,246
UMRANIYE,SITE MAH.,402,378,375,95,280
UMRANIYE,SITE MAH.,402,374,374,83,291
UMRANIYE,SITE MAH.,402,372,369,80,289
UMRANIYE,SITE MAH.,402,378,372,81,291
UMRANIYE,SITE MAH.,401,374,373,89,284
UMRANIYE,SITE MAH.,403,364,358,59,299
UMRANIYE,SITE MAH.,402,361,360,72,288
UMRANIYE,SITE MAH.,402,375,375,91,284
UMRANIYE,SITE MAH.,402,368,367,82,285
UMRANIYE,SITE MAH.,401,370,366,95,271
UMRANIYE,SITE MAH.,401,371,369,80,289
UMRANIYE,SITE MAH.,401,384,383,95,288
UMRANIYE,SITE MAH.,401,368,363,78,285
UMRANIYE,SITE MAH.,401,375,369,83,286
UMRANIYE,SITE MAH.,401,356,350,138,212
UMRANIYE,SITE MAH.,401,365,359,105,254
UMRANIYE,SITE MAH.,401,365,365,140,225
UMRANIYE,SITE MAH.,404,389,383,122,261
UMRANIYE,SITE MAH.,401,352,347,136,211
UMRANIYE,SITE MAH.,402,359,355,105,250
UMRANIYE,SITE MAH.,402,377,375,107,268
UMRANIYE,SITE MAH.,401,367,366,133,233
UMRANIYE,SITE MAH.,403,366,362,117,245
UMRANIYE,SITE MAH.,400,369,365,125,240
UMRANIYE,SITE MAH.,401,365,363,138,225
UMRANIYE,SITE MAH.,401,381,377,140,237
UMRANIYE,SITE MAH.,401,370,370,128,242
UMRANIYE,SITE MAH.,401,366,362,121,241
UMRANIYE,SITE MAH.,401,366,363,126,237
UMRANIYE,SITE MAH.,400,369,360,129,231
UMRANIYE,SITE MAH.,400,353,350,129,221
UMRANIYE,SITE MAH.,401,363,361,114,247
UMRANIYE,SITE MAH.,401,375,371,146,225
UMRANIYE,SITE MAH.,401,358,354,114,240
UMRANIYE,SITE MAH.,400,352,350,121,229
UMRANIYE,SITE MAH.,398,346,336,58,278
UMRANIYE,SITE MAH.,399,369,363,47,316
UMRANIYE,SITE MAH.,399,349,345,45,300
UMRANIYE,SITE MAH.,399,370,367,64,303
UMRANIYE,SITE MAH.,399,356,353,58,295
UMRANIYE,SITE MAH.,397,356,354,54,300
UMRANIYE,SITE MAH.,400,363,358,56,302
UMRANIYE,SITE MAH.,399,356,355,76,279
UMRANIYE,SITE MAH.,399,364,363,52,311
UMRANIYE,SITE MAH.,399,373,370,64,306
UMRANIYE,TEPEUSTU MAH.,406,327,317,175,142
UMRANIYE,TEPEUSTU MAH.,406,326,318,200,118
UMRANIYE,TEPEUSTU MAH.,408,360,355,213,142
UMRANIYE,TEPEUSTU MAH.,405,370,365,220,145
UMRANIYE,TEPEUSTU MAH.,408,369,363,243,120
UMRANIYE,TEPEUSTU MAH.,405,370,362,236,126
UMRANIYE,TEPEUSTU MAH.,406,346,339,198,141
UMRANIYE,TEPEUSTU MAH.,405,344,341,215,126
UMRANIYE,TEPEUSTU MAH.,406,370,368,248,120
UMRANIYE,TEPEUSTU MAH.,407,365,363,219,144
UMRANIYE,TEPEUSTU MAH.,405,346,340,227,113
UMRANIYE,TEPEUSTU MAH.,405,371,369,226,143
UMRANIYE,TEPEUSTU MAH.,405,369,362,222,140
UMRANIYE,TEPEUSTU MAH.,406,357,354,215,139
UMRANIYE,TEPEUSTU MAH.,406,363,357,248,109
UMRANIYE,TEPEUSTU MAH.,405,365,358,232,126
UMRANIYE,TEPEUSTU MAH.,406,360,347,226,121
UMRANIYE,TEPEUSTU MAH.,405,346,342,201,141
UMRANIYE,TEPEUSTU MAH.,406,369,364,210,154
UMRANIYE,TEPEUSTU MAH.,405,355,353,213,140
UMRANIYE,TEPEUSTU MAH.,406,371,370,213,157
UMRANIYE,TEPEUSTU MAH.,405,357,352,243,109
UMRANIYE,TEPEUSTU MAH.,407,350,347,213,134
UMRANIYE,TEPEUSTU MAH.,407,365,360,225,135
UMRANIYE,ADEM YAVUZ MAH.,402,320,312,200,112
UMRANIYE,ADEM YAVUZ MAH.,403,317,311,191,120
UMRANIYE,ADEM YAVUZ MAH.,402,335,326,245,81
UMRANIYE,ADEM YAVUZ MAH.,403,362,355,243,112
UMRANIYE,ADEM YAVUZ MAH.,404,339,337,221,116
UMRANIYE,ADEM YAVUZ MAH.,402,341,334,222,112
UMRANIYE,ADEM YAVUZ MAH.,402,353,350,214,136
UMRANIYE,ADEM YAVUZ MAH.,402,348,343,238,105
UMRANIYE,ADEM YAVUZ MAH.,402,361,353,234,119
UMRANIYE,ADEM YAVUZ MAH.,403,341,334,240,94
UMRANIYE,ADEM YAVUZ MAH.,402,357,346,226,120
UMRANIYE,ADEM YAVUZ MAH.,402,369,365,245,120
UMRANIYE,ADEM YAVUZ MAH.,404,364,360,231,129
UMRANIYE,ADEM YAVUZ MAH.,403,357,351,221,130
UMRANIYE,ADEM YAVUZ MAH.,403,361,355,225,130
UMRANIYE,ADEM YAVUZ MAH.,402,331,326,206,120
UMRANIYE,ADEM YAVUZ MAH.,403,356,354,223,131
UMRANIYE,ADEM YAVUZ MAH.,408,360,354,228,126
UMRANIYE,ADEM YAVUZ MAH.,403,367,364,233,131
UMRANIYE,ADEM YAVUZ MAH.,402,362,357,237,120
UMRANIYE,ADEM YAVUZ MAH.,403,374,371,266,105
UMRANIYE,ADEM YAVUZ MAH.,403,351,345,245,100
UMRANIYE,ADEM YAVUZ MAH.,403,347,344,237,107
UMRANIYE,ADEM YAVUZ MAH.,403,371,362,258,104
UMRANIYE,ADEM YAVUZ MAH.,403,349,347,209,138
UMRANIYE,ADEM YAVUZ MAH.,403,369,366,249,117
UMRANIYE,ADEM YAVUZ MAH.,402,370,363,264,99
UMRANIYE,ADEM YAVUZ MAH.,402,364,360,246,114
UMRANIYE,ADEM YAVUZ MAH.,403,361,358,264,94
UMRANIYE,ADEM YAVUZ MAH.,404,391,386,277,109
UMRANIYE,ALTINSEHIR MAH.,391,315,309,173,136
UMRANIYE,ALTINSEHIR MAH.,390,353,351,237,114
UMRANIYE,ALTINSEHIR MAH.,392,343,339,213,126
UMRANIYE,ALTINSEHIR MAH.,391,356,354,233,121
UMRANIYE,ALTINSEHIR MAH.,391,340,337,215,122
UMRANIYE,ALTINSEHIR MAH.,390,341,336,242,94
UMRANIYE,ALTINSEHIR MAH.,390,334,329,200,129
UMRANIYE,ALTINSEHIR MAH.,391,350,346,231,115
UMRANIYE,ALTINSEHIR MAH.,389,356,347,231,116
UMRANIYE,ALTINSEHIR MAH.,390,344,340,232,108
UMRANIYE,ALTINSEHIR MAH.,391,339,335,217,118
UMRANIYE,ALTINSEHIR MAH.,411,333,323,234,89
UMRANIYE,ALTINSEHIR MAH.,411,368,363,236,127
UMRANIYE,ALTINSEHIR MAH.,411,375,373,254,119
UMRANIYE,ALTINSEHIR MAH.,411,363,354,254,100
UMRANIYE,ALTINSEHIR MAH.,411,376,372,253,119
UMRANIYE,ALTINSEHIR MAH.,411,369,365,250,115
UMRANIYE,ALTINSEHIR MAH.,411,365,362,256,106
UMRANIYE,ALTINSEHIR MAH.,415,372,370,271,99
UMRANIYE,ALTINSEHIR MAH.,415,381,375,271,104
UMRANIYE,ALTINSEHIR MAH.,411,377,371,245,126
UMRANIYE,ALTINSEHIR MAH.,412,364,359,229,130
UMRANIYE,ALTINSEHIR MAH.,412,380,376,243,133
UMRANIYE,ALTINSEHIR MAH.,412,376,367,244,123
UMRANIYE,ALTINSEHIR MAH.,411,374,369,246,123
UMRANIYE,ALTINSEHIR MAH.,410,380,367,237,130
UMRANIYE,ALTINSEHIR MAH.,415,334,329,203,126
UMRANIYE,ALTINSEHIR MAH.,415,327,317,140,177
UMRANIYE,ALTINSEHIR MAH.,415,370,366,230,136
UMRANIYE,ALTINSEHIR MAH.,415,359,356,228,128
UMRANIYE,ALTINSEHIR MAH.,415,377,373,247,126
UMRANIYE,ALTINSEHIR MAH.,415,372,369,199,170
UMRANIYE,ALTINSEHIR MAH.,410,369,368,244,124
UMRANIYE,ALTINSEHIR MAH.,413,371,366,220,146
UMRANIYE,ALTINSEHIR MAH.,410,361,358,221,137
UMRANIYE,ALTINSEHIR MAH.,415,367,363,222,141
UMRANIYE,ALTINSEHIR MAH.,413,373,367,250,117
UMRANIYE,ALTINSEHIR MAH.,415,368,364,212,152
UMRANIYE,ALTINSEHIR MAH.,412,365,356,204,152
UMRANIYE,ALTINSEHIR MAH.,412,364,362,206,156
UMRANIYE,ALTINSEHIR MAH.,413,370,365,224,141
UMRANIYE,ALTINSEHIR MAH.,413,369,362,181,181
UMRANIYE,ALTINSEHIR MAH.,411,375,369,218,151
UMRANIYE,ALTINSEHIR MAH.,412,354,351,216,135
UMRANIYE,ALTINSEHIR MAH.,413,380,376,248,128
UMRANIYE,ALTINSEHIR MAH.,412,367,364,230,134
UMRANIYE,ALTINSEHIR MAH.,412,360,359,255,104
UMRANIYE,ALTINSEHIR MAH.,412,357,353,238,115
UMRANIYE,ALTINSEHIR MAH.,412,374,371,220,151
UMRANIYE,ASAGI DUDULLU MAH.,409,346,342,194,148
UMRANIYE,ASAGI DUDULLU MAH.,409,355,346,210,136
UMRANIYE,ASAGI DUDULLU MAH.,409,369,365,230,135
UMRANIYE,ASAGI DUDULLU MAH.,409,371,367,228,139
UMRANIYE,ASAGI DUDULLU MAH.,409,366,361,208,153
UMRANIYE,ASAGI DUDULLU MAH.,409,365,358,208,150
UMRANIYE,ASAGI DUDULLU MAH.,409,375,369,233,136
UMRANIYE,ASAGI DUDULLU MAH.,408,370,365,198,167
UMRANIYE,ASAGI DUDULLU MAH.,410,360,354,212,142
UMRANIYE,ASAGI DUDULLU MAH.,409,370,366,212,154
UMRANIYE,ASAGI DUDULLU MAH.,410,364,360,210,150
UMRANIYE,ASAGI DUDULLU MAH.,409,350,348,181,167
UMRANIYE,ASAGI DUDULLU MAH.,409,375,372,234,138
UMRANIYE,ASAGI DUDULLU MAH.,408,366,355,248,107
UMRANIYE,ASAGI DUDULLU MAH.,409,361,358,224,134
UMRANIYE,ASAGI DUDULLU MAH.,409,363,358,201,157
UMRANIYE,ASAGI DUDULLU MAH.,409,365,363,218,145
UMRANIYE,ASAGI DUDULLU MAH.,409,378,374,230,144
UMRANIYE,ASAGI DUDULLU MAH.,408,363,360,195,165
UMRANIYE,ASAGI DUDULLU MAH.,408,376,364,203,161
UMRANIYE,ASAGI DUDULLU MAH.,409,383,377,239,138
UMRANIYE,ESENKENT MAH.,403,343,330,181,149
UMRANIYE,ESENKENT MAH.,404,333,326,200,126
UMRANIYE,ESENKENT MAH.,404,361,358,241,117
UMRANIYE,ESENKENT MAH.,405,362,358,243,115
UMRANIYE,ESENKENT MAH.,404,369,355,226,129
UMRANIYE,ESENKENT MAH.,404,348,345,205,140
UMRANIYE,ESENKENT MAH.,405,363,356,210,146
UMRANIYE,ESENKENT MAH.,407,374,367,256,111
UMRANIYE,ESENKENT MAH.,404,365,357,225,132
UMRANIYE,ESENKENT MAH.,405,354,350,213,137
UMRANIYE,ESENKENT MAH.,404,371,369,244,125
UMRANIYE,ESENKENT MAH.,404,361,359,225,134
UMRANIYE,ESENKENT MAH.,404,374,369,248,121
UMRANIYE,ESENKENT MAH.,404,359,355,226,129
UMRANIYE,ESENKENT MAH.,405,366,360,229,131
UMRANIYE,ESENKENT MAH.,404,373,370,213,157
UMRANIYE,ESENKENT MAH.,407,363,360,225,135
UMRANIYE,ESENKENT MAH.,404,368,361,220,141
UMRANIYE,ESENKENT MAH.,403,356,347,215,132
UMRANIYE,ESENKENT MAH.,404,362,354,223,131
UMRANIYE,ESENKENT MAH.,404,369,364,224,140
UMRANIYE,ESENKENT MAH.,404,347,337,194,143
UMRANIYE,ESENKENT MAH.,405,355,353,242,111
UMRANIYE,ESENKENT MAH.,406,359,354,197,157
UMRANIYE,ESENKENT MAH.,403,368,362,222,140
UMRANIYE,ESENKENT MAH.,406,371,364,223,141
UMRANIYE,ESENKENT MAH.,404,374,372,227,145
UMRANIYE,ESENKENT MAH.,404,362,351,233,118
UMRANIYE,ESENKENT MAH.,404,368,362,240,122
UMRANIYE,ESENKENT MAH.,405,371,366,229,137
UMRANIYE,ESENKENT MAH.,406,383,377,263,114
UMRANIYE,ESENSEHIR MAH.,415,346,334,173,161
UMRANIYE,ESENSEHIR MAH.,415,349,338,158,180
UMRANIYE,ESENSEHIR MAH.,415,365,361,186,175
UMRANIYE,ESENSEHIR MAH.,415,372,363,178,185
UMRANIYE,ESENSEHIR MAH.,409,368,365,189,176
UMRANIYE,ESENSEHIR MAH.,410,359,353,204,149
UMRANIYE,ESENSEHIR MAH.,409,348,342,181,161
UMRANIYE,ESENSEHIR MAH.,410,361,359,166,193
UMRANIYE,ESENSEHIR MAH.,410,363,359,186,173
UMRANIYE,ESENSEHIR MAH.,410,365,359,150,209
UMRANIYE,ESENSEHIR MAH.,409,356,354,194,160
UMRANIYE,ESENSEHIR MAH.,409,372,366,187,179
UMRANIYE,ESENSEHIR MAH.,409,366,363,173,190
UMRANIYE,ESENSEHIR MAH.,410,365,359,169,190
UMRANIYE,ESENSEHIR MAH.,408,363,356,165,191
UMRANIYE,ESENSEHIR MAH.,408,360,357,192,165
UMRANIYE,ESENSEHIR MAH.,409,362,360,163,197
UMRANIYE,ESENSEHIR MAH.,409,363,359,190,169
UMRANIYE,ESENSEHIR MAH.,408,360,354,185,169
UMRANIYE,ESENSEHIR MAH.,409,367,361,197,164
UMRANIYE,ESENSEHIR MAH.,409,364,360,171,189
UMRANIYE,ESENSEHIR MAH.,409,368,356,186,170
UMRANIYE,ESENSEHIR MAH.,410,349,345,169,176
UMRANIYE,ESENSEHIR MAH.,410,360,353,173,180
UMRANIYE,ESENSEHIR MAH.,410,364,357,167,190
UMRANIYE,ESENSEHIR MAH.,409,364,355,173,182
UMRANIYE,ESENSEHIR MAH.,409,376,372,190,182
UMRANIYE,ESENSEHIR MAH.,409,380,379,177,202
UMRANIYE,ESENSEHIR MAH.,410,361,356,197,159
UMRANIYE,ESENSEHIR MAH.,409,373,367,177,190
UMRANIYE,ESENSEHIR MAH.,408,382,375,184,191
UMRANIYE,HUZUR MAH.,415,351,344,211,133
UMRANIYE,HUZUR MAH.,415,359,346,224,122
UMRANIYE,HUZUR MAH.,415,375,370,264,106
UMRANIYE,HUZUR MAH.,412,375,371,242,129
UMRANIYE,HUZUR MAH.,415,372,368,225,143
UMRANIYE,HUZUR MAH.,412,372,366,233,133
UMRANIYE,HUZUR MAH.,415,369,367,259,108
UMRANIYE,HUZUR MAH.,413,371,363,236,127
UMRANIYE,HUZUR MAH.,415,375,370,236,134
UMRANIYE,HUZUR MAH.,415,367,358,227,131
UMRANIYE,HUZUR MAH.,412,377,363,240,123
UMRANIYE,HUZUR MAH.,413,368,363,250,113
UMRANIYE,HUZUR MAH.,413,360,350,241,109
UMRANIYE,HUZUR MAH.,413,377,375,239,136
UMRANIYE,HUZUR MAH.,414,377,372,251,121
UMRANIYE,HUZUR MAH.,413,356,339,232,107
UMRANIYE,HUZUR MAH.,414,368,358,248,110
UMRANIYE,HUZUR MAH.,414,380,373,269,104
UMRANIYE,HUZUR MAH.,414,365,359,238,121
UMRANIYE,HUZUR MAH.,415,372,364,267,97
UMRANIYE,MADENLER MAH.,406,363,336,145,191
UMRANIYE,MADENLER MAH.,405,354,350,194,156
UMRANIYE,MADENLER MAH.,405,376,370,177,193
UMRANIYE,MADENLER MAH.,405,368,366,186,180
UMRANIYE,MADENLER MAH.,406,378,370,177,193
UMRANIYE,MADENLER MAH.,405,374,371,154,217
UMRANIYE,MADENLER MAH.,405,363,358,173,185
UMRANIYE,MADENLER MAH.,405,383,381,181,200
UMRANIYE,MADENLER MAH.,405,371,364,182,182
UMRANIYE,MADENLER MAH.,405,357,356,160,196
UMRANIYE,MADENLER MAH.,405,365,359,179,180
UMRANIYE,MADENLER MAH.,405,371,366,165,201
UMRANIYE,MADENLER MAH.,405,370,366,163,203
UMRANIYE,MADENLER MAH.,405,373,370,179,191
UMRANIYE,MADENLER MAH.,405,362,361,174,187
UMRANIYE,MADENLER MAH.,405,369,361,180,181
UMRANIYE,MADENLER MAH.,406,373,366,182,184
UMRANIYE,MADENLER MAH.,407,382,373,183,190
UMRANIYE,MADENLER MAH.,405,377,365,168,197
UMRANIYE,MADENLER MAH.,405,356,345,147,198
UMRANIYE,MADENLER MAH.,405,368,364,171,193
UMRANIYE,MADENLER MAH.,405,369,365,164,201
UMRANIYE,MADENLER MAH.,405,379,377,152,225
UMRANIYE,MADENLER MAH.,407,368,356,175,181
UMRANIYE,MEHMET AKIF MAH.,408,344,339,145,194
UMRANIYE,MEHMET AKIF MAH.,410,334,328,140,188
UMRANIYE,MEHMET AKIF MAH.,408,359,350,158,192
UMRANIYE,MEHMET AKIF MAH.,408,383,378,170,208
UMRANIYE,MEHMET AKIF MAH.,409,381,376,174,202
UMRANIYE,MEHMET AKIF MAH.,408,381,380,179,201
UMRANIYE,MEHMET AKIF MAH.,408,369,367,147,220
UMRANIYE,MEHMET AKIF MAH.,408,363,358,168,190
UMRANIYE,MEHMET AKIF MAH.,408,378,374,158,216
UMRANIYE,MEHMET AKIF MAH.,408,372,368,141,227
UMRANIYE,MEHMET AKIF MAH.,408,371,369,165,204
UMRANIYE,MEHMET AKIF MAH.,407,382,379,171,208
UMRANIYE,MEHMET AKIF MAH.,407,388,383,158,225
UMRANIYE,MEHMET AKIF MAH.,408,377,375,179,196
UMRANIYE,MEHMET AKIF MAH.,408,364,363,136,227
UMRANIYE,MEHMET AKIF MAH.,408,382,375,139,236
UMRANIYE,MEHMET AKIF MAH.,408,363,360,142,218
UMRANIYE,MEHMET AKIF MAH.,408,352,351,154,197
UMRANIYE,MEHMET AKIF MAH.,407,366,359,159,200
UMRANIYE,MEHMET AKIF MAH.,408,379,375,171,204
UMRANIYE,MEHMET AKIF MAH.,408,384,374,162,212
UMRANIYE,MEHMET AKIF MAH.,408,373,371,143,228
UMRANIYE,MEHMET AKIF MAH.,408,366,362,177,185
UMRANIYE,MEHMET AKIF MAH.,408,374,370,142,228
UMRANIYE,MEHMET AKIF MAH.,407,371,366,151,215
UMRANIYE,MEHMET AKIF MAH.,408,377,373,171,202
UMRANIYE,MEHMET AKIF MAH.,407,365,362,158,204
UMRANIYE,MEHMET AKIF MAH.,408,365,361,146,215
UMRANIYE,MEHMET AKIF MAH.,408,384,378,152,226
UMRANIYE,MEHMET AKIF MAH.,408,372,367,162,205
UMRANIYE,MEHMET AKIF MAH.,407,368,362,136,226
UMRANIYE,MEHMET AKIF MAH.,407,371,367,168,199
UMRANIYE,MEHMET AKIF MAH.,408,375,372,157,215
UMRANIYE,MEHMET AKIF MAH.,408,370,365,142,223
UMRANIYE,MEHMET AKIF MAH.,408,360,359,173,186
UMRANIYE,MEHMET AKIF MAH.,407,374,369,166,203
UMRANIYE,MEHMET AKIF MAH.,408,375,366,164,202
UMRANIYE,MEHMET AKIF MAH.,409,369,364,164,200
UMRANIYE,MEHMET AKIF MAH.,408,373,369,162,207
UMRANIYE,MEHMET AKIF MAH.,407,370,369,160,209
UMRANIYE,MEHMET AKIF MAH.,407,373,368,184,184
UMRANIYE,MEHMET AKIF MAH.,408,389,383,167,216
UMRANIYE,NECIP FAZIL MAH.,408,338,327,170,157
UMRANIYE,NECIP FAZIL MAH.,409,352,347,215,132
UMRANIYE,NECIP FAZIL MAH.,408,384,379,203,176
UMRANIYE,NECIP FAZIL MAH.,415,376,362,219,143
UMRANIYE,NECIP FAZIL MAH.,409,369,358,209,149
UMRANIYE,NECIP FAZIL MAH.,409,377,369,186,183
UMRANIYE,NECIP FAZIL MAH.,409,371,368,199,169
UMRANIYE,NECIP FAZIL MAH.,408,365,358,187,171
UMRANIYE,NECIP FAZIL MAH.,408,369,363,212,151
UMRANIYE,NECIP FAZIL MAH.,408,362,358,197,161
UMRANIYE,NECIP FAZIL MAH.,409,375,371,206,165
UMRANIYE,NECIP FAZIL MAH.,409,366,363,218,145
UMRANIYE,NECIP FAZIL MAH.,409,365,363,214,149
UMRANIYE,NECIP FAZIL MAH.,409,388,386,209,177
UMRANIYE,NECIP FAZIL MAH.,409,377,372,233,139
UMRANIYE,NECIP FAZIL MAH.,409,374,372,204,168
UMRANIYE,NECIP FAZIL MAH.,409,365,358,196,162
UMRANIYE,NECIP FAZIL MAH.,409,364,362,222,140
UMRANIYE,NECIP FAZIL MAH.,409,375,371,193,178
UMRANIYE,NECIP FAZIL MAH.,409,377,370,189,181
UMRANIYE,NECIP FAZIL MAH.,409,367,364,187,177
UMRANIYE,NECIP FAZIL MAH.,409,369,364,212,152
UMRANIYE,NECIP FAZIL MAH.,409,366,366,202,164
UMRANIYE,NECIP FAZIL MAH.,409,362,357,233,124
UMRANIYE,NECIP FAZIL MAH.,410,375,372,214,158
UMRANIYE,NECIP FAZIL MAH.,409,377,375,223,152
UMRANIYE,NECIP FAZIL MAH.,409,364,357,216,141
UMRANIYE,NECIP FAZIL MAH.,409,364,362,204,158
UMRANIYE,NECIP FAZIL MAH.,399,339,335,187,148
UMRANIYE,NECIP FAZIL MAH.,398,350,341,168,173
UMRANIYE,NECIP FAZIL MAH.,400,344,341,168,173
UMRANIYE,NECIP FAZIL MAH.,402,365,362,181,181
UMRANIYE,NECIP FAZIL MAH.,400,358,356,194,162
UMRANIYE,NECIP FAZIL MAH.,399,372,365,160,205
UMRANIYE,NECIP FAZIL MAH.,400,362,354,153,201
UMRANIYE,NECIP FAZIL MAH.,400,372,368,183,185
UMRANIYE,NECIP FAZIL MAH.,399,367,364,180,184
UMRANIYE,NECIP FAZIL MAH.,400,357,353,200,153
UMRANIYE,NECIP FAZIL MAH.,398,357,351,180,171
UMRANIYE,NECIP FAZIL MAH.,400,355,354,182,172
UMRANIYE,NECIP FAZIL MAH.,399,364,361,188,173
UMRANIYE,NECIP FAZIL MAH.,400,358,354,157,197
UMRANIYE,NECIP FAZIL MAH.,399,353,350,173,177
UMRANIYE,NECIP FAZIL MAH.,400,365,358,200,158
UMRANIYE,NECIP FAZIL MAH.,400,362,359,185,174
UMRANIYE,PARSELLER MAH.,402,338,329,164,165
UMRANIYE,PARSELLER MAH.,403,347,342,163,179
UMRANIYE,PARSELLER MAH.,402,371,363,186,177
UMRANIYE,PARSELLER MAH.,402,377,374,191,183
UMRANIYE,PARSELLER MAH.,402,377,371,210,161
UMRANIYE,PARSELLER MAH.,403,369,366,191,175
UMRANIYE,PARSELLER MAH.,402,368,365,191,174
UMRANIYE,PARSELLER MAH.,402,368,361,193,168
UMRANIYE,PARSELLER MAH.,402,373,359,155,204
UMRANIYE,PARSELLER MAH.,402,373,366,183,183
UMRANIYE,PARSELLER MAH.,402,356,350,160,190
UMRANIYE,PARSELLER MAH.,405,376,373,198,175
UMRANIYE,PARSELLER MAH.,402,369,359,182,177
UMRANIYE,PARSELLER MAH.,401,362,359,183,176
UMRANIYE,PARSELLER MAH.,401,368,365,167,198
UMRANIYE,PARSELLER MAH.,402,365,363,173,190
UMRANIYE,PARSELLER MAH.,402,374,372,202,170
UMRANIYE,PARSELLER MAH.,403,373,371,195,176
UMRANIYE,PARSELLER MAH.,401,373,368,185,183
UMRANIYE,PARSELLER MAH.,401,358,354,198,156
UMRANIYE,PARSELLER MAH.,405,366,362,196,166
UMRANIYE,PARSELLER MAH.,401,356,352,170,182
UMRANIYE,PARSELLER MAH.,401,370,364,193,171
UMRANIYE,PARSELLER MAH.,401,379,373,175,198
UMRANIYE,PARSELLER MAH.,402,369,362,211,151
UMRANIYE,PARSELLER MAH.,404,382,378,223,155
UMRANIYE,SERIFALI MAH.,394,334,330,133,197
UMRANIYE,SERIFALI MAH.,390,348,342,119,223
UMRANIYE,SERIFALI MAH.,390,346,341,118,223
UMRANIYE,SERIFALI MAH.,389,346,344,123,221
UMRANIYE,SERIFALI MAH.,390,361,354,120,234
UMRANIYE,SERIFALI MAH.,389,357,349,120,229
UMRANIYE,SERIFALI MAH.,390,358,353,97,256
UMRANIYE,SERIFALI MAH.,390,348,342,107,235
UMRANIYE,SERIFALI MAH.,390,359,357,123,234
UMRANIYE,SERIFALI MAH.,389,363,359,138,221
UMRANIYE,SERIFALI MAH.,390,359,354,132,222
UMRANIYE,SERIFALI MAH.,390,361,358,137,221
UMRANIYE,SERIFALI MAH.,390,353,350,111,239
UMRANIYE,SERIFALI MAH.,389,354,349,135,214
UMRANIYE,SERIFALI MAH.,390,345,338,136,202
UMRANIYE,TATLISU MAH.,412,365,357,131,226
UMRANIYE,TATLISU MAH.,411,347,341,94,247
UMRANIYE,TATLISU MAH.,412,391,384,103,281
UMRANIYE,TATLISU MAH.,412,384,382,103,279
UMRANIYE,TATLISU MAH.,412,395,392,115,277
UMRANIYE,TATLISU MAH.,412,391,387,112,275
UMRANIYE,TATLISU MAH.,415,377,371,110,261
UMRANIYE,TATLISU MAH.,412,393,390,104,286
UMRANIYE,TATLISU MAH.,412,382,377,101,276
UMRANIYE,TATLISU MAH.,415,387,383,121,262
UMRANIYE,TATLISU MAH.,411,377,375,91,284
UMRANIYE,TATLISU MAH.,415,384,381,94,287
UMRANIYE,TATLISU MAH.,415,385,380,122,258
UMRANIYE,TATLISU MAH.,412,385,381,105,276
UMRANIYE,TATLISU MAH.,412,384,379,108,271
UMRANIYE,TATLISU MAH.,412,388,384,129,255
UMRANIYE,TATLISU MAH.,412,384,382,107,275
UMRANIYE,TATLISU MAH.,412,374,372,110,262
UMRANIYE,TATLISU MAH.,415,375,372,96,276
UMRANIYE,TATLISU MAH.,415,392,386,109,277
UMRANIYE,TATLISU MAH.,411,367,360,91,269
UMRANIYE,TATLISU MAH.,412,380,376,112,264
UMRANIYE,TATLISU MAH.,412,378,373,109,264
UMRANIYE,TATLISU MAH.,411,355,353,97,256
UMRANIYE,TATLISU MAH.,413,377,371,108,263
UMRANIYE,TATLISU MAH.,411,378,369,97,272
UMRANIYE,TATLISU MAH.,412,395,394,96,298
UMRANIYE,TATLISU MAH.,413,376,372,111,261
UMRANIYE,TATLISU MAH.,413,368,363,111,252
UMRANIYE,TATLISU MAH.,412,375,375,120,255
UMRANIYE,TATLISU MAH.,411,376,371,108,263
UMRANIYE,TATLISU MAH.,412,412,368,107,261
UMRANIYE,TATLISU MAH.,413,385,378,102,276
UMRANIYE,TATLISU MAH.,413,373,370,110,260
UMRANIYE,TATLISU MAH.,415,396,394,110,284
UMRANIYE,YUKARI DUDULLU MAH.,392,325,320,224,96
UMRANIYE,YUKARI DUDULLU MAH.,393,332,328,204,124
UMRANIYE,YUKARI DUDULLU MAH.,392,343,335,200,135
UMRANIYE,YUKARI DUDULLU MAH.,393,332,327,212,115
UMRANIYE,YUKARI DUDULLU MAH.,393,340,336,218,118
UMRANIYE,YUKARI DUDULLU MAH.,394,351,345,228,117
UMRANIYE,YUKARI DUDULLU MAH.,394,338,333,212,121
UMRANIYE,YUKARI DUDULLU MAH.,395,345,339,217,122
UMRANIYE,YUKARI DUDULLU MAH.,393,330,322,205,117
UMRANIYE,YUKARI DUDULLU MAH.,393,340,337,227,110
UMRANIYE,YUKARI DUDULLU MAH.,395,346,339,236,103
UMRANIYE,YUKARI DUDULLU MAH.,392,355,349,251,98
UMRANIYE,YUKARI DUDULLU MAH.,393,342,340,229,111
UMRANIYE,YUKARI DUDULLU MAH.,397,341,338,230,108
UMRANIYE,YUKARI DUDULLU MAH.,393,333,329,233,96
UMRANIYE,YUKARI DUDULLU MAH.,393,344,336,252,84
UMRANIYE,YUKARI DUDULLU MAH.,409,332,321,236,85
UMRANIYE,YUKARI DUDULLU MAH.,410,352,347,265,82
UMRANIYE,YUKARI DUDULLU MAH.,409,362,358,248,110
UMRANIYE,YUKARI DUDULLU MAH.,409,376,371,272,99
UMRANIYE,YUKARI DUDULLU MAH.,412,388,376,271,105
UMRANIYE,YUKARI DUDULLU MAH.,408,364,362,255,107
UMRANIYE,YUKARI DUDULLU MAH.,408,380,377,256,121
UMRANIYE,YUKARI DUDULLU MAH.,408,357,353,248,105
UMRANIYE,YUKARI DUDULLU MAH.,409,357,355,261,94
UMRANIYE,YUKARI DUDULLU MAH.,409,379,374,241,133
UMRANIYE,YUKARI DUDULLU MAH.,409,372,365,260,105
UMRANIYE,YUKARI DUDULLU MAH.,409,356,351,232,119
UMRANIYE,YUKARI DUDULLU MAH.,408,365,361,235,126
UMRANIYE,YUKARI DUDULLU MAH.,409,364,359,242,117
UMRANIYE,YUKARI DUDULLU MAH.,408,377,371,261,110
UMRANIYE,YUKARI DUDULLU MAH.,409,369,364,255,109
UMRANIYE,YUKARI DUDULLU MAH.,409,377,376,274,102
UMRANIYE,YUKARI DUDULLU MAH.,408,386,382,281,101
UMRANIYE,UMRANIYE E TIPI KAPALI CEZAEVI,17,23,22,12,10
UMRANIYE,UMRANIYE T TIPI KAPALI CEZAEVI,185,189,187,73,114
BUYUKCEKMECE,AHMEDIYE MAH.,286,255,250,137,113
BUYUKCEKMECE,AHMEDIYE MAH.,288,267,254,141,113
BUYUKCEKMECE,AHMEDIYE MAH.,286,263,249,103,146
BUYUKCEKMECE,ALKENT 2000 MAH.,400,341,335,100,235
BUYUKCEKMECE,ALKENT 2000 MAH.,399,356,354,89,265
BUYUKCEKMECE,ALKENT 2000 MAH.,400,366,364,91,273
BUYUKCEKMECE,ALKENT 2000 MAH.,401,354,353,83,270
BUYUKCEKMECE,ALKENT 2000 MAH.,398,367,366,125,241
BUYUKCEKMECE,ALKENT 2000 MAH.,399,370,366,91,275
BUYUKCEKMECE,ALKENT 2000 MAH.,398,368,364,86,278
BUYUKCEKMECE,ATATURK MAH.,411,319,313,66,247
BUYUKCEKMECE,ATATURK MAH.,411,302,296,64,232
BUYUKCEKMECE,ATATURK MAH.,411,355,353,88,265
BUYUKCEKMECE,ATATURK MAH.,411,323,319,80,239
BUYUKCEKMECE,ATATURK MAH.,411,355,353,99,254
BUYUKCEKMECE,ATATURK MAH.,411,358,356,80,276
BUYUKCEKMECE,ATATURK MAH.,409,348,345,107,238
BUYUKCEKMECE,ATATURK MAH.,410,344,338,61,277
BUYUKCEKMECE,ATATURK MAH.,411,351,348,116,232
BUYUKCEKMECE,ATATURK MAH.,411,358,354,79,275
BUYUKCEKMECE,ATATURK MAH.,410,347,340,62,278
BUYUKCEKMECE,ATATURK MAH.,411,346,342,80,262
BUYUKCEKMECE,ATATURK MAH.,411,350,349,94,255
BUYUKCEKMECE,ATATURK MAH.,401,330,329,98,231
BUYUKCEKMECE,ATATURK MAH.,401,332,323,100,223
BUYUKCEKMECE,ATATURK MAH.,400,345,342,107,235
BUYUKCEKMECE,ATATURK MAH.,400,351,346,138,208
BUYUKCEKMECE,ATATURK MAH.,400,350,350,128,222
BUYUKCEKMECE,ATATURK MAH.,399,341,339,126,213
BUYUKCEKMECE,ATATURK MAH.,400,347,345,125,220
BUYUKCEKMECE,ATATURK MAH.,400,345,342,111,231
BUYUKCEKMECE,ATATURK MAH.,401,354,353,106,247
BUYUKCEKMECE,ATATURK MAH.,400,345,338,123,215
BUYUKCEKMECE,ATATURK MAH.,400,352,350,124,226
BUYUKCEKMECE,ATATURK MAH.,400,356,353,105,248
BUYUKCEKMECE,ATATURK MAH.,400,346,344,137,207
BUYUKCEKMECE,ATATURK MAH.,401,352,350,128,222
BUYUKCEKMECE,ATATURK MAH.,401,365,357,112,245
BUYUKCEKMECE,ATATURK MAH.,400,345,337,103,234
BUYUKCEKMECE,ATATURK MAH.,401,350,344,104,240
BUYUKCEKMECE,ATATURK MAH.,401,337,335,114,221
BUYUKCEKMECE,ATATURK MAH.,402,344,338,114,224
BUYUKCEKMECE,ATATURK MAH.,400,361,358,122,236
BUYUKCEKMECE,ATATURK MAH.,402,364,363,101,262
BUYUKCEKMECE,ATATURK MAH.,400,346,344,97,247
BUYUKCEKMECE,BAHCELIEVLER MAH.,400,342,338,198,140
BUYUKCEKMECE,BAHCELIEVLER MAH.,398,375,372,211,161
BUYUKCEKMECE,BAHCELIEVLER MAH.,399,355,350,218,132
BUYUKCEKMECE,BAHCELIEVLER MAH.,400,351,344,198,146
BUYUKCEKMECE,BAHCELIEVLER MAH.,399,353,348,186,162
BUYUKCEKMECE,BAHCELIEVLER MAH.,399,351,346,180,166
BUYUKCEKMECE,CELALIYE MAH.,395,319,315,100,215
BUYUKCEKMECE,CELALIYE MAH.,394,331,325,115,210
BUYUKCEKMECE,CELALIYE MAH.,394,339,336,122,214
BUYUKCEKMECE,CELALIYE MAH.,395,351,345,143,202
BUYUKCEKMECE,CELALIYE MAH.,394,341,340,129,211
BUYUKCEKMECE,CELALIYE MAH.,393,358,351,166,185
BUYUKCEKMECE,CELALIYE MAH.,393,334,333,129,204
BUYUKCEKMECE,CELALIYE MAH.,394,340,332,134,198
BUYUKCEKMECE,CELALIYE MAH.,394,348,343,136,207
BUYUKCEKMECE,CELALIYE MAH.,394,337,331,126,205
BUYUKCEKMECE,CUMHURIYET MAH.,396,329,323,109,214
BUYUKCEKMECE,CUMHURIYET MAH.,394,345,340,106,234
BUYUKCEKMECE,CUMHURIYET MAH.,395,326,324,116,208
BUYUKCEKMECE,CUMHURIYET MAH.,395,347,340,145,195
BUYUKCEKMECE,CUMHURIYET MAH.,395,352,349,139,210
BUYUKCEKMECE,CUMHURIYET MAH.,396,358,356,127,229
BUYUKCEKMECE,CUMHURIYET MAH.,398,340,337,132,205
BUYUKCEKMECE,CUMHURIYET MAH.,396,347,342,140,202
BUYUKCEKMECE,CUMHURIYET MAH.,396,359,359,154,205
BUYUKCEKMECE,CUMHURIYET MAH.,396,356,352,144,208
BUYUKCEKMECE,CUMHURIYET MAH.,397,363,358,133,225
BUYUKCEKMECE,CUMHURIYET MAH.,396,346,342,135,207
BUYUKCEKMECE,CUMHURIYET MAH.,394,372,372,121,251
BUYUKCEKMECE,CAKMAKLI MAH.,373,320,316,143,173
BUYUKCEKMECE,CAKMAKLI MAH.,373,342,338,133,205
BUYUKCEKMECE,CAKMAKLI MAH.,372,331,329,128,201
BUYUKCEKMECE,CAKMAKLI MAH.,376,332,331,130,201
BUYUKCEKMECE,CAKMAKLI MAH.,373,328,325,171,154
BUYUKCEKMECE,CAKMAKLI MAH.,373,324,320,152,168
BUYUKCEKMECE,CAKMAKLI MAH.,372,328,321,164,157
BUYUKCEKMECE,CAKMAKLI MAH.,372,344,341,196,145
BUYUKCEKMECE,CAKMAKLI MAH.,372,341,326,144,182
BUYUKCEKMECE,DIZDARIYE MAH.,396,323,321,122,199
BUYUKCEKMECE,DIZDARIYE MAH.,396,347,340,163,177
BUYUKCEKMECE,DIZDARIYE MAH.,397,356,353,165,188
BUYUKCEKMECE,DIZDARIYE MAH.,397,357,354,174,180
BUYUKCEKMECE,DIZDARIYE MAH.,397,362,347,187,160
BUYUKCEKMECE,DIZDARIYE MAH.,394,348,345,159,186
BUYUKCEKMECE,DIZDARIYE MAH.,397,348,344,191,153
BUYUKCEKMECE,DIZDARIYE MAH.,397,354,344,150,194
BUYUKCEKMECE,DIZDARIYE MAH.,397,344,332,164,168
BUYUKCEKMECE,DIZDARIYE MAH.,397,343,341,174,167
BUYUKCEKMECE,DIZDARIYE MAH.,397,356,351,162,189
BUYUKCEKMECE,DIZDARIYE MAH.,397,358,356,157,199
BUYUKCEKMECE,DIZDARIYE MAH.,396,354,351,148,203
BUYUKCEKMECE,EKINOBA MAH.,404,352,347,96,251
BUYUKCEKMECE,EKINOBA MAH.,404,356,353,99,254
BUYUKCEKMECE,EKINOBA MAH.,405,362,359,86,273
BUYUKCEKMECE,EKINOBA MAH.,407,344,340,99,241
BUYUKCEKMECE,EKINOBA MAH.,405,372,366,123,243
BUYUKCEKMECE,EKINOBA MAH.,404,353,345,109,236
BUYUKCEKMECE,EKINOBA MAH.,404,359,356,114,242
BUYUKCEKMECE,EKINOBA MAH.,389,330,327,120,207
BUYUKCEKMECE,EKINOBA MAH.,389,345,342,131,211
BUYUKCEKMECE,EKINOBA MAH.,389,347,340,143,197
BUYUKCEKMECE,EKINOBA MAH.,389,351,344,151,193
BUYUKCEKMECE,EKINOBA MAH.,389,350,344,161,183
BUYUKCEKMECE,EKINOBA MAH.,388,336,333,119,214
BUYUKCEKMECE,EKINOBA MAH.,389,329,325,127,198
BUYUKCEKMECE,EKINOBA MAH.,389,331,328,140,188
BUYUKCEKMECE,EKINOBA MAH.,389,334,326,131,195
BUYUKCEKMECE,EKINOBA MAH.,391,346,343,142,201
BUYUKCEKMECE,EKINOBA MAH.,389,353,348,137,211
BUYUKCEKMECE,EKINOBA MAH.,389,337,335,153,182
BUYUKCEKMECE,EKINOBA MAH.,388,342,332,148,184
BUYUKCEKMECE,EKINOBA MAH.,389,346,338,116,222
BUYUKCEKMECE,FATIH MAH.,415,334,330,94,236
BUYUKCEKMECE,FATIH MAH.,415,345,344,123,221
BUYUKCEKMECE,FATIH MAH.,415,359,358,95,263
BUYUKCEKMECE,FATIH MAH.,415,375,370,110,260
BUYUKCEKMECE,FATIH MAH.,415,360,358,114,244
BUYUKCEKMECE,FATIH MAH.,415,368,364,104,260
BUYUKCEKMECE,FATIH MAH.,413,368,364,122,242
BUYUKCEKMECE,FATIH MAH.,412,361,355,116,239
BUYUKCEKMECE,FATIH MAH.,413,369,367,129,238
BUYUKCEKMECE,FATIH MAH.,413,365,363,124,239
BUYUKCEKMECE,FATIH MAH.,412,358,351,119,232
BUYUKCEKMECE,FATIH MAH.,391,315,315,78,237
BUYUKCEKMECE,FATIH MAH.,392,328,322,83,239
BUYUKCEKMECE,FATIH MAH.,393,350,345,108,237
BUYUKCEKMECE,FATIH MAH.,392,335,333,90,243
BUYUKCEKMECE,FATIH MAH.,392,335,328,80,248
BUYUKCEKMECE,FATIH MAH.,392,337,333,89,244
BUYUKCEKMECE,FATIH MAH.,393,346,345,110,235
BUYUKCEKMECE,FATIH MAH.,392,338,333,98,235
BUYUKCEKMECE,FATIH MAH.,391,339,338,96,242
BUYUKCEKMECE,FATIH MAH.,391,349,345,107,238
BUYUKCEKMECE,FATIH MAH.,384,330,326,122,204
BUYUKCEKMECE,FATIH MAH.,384,351,348,152,196
BUYUKCEKMECE,FATIH MAH.,383,341,334,147,187
BUYUKCEKMECE,FATIH MAH.,382,340,334,144,190
BUYUKCEKMECE,FATIH MAH.,384,342,338,127,211
BUYUKCEKMECE,FATIH MAH.,384,345,339,123,216
BUYUKCEKMECE,FATIH MAH.,383,334,330,128,202
BUYUKCEKMECE,FATIH MAH.,383,338,331,127,204
BUYUKCEKMECE,FATIH MAH.,382,344,342,132,210
BUYUKCEKMECE,FATIH MAH.,411,345,340,69,271
BUYUKCEKMECE,FATIH MAH.,415,358,347,117,230
BUYUKCEKMECE,FATIH MAH.,411,336,332,107,225
BUYUKCEKMECE,FATIH MAH.,411,362,354,100,254
BUYUKCEKMECE,FATIH MAH.,412,359,356,120,236
BUYUKCEKMECE,FATIH MAH.,412,358,353,93,260
BUYUKCEKMECE,FATIH MAH.,411,355,350,107,243
BUYUKCEKMECE,GUZELCE MAH.,394,324,320,92,228
BUYUKCEKMECE,GUZELCE MAH.,395,333,329,82,247
BUYUKCEKMECE,GUZELCE MAH.,395,371,366,145,221
BUYUKCEKMECE,GUZELCE MAH.,394,342,340,114,226
BUYUKCEKMECE,GUZELCE MAH.,394,358,355,114,241
BUYUKCEKMECE,GUZELCE MAH.,394,354,351,114,237
BUYUKCEKMECE,GUZELCE MAH.,394,344,339,92,247
BUYUKCEKMECE,GUZELCE MAH.,394,347,339,112,227
BUYUKCEKMECE,GUZELCE MAH.,396,359,350,122,228
BUYUKCEKMECE,GUZELCE MAH.,394,356,351,104,247
BUYUKCEKMECE,GUZELCE MAH.,394,358,358,106,252
BUYUKCEKMECE,GUZELCE MAH.,394,353,347,125,222
BUYUKCEKMECE,HURRIYET MAH.,408,344,339,228,111
BUYUKCEKMECE,HURRIYET MAH.,407,360,354,226,128
BUYUKCEKMECE,HURRIYET MAH.,406,370,366,255,111
BUYUKCEKMECE,HURRIYET MAH.,407,368,365,269,96
BUYUKCEKMECE,HURRIYET MAH.,406,356,351,243,108
BUYUKCEKMECE,HURRIYET MAH.,406,360,353,238,115
BUYUKCEKMECE,HURRIYET MAH.,405,356,350,248,102
BUYUKCEKMECE,HURRIYET MAH.,407,367,363,236,127
BUYUKCEKMECE,HURRIYET MAH.,406,363,357,263,94
BUYUKCEKMECE,HURRIYET MAH.,406,368,360,253,107
BUYUKCEKMECE,HURRIYET MAH.,407,371,365,274,91
BUYUKCEKMECE,HURRIYET MAH.,406,375,371,242,129
BUYUKCEKMECE,HURRIYET MAH.,406,381,372,255,117
BUYUKCEKMECE,HURRIYET MAH.,406,371,365,271,94
BUYUKCEKMECE,HURRIYET MAH.,407,361,352,246,106
BUYUKCEKMECE,HURRIYET MAH.,406,369,362,260,102
BUYUKCEKMECE,HURRIYET MAH.,406,365,363,269,94
BUYUKCEKMECE,HURRIYET MAH.,407,377,366,240,126
BUYUKCEKMECE,HURRIYET MAH.,406,351,344,222,122
BUYUKCEKMECE,HURRIYET MAH.,406,384,375,261,114
BUYUKCEKMECE,HURRIYET MAH.,406,372,369,256,113
BUYUKCEKMECE,HURRIYET MAH.,406,374,360,232,128
BUYUKCEKMECE,HURRIYET MAH.,394,351,339,250,89
BUYUKCEKMECE,HURRIYET MAH.,393,358,350,247,103
BUYUKCEKMECE,HURRIYET MAH.,393,359,350,269,81
BUYUKCEKMECE,HURRIYET MAH.,393,357,354,287,67
BUYUKCEKMECE,HURRIYET MAH.,392,362,355,241,114
BUYUKCEKMECE,HURRIYET MAH.,393,361,354,243,111
BUYUKCEKMECE,HURRIYET MAH.,393,353,345,273,72
BUYUKCEKMECE,HURRIYET MAH.,393,355,342,257,85
BUYUKCEKMECE,HURRIYET MAH.,397,358,355,286,69
BUYUKCEKMECE,HURRIYET MAH.,392,362,360,283,77
BUYUKCEKMECE,HURRIYET MAH.,394,365,356,257,99
BUYUKCEKMECE,HURRIYET MAH.,394,365,361,277,84
BUYUKCEKMECE,KAMILOBA MAH.,389,291,287,93,194
BUYUKCEKMECE,KAMILOBA MAH.,390,327,327,116,211
BUYUKCEKMECE,KAMILOBA MAH.,389,320,311,115,196
BUYUKCEKMECE,KAMILOBA MAH.,389,334,330,122,208
BUYUKCEKMECE,KAMILOBA MAH.,388,321,317,123,194
BUYUKCEKMECE,KAMILOBA MAH.,388,329,325,119,206
BUYUKCEKMECE,KAMILOBA MAH.,388,295,293,91,202
BUYUKCEKMECE,KAMILOBA MAH.,369,292,286,97,189
BUYUKCEKMECE,KAMILOBA MAH.,369,298,295,118,177
BUYUKCEKMECE,KAMILOBA MAH.,369,293,291,105,186
BUYUKCEKMECE,KAMILOBA MAH.,369,320,319,97,222
BUYUKCEKMECE,KAMILOBA MAH.,369,297,293,117,176
BUYUKCEKMECE,KAMILOBA MAH.,367,306,299,106,193
BUYUKCEKMECE,KARAAGAC MAH.,388,343,339,163,176
BUYUKCEKMECE,KARAAGAC MAH.,387,358,348,162,186
BUYUKCEKMECE,KARAAGAC MAH.,388,350,344,159,185
BUYUKCEKMECE,KARAAGAC MAH.,389,365,361,189,172
BUYUKCEKMECE,KUMBURGAZ MAH.,378,314,309,123,186
BUYUKCEKMECE,KUMBURGAZ MAH.,377,340,336,181,155
BUYUKCEKMECE,KUMBURGAZ MAH.,376,333,328,163,165
BUYUKCEKMECE,KUMBURGAZ MAH.,376,319,316,163,153
BUYUKCEKMECE,KUMBURGAZ MAH.,376,337,330,140,190
BUYUKCEKMECE,KUMBURGAZ MAH.,375,336,329,152,177
BUYUKCEKMECE,KUMBURGAZ MAH.,375,341,333,147,186
BUYUKCEKMECE,KUMBURGAZ MAH.,364,300,296,90,206
BUYUKCEKMECE,KUMBURGAZ MAH.,364,310,306,149,157
BUYUKCEKMECE,KUMBURGAZ MAH.,363,314,310,108,202
BUYUKCEKMECE,KUMBURGAZ MAH.,363,317,315,137,178
BUYUKCEKMECE,KUMBURGAZ MAH.,364,309,306,125,181
BUYUKCEKMECE,KUMBURGAZ MAH.,364,322,319,119,200
BUYUKCEKMECE,MIMARSINAN MAH.,390,297,294,147,147
BUYUKCEKMECE,MIMARSINAN MAH.,394,346,341,182,159
BUYUKCEKMECE,MIMARSINAN MAH.,390,348,344,203,141
BUYUKCEKMECE,MIMARSINAN MAH.,390,342,335,188,147
BUYUKCEKMECE,MIMARSINAN MAH.,389,339,332,168,164
BUYUKCEKMECE,MIMARSINAN MAH.,389,344,335,186,149
BUYUKCEKMECE,MIMARSINAN MAH.,389,335,333,182,151
BUYUKCEKMECE,MIMARSINAN MAH.,390,350,344,184,160
BUYUKCEKMECE,MIMARSINAN MAH.,389,338,331,177,154
BUYUKCEKMECE,MIMARSINAN MAH.,390,340,335,182,153
BUYUKCEKMECE,MIMARSINAN MAH.,390,341,338,182,156
BUYUKCEKMECE,MIMARSINAN MAH.,389,338,334,181,153
BUYUKCEKMECE,MIMARSINAN MAH.,390,335,331,192,139
BUYUKCEKMECE,MIMARSINAN MAH.,390,353,344,166,178
BUYUKCEKMECE,MIMARSINAN MAH.,390,360,360,191,169
BUYUKCEKMECE,MIMARSINAN MAH.,390,338,334,146,188
BUYUKCEKMECE,MIMAROBA MAH.,397,350,346,88,258
BUYUKCEKMECE,MIMAROBA MAH.,398,334,329,67,262
BUYUKCEKMECE,MIMAROBA MAH.,396,354,351,99,252
BUYUKCEKMECE,MIMAROBA MAH.,396,348,342,83,259
BUYUKCEKMECE,MIMAROBA MAH.,396,351,349,89,260
BUYUKCEKMECE,MIMAROBA MAH.,395,359,356,92,264
BUYUKCEKMECE,MIMAROBA MAH.,396,364,362,95,267
BUYUKCEKMECE,MIMAROBA MAH.,395,345,335,82,253
BUYUKCEKMECE,MIMAROBA MAH.,396,369,366,100,266
BUYUKCEKMECE,MIMAROBA MAH.,395,368,363,108,255
BUYUKCEKMECE,MIMAROBA MAH.,396,359,356,95,261
BUYUKCEKMECE,MIMAROBA MAH.,395,353,349,105,244
BUYUKCEKMECE,MIMAROBA MAH.,396,365,362,126,236
BUYUKCEKMECE,MIMAROBA MAH.,395,366,363,93,270
BUYUKCEKMECE,MIMAROBA MAH.,396,341,336,123,213
BUYUKCEKMECE,MIMAROBA MAH.,395,341,339,89,250
BUYUKCEKMECE,MIMAROBA MAH.,396,372,366,110,256
BUYUKCEKMECE,MIMAROBA MAH.,396,349,336,85,251
BUYUKCEKMECE,MIMAROBA MAH.,396,359,359,103,256
BUYUKCEKMECE,MIMAROBA MAH.,406,354,347,59,288
BUYUKCEKMECE,MIMAROBA MAH.,406,354,352,84,268
BUYUKCEKMECE,MIMAROBA MAH.,407,364,362,119,243
BUYUKCEKMECE,MIMAROBA MAH.,405,369,368,106,262
BUYUKCEKMECE,MIMAROBA MAH.,409,378,377,97,280
BUYUKCEKMECE,MIMAROBA MAH.,406,361,355,120,235
BUYUKCEKMECE,MIMAROBA MAH.,405,364,361,105,256
BUYUKCEKMECE,MIMAROBA MAH.,406,375,371,98,273
BUYUKCEKMECE,MIMAROBA MAH.,405,367,363,115,248
BUYUKCEKMECE,MIMAROBA MAH.,406,372,368,130,238
BUYUKCEKMECE,MIMAROBA MAH.,405,364,358,107,251
BUYUKCEKMECE,MIMAROBA MAH.,406,359,357,100,257
BUYUKCEKMECE,MIMAROBA MAH.,406,371,363,121,242
BUYUKCEKMECE,MIMAROBA MAH.,405,360,357,112,245
BUYUKCEKMECE,MURAT CESME MAH.,384,339,332,264,68
BUYUKCEKMECE,MURAT CESME MAH.,385,342,337,256,81
BUYUKCEKMECE,MURAT CESME MAH.,383,361,353,273,80
BUYUKCEKMECE,MURAT CESME MAH.,385,353,351,263,88
BUYUKCEKMECE,MURAT CESME MAH.,386,356,354,263,91
BUYUKCEKMECE,MURAT CESME MAH.,385,354,348,282,66
BUYUKCEKMECE,MURAT CESME MAH.,386,354,353,269,84
BUYUKCEKMECE,MURAT CESME MAH.,384,347,340,266,74
BUYUKCEKMECE,MURAT CESME MAH.,383,346,343,253,90
BUYUKCEKMECE,MURAT CESME MAH.,385,336,329,246,83
BUYUKCEKMECE,MURAT CESME MAH.,385,352,346,238,108
BUYUKCEKMECE,MURAT CESME MAH.,390,330,326,183,143
BUYUKCEKMECE,MURAT CESME MAH.,390,336,332,203,129
BUYUKCEKMECE,MURAT CESME MAH.,390,359,354,224,130
BUYUKCEKMECE,MURAT CESME MAH.,391,335,332,175,157
BUYUKCEKMECE,MURAT CESME MAH.,390,345,343,189,154
BUYUKCEKMECE,MURAT CESME MAH.,390,349,348,192,156
BUYUKCEKMECE,MURAT CESME MAH.,389,334,331,182,149
BUYUKCEKMECE,MURAT CESME MAH.,390,355,347,216,131
BUYUKCEKMECE,MURAT CESME MAH.,390,363,359,219,140
BUYUKCEKMECE,MURAT CESME MAH.,390,342,339,204,135
BUYUKCEKMECE,MURAT CESME MAH.,389,359,358,215,143
BUYUKCEKMECE,MURAT CESME MAH.,391,348,345,206,139
BUYUKCEKMECE,MURAT CESME MAH.,389,332,328,216,112
BUYUKCEKMECE,MURAT CESME MAH.,389,338,332,184,148
BUYUKCEKMECE,PINARTEPE MAH.,403,324,321,112,209
BUYUKCEKMECE,PINARTEPE MAH.,401,356,355,146,209
BUYUKCEKMECE,PINARTEPE MAH.,400,345,340,118,222
BUYUKCEKMECE,PINARTEPE MAH.,400,349,346,121,225
BUYUKCEKMECE,PINARTEPE MAH.,401,361,355,136,219
BUYUKCEKMECE,PINARTEPE MAH.,401,351,345,115,230
BUYUKCEKMECE,PINARTEPE MAH.,401,355,351,123,228
BUYUKCEKMECE,PINARTEPE MAH.,404,346,344,159,185
BUYUKCEKMECE,PINARTEPE MAH.,401,351,348,116,232
BUYUKCEKMECE,PINARTEPE MAH.,401,345,345,146,199
BUYUKCEKMECE,PINARTEPE MAH.,401,361,352,133,219
BUYUKCEKMECE,PINARTEPE MAH.,401,342,341,136,205
BUYUKCEKMECE,PINARTEPE MAH.,408,322,319,149,170
BUYUKCEKMECE,PINARTEPE MAH.,408,352,345,178,167
BUYUKCEKMECE,PINARTEPE MAH.,409,349,345,168,177
BUYUKCEKMECE,PINARTEPE MAH.,408,361,357,163,194
BUYUKCEKMECE,PINARTEPE MAH.,407,329,322,129,193
BUYUKCEKMECE,PINARTEPE MAH.,407,362,358,151,207
BUYUKCEKMECE,PINARTEPE MAH.,407,355,354,160,194
BUYUKCEKMECE,PINARTEPE MAH.,409,343,339,176,163
BUYUKCEKMECE,PINARTEPE MAH.,408,352,348,150,198
BUYUKCEKMECE,PINARTEPE MAH.,407,355,350,166,184
BUYUKCEKMECE,PINARTEPE MAH.,408,359,349,184,165
BUYUKCEKMECE,PINARTEPE MAH.,408,356,350,161,189
BUYUKCEKMECE,PINARTEPE MAH.,407,337,330,149,181
BUYUKCEKMECE,PINARTEPE MAH.,407,347,344,162,182
BUYUKCEKMECE,PINARTEPE MAH.,407,368,363,181,182
BUYUKCEKMECE,PINARTEPE MAH.,408,352,347,181,166
BUYUKCEKMECE,PINARTEPE MAH.,407,353,347,142,205
BUYUKCEKMECE,SINANOBA MAH.,388,337,337,65,272
BUYUKCEKMECE,SINANOBA MAH.,389,345,339,77,262
BUYUKCEKMECE,SINANOBA MAH.,387,357,349,72,277
BUYUKCEKMECE,SINANOBA MAH.,388,335,329,71,258
BUYUKCEKMECE,SINANOBA MAH.,388,339,338,80,258
BUYUKCEKMECE,SINANOBA MAH.,388,361,358,91,267
BUYUKCEKMECE,SINANOBA MAH.,388,345,342,97,245
BUYUKCEKMECE,SINANOBA MAH.,388,356,350,89,261
BUYUKCEKMECE,SINANOBA MAH.,387,357,356,92,264
BUYUKCEKMECE,SINANOBA MAH.,388,353,349,97,252
BUYUKCEKMECE,SINANOBA MAH.,388,358,356,78,278
BUYUKCEKMECE,SINANOBA MAH.,388,342,338,71,267
BUYUKCEKMECE,SINANOBA MAH.,387,342,339,66,273
BUYUKCEKMECE,SINANOBA MAH.,388,357,355,80,275
BUYUKCEKMECE,SINANOBA MAH.,415,361,356,78,278
BUYUKCEKMECE,SINANOBA MAH.,415,382,379,75,304
BUYUKCEKMECE,SINANOBA MAH.,415,370,361,89,272
BUYUKCEKMECE,SINANOBA MAH.,412,366,359,82,277
BUYUKCEKMECE,SINANOBA MAH.,415,372,370,97,273
BUYUKCEKMECE,SINANOBA MAH.,413,377,372,103,269
BUYUKCEKMECE,SINANOBA MAH.,411,364,360,110,250
BUYUKCEKMECE,SINANOBA MAH.,413,374,371,108,263
BUYUKCEKMECE,SINANOBA MAH.,411,366,365,97,268
BUYUKCEKMECE,SINANOBA MAH.,413,366,365,95,270
BUYUKCEKMECE,SINANOBA MAH.,411,370,365,81,284
BUYUKCEKMECE,SINANOBA MAH.,412,366,361,89,272
BUYUKCEKMECE,SINANOBA MAH.,411,372,368,79,289
BUYUKCEKMECE,TURKOBA MAH.,414,363,354,205,149
BUYUKCEKMECE,TURKOBA MAH.,408,351,345,215,130
BUYUKCEKMECE,TURKOBA MAH.,410,352,345,206,139
BUYUKCEKMECE,TURKOBA MAH.,409,368,363,241,122
BUYUKCEKMECE,TURKOBA MAH.,410,376,370,236,134
BUYUKCEKMECE,TURKOBA MAH.,408,364,361,245,116
BUYUKCEKMECE,TURKOBA MAH.,410,361,353,223,130
BUYUKCEKMECE,TURKOBA MAH.,410,346,341,184,157
BUYUKCEKMECE,TURKOBA MAH.,410,354,349,217,132
BUYUKCEKMECE,TURKOBA MAH.,410,365,361,232,129
BUYUKCEKMECE,TURKOBA MAH.,415,360,355,214,141
BUYUKCEKMECE,TURKOBA MAH.,408,369,365,228,137
BUYUKCEKMECE,TURKOBA MAH.,408,366,363,224,139
BUYUKCEKMECE,TURKOBA MAH.,410,370,364,187,177
BUYUKCEKMECE,TURKOBA MAH.,409,364,358,229,129
BUYUKCEKMECE,TURKOBA MAH.,409,361,358,198,160
BUYUKCEKMECE,TURKOBA MAH.,410,362,359,216,143
BUYUKCEKMECE,TURKOBA MAH.,408,373,369,204,165
BUYUKCEKMECE,TURKOBA MAH.,408,374,367,228,139
BUYUKCEKMECE,TURKOBA MAH.,408,365,352,211,141
BUYUKCEKMECE,ULUS MAH.,403,316,311,229,82
BUYUKCEKMECE,ULUS MAH.,404,360,352,233,119
BUYUKCEKMECE,ULUS MAH.,405,364,358,212,146
BUYUKCEKMECE,ULUS MAH.,403,355,351,225,126
BUYUKCEKMECE,ULUS MAH.,403,369,365,240,125
BUYUKCEKMECE,ULUS MAH.,403,353,351,218,133
BUYUKCEKMECE,ULUS MAH.,403,350,345,220,125
BUYUKCEKMECE,ULUS MAH.,403,360,356,237,119
BUYUKCEKMECE,ULUS MAH.,403,362,360,227,133
BUYUKCEKMECE,ULUS MAH.,403,362,358,247,111
BUYUKCEKMECE,ULUS MAH.,403,354,351,215,136
BUYUKCEKMECE,ULUS MAH.,403,371,366,249,117
BUYUKCEKMECE,ULUS MAH.,402,357,348,245,103
BUYUKCEKMECE,ULUS MAH.,403,354,347,249,98
BUYUKCEKMECE,ULUS MAH.,414,336,331,245,86
BUYUKCEKMECE,ULUS MAH.,414,372,371,253,118
BUYUKCEKMECE,ULUS MAH.,414,368,368,273,95
BUYUKCEKMECE,ULUS MAH.,415,363,358,225,133
BUYUKCEKMECE,ULUS MAH.,415,370,364,257,107
BUYUKCEKMECE,ULUS MAH.,415,389,380,268,112
BUYUKCEKMECE,ULUS MAH.,414,377,372,283,89
BUYUKCEKMECE,ULUS MAH.,417,389,384,264,120
BUYUKCEKMECE,ULUS MAH.,418,381,372,272,100
BUYUKCEKMECE,ULUS MAH.,415,366,361,268,93
BUYUKCEKMECE,ULUS MAH.,415,388,377,272,105
BUYUKCEKMECE,ULUS MAH.,415,371,366,269,97
BUYUKCEKMECE,YENIMAHALLE MAH.,361,276,275,93,182
BUYUKCEKMECE,YENIMAHALLE MAH.,361,299,297,120,177
BUYUKCEKMECE,YENIMAHALLE MAH.,362,294,292,128,164
BUYUKCEKMECE,YENIMAHALLE MAH.,362,302,299,129,170
BUYUKCEKMECE,19 MAYIS MAH.,398,341,338,126,212
BUYUKCEKMECE,19 MAYIS MAH.,396,338,337,128,209
BUYUKCEKMECE,19 MAYIS MAH.,396,367,362,164,198
BUYUKCEKMECE,19 MAYIS MAH.,396,363,359,134,225
BUYUKCEKMECE,19 MAYIS MAH.,396,349,346,141,205
BUYUKCEKMECE,19 MAYIS MAH.,396,356,352,152,200
BUYUKCEKMECE,19 MAYIS MAH.,397,348,344,142,202
BUYUKCEKMECE,19 MAYIS MAH.,397,345,339,193,146
BUYUKCEKMECE,19 MAYIS MAH.,398,349,343,157,186
BUYUKCEKMECE,19 MAYIS MAH.,397,352,348,161,187
BUYUKCEKMECE,19 MAYIS MAH.,396,354,350,172,178
BUYUKCEKMECE,19 MAYIS MAH.,396,358,357,148,209
BUYUKCEKMECE,19 MAYIS MAH.,395,356,350,146,204
BUYUKCEKMECE,19 MAYIS MAH.,395,342,338,154,184
BUYUKCEKMECE,19 MAYIS MAH.,395,351,349,126,223
BUYUKCEKMECE,19 MAYIS MAH.,395,357,350,144,206
EYUPSULTAN,DEFTERDAR MAH.,388,314,310,166,144
EYUPSULTAN,DEFTERDAR MAH.,389,355,348,207,141
EYUPSULTAN,DEFTERDAR MAH.,390,344,339,222,117
EYUPSULTAN,DEFTERDAR MAH.,390,348,343,227,116
EYUPSULTAN,DEFTERDAR MAH.,390,331,328,217,111
EYUPSULTAN,DEFTERDAR MAH.,390,351,344,214,130
EYUPSULTAN,DEFTERDAR MAH.,390,340,334,211,123
EYUPSULTAN,DEFTERDAR MAH.,389,358,353,202,151
EYUPSULTAN,DEFTERDAR MAH.,390,360,355,217,138
EYUPSULTAN,DUGMECILER MAH.,354,292,289,168,121
EYUPSULTAN,DUGMECILER MAH.,354,315,311,193,118
EYUPSULTAN,DUGMECILER MAH.,355,326,326,207,119
EYUPSULTAN,DUGMECILER MAH.,357,331,329,197,132
EYUPSULTAN,DUGMECILER MAH.,355,316,311,175,136
EYUPSULTAN,DUGMECILER MAH.,409,332,329,168,161
EYUPSULTAN,DUGMECILER MAH.,411,349,340,172,168
EYUPSULTAN,DUGMECILER MAH.,415,373,369,218,151
EYUPSULTAN,DUGMECILER MAH.,410,372,368,199,169
EYUPSULTAN,DUGMECILER MAH.,409,369,360,177,183
EYUPSULTAN,DUGMECILER MAH.,410,368,364,196,168
EYUPSULTAN,DUGMECILER MAH.,410,387,382,212,170
EYUPSULTAN,DUGMECILER MAH.,410,368,365,201,164
EYUPSULTAN,DUGMECILER MAH.,409,358,353,205,148
EYUPSULTAN,DUGMECILER MAH.,410,363,357,213,144
EYUPSULTAN,DUGMECILER MAH.,410,383,371,185,186
EYUPSULTAN,DUGMECILER MAH.,409,378,370,214,156
EYUPSULTAN,DUGMECILER MAH.,400,341,335,185,150
EYUPSULTAN,DUGMECILER MAH.,400,344,336,214,122
EYUPSULTAN,DUGMECILER MAH.,399,364,362,242,120
EYUPSULTAN,DUGMECILER MAH.,400,375,371,227,144
EYUPSULTAN,DUGMECILER MAH.,400,376,376,217,159
EYUPSULTAN,DUGMECILER MAH.,399,360,356,209,147
EYUPSULTAN,DUGMECILER MAH.,401,375,374,232,142
EYUPSULTAN,DUGMECILER MAH.,399,378,370,217,153
EYUPSULTAN,DUGMECILER MAH.,399,355,352,200,152
EYUPSULTAN,DUGMECILER MAH.,399,352,349,233,116
EYUPSULTAN,DUGMECILER MAH.,400,371,369,232,137
EYUPSULTAN,DUGMECILER MAH.,400,370,362,206,156
EYUPSULTAN,DUGMECILER MAH.,400,378,373,224,149
EYUPSULTAN,DUGMECILER MAH.,366,303,295,123,172
EYUPSULTAN,DUGMECILER MAH.,366,324,316,179,137
EYUPSULTAN,DUGMECILER MAH.,368,349,343,194,149
EYUPSULTAN,DUGMECILER MAH.,367,337,333,188,145
EYUPSULTAN,DUGMECILER MAH.,368,344,339,189,150
EYUPSULTAN,DUGMECILER MAH.,367,331,325,162,163
EYUPSULTAN,EMNIYETTEPE MAH.,394,325,319,185,134
EYUPSULTAN,EMNIYETTEPE MAH.,391,338,333,168,165
EYUPSULTAN,EMNIYETTEPE MAH.,392,357,356,187,169
EYUPSULTAN,EMNIYETTEPE MAH.,392,356,353,180,173
EYUPSULTAN,EMNIYETTEPE MAH.,392,364,357,172,185
EYUPSULTAN,EMNIYETTEPE MAH.,392,355,348,209,139
EYUPSULTAN,EMNIYETTEPE MAH.,392,364,357,187,170
EYUPSULTAN,EMNIYETTEPE MAH.,392,358,354,169,185
EYUPSULTAN,EMNIYETTEPE MAH.,392,347,344,188,156
EYUPSULTAN,EMNIYETTEPE MAH.,392,351,350,186,164
EYUPSULTAN,EMNIYETTEPE MAH.,392,347,345,153,192
EYUPSULTAN,EMNIYETTEPE MAH.,392,341,336,155,181
EYUPSULTAN,EMNIYETTEPE MAH.,392,355,350,183,167
EYUPSULTAN,EMNIYETTEPE MAH.,391,352,345,174,171
EYUPSULTAN,EMNIYETTEPE MAH.,393,364,360,168,192
EYUPSULTAN,EMNIYETTEPE MAH.,392,363,358,188,170
EYUPSULTAN,ESENTEPE MAH.,415,334,328,181,147
EYUPSULTAN,ESENTEPE MAH.,415,361,359,207,152
EYUPSULTAN,ESENTEPE MAH.,415,361,358,209,149
EYUPSULTAN,ESENTEPE MAH.,415,373,365,209,156
EYUPSULTAN,ESENTEPE MAH.,414,384,382,206,176
EYUPSULTAN,ESENTEPE MAH.,415,375,371,212,159
EYUPSULTAN,ESENTEPE MAH.,411,358,352,193,159
EYUPSULTAN,ESENTEPE MAH.,413,370,358,198,160
EYUPSULTAN,ESENTEPE MAH.,400,315,312,162,150
EYUPSULTAN,ESENTEPE MAH.,402,300,296,177,119
EYUPSULTAN,ESENTEPE MAH.,401,354,342,173,169
EYUPSULTAN,ESENTEPE MAH.,399,366,358,192,166
EYUPSULTAN,ESENTEPE MAH.,400,351,346,192,154
EYUPSULTAN,ESENTEPE MAH.,399,342,336,181,155
EYUPSULTAN,ESENTEPE MAH.,399,364,354,184,170
EYUPSULTAN,ESENTEPE MAH.,400,335,334,192,142
EYUPSULTAN,ESENTEPE MAH.,399,347,340,166,174
EYUPSULTAN,ESENTEPE MAH.,399,358,356,212,144
EYUPSULTAN,ESENTEPE MAH.,399,342,340,200,140
EYUPSULTAN,ESENTEPE MAH.,400,362,354,189,165
EYUPSULTAN,ESENTEPE MAH.,400,368,363,230,133
EYUPSULTAN,ESENTEPE MAH.,399,344,339,172,167
EYUPSULTAN,ESENTEPE MAH.,400,350,347,209,138
EYUPSULTAN,ESENTEPE MAH.,400,349,347,192,155
EYUPSULTAN,ESENTEPE MAH.,400,358,354,216,138
EYUPSULTAN,ESENTEPE MAH.,399,345,342,199,143
EYUPSULTAN,ESENTEPE MAH.,400,353,344,201,143
EYUPSULTAN,ESENTEPE MAH.,400,362,356,188,168
EYUPSULTAN,ESENTEPE MAH.,400,373,367,205,162
EYUPSULTAN,ESENTEPE MAH.,400,351,346,182,164
EYUPSULTAN,ESENTEPE MAH.,399,353,347,191,156
EYUPSULTAN,ESENTEPE MAH.,401,368,363,197,166
EYUPSULTAN,ESENTEPE MAH.,400,355,351,193,158
EYUPSULTAN,ESENTEPE MAH.,400,348,344,180,164
EYUPSULTAN,GUZELTEPE MAH.,410,354,344,154,190
EYUPSULTAN,GUZELTEPE MAH.,410,376,370,144,226
EYUPSULTAN,GUZELTEPE MAH.,409,379,375,132,243
EYUPSULTAN,GUZELTEPE MAH.,410,360,355,147,208
EYUPSULTAN,GUZELTEPE MAH.,410,367,360,148,212
EYUPSULTAN,GUZELTEPE MAH.,415,385,375,157,218
EYUPSULTAN,GUZELTEPE MAH.,415,372,365,160,205
EYUPSULTAN,GUZELTEPE MAH.,411,380,374,137,237
EYUPSULTAN,GUZELTEPE MAH.,410,373,370,110,260
EYUPSULTAN,GUZELTEPE MAH.,415,348,343,89,254
EYUPSULTAN,GUZELTEPE MAH.,410,382,373,124,249
EYUPSULTAN,GUZELTEPE MAH.,411,385,378,94,284
EYUPSULTAN,GUZELTEPE MAH.,410,372,364,94,270
EYUPSULTAN,GUZELTEPE MAH.,410,375,372,113,259
EYUPSULTAN,GUZELTEPE MAH.,411,380,378,129,249
EYUPSULTAN,GUZELTEPE MAH.,412,372,370,118,252
EYUPSULTAN,GUZELTEPE MAH.,409,382,380,106,274
EYUPSULTAN,GUZELTEPE MAH.,409,381,377,110,267
EYUPSULTAN,GUZELTEPE MAH.,409,376,371,112,259
EYUPSULTAN,GUZELTEPE MAH.,410,381,376,107,269
EYUPSULTAN,GUZELTEPE MAH.,409,367,365,122,243
EYUPSULTAN,GUZELTEPE MAH.,409,376,370,105,265
EYUPSULTAN,GUZELTEPE MAH.,409,371,367,102,265
EYUPSULTAN,GUZELTEPE MAH.,410,388,386,109,277
EYUPSULTAN,GUZELTEPE MAH.,409,376,374,121,253
EYUPSULTAN,GUZELTEPE MAH.,410,381,378,107,271
EYUPSULTAN,GUZELTEPE MAH.,409,365,361,138,223
EYUPSULTAN,GUZELTEPE MAH.,409,369,363,106,257
EYUPSULTAN,GUZELTEPE MAH.,410,373,368,104,264
EYUPSULTAN,GUZELTEPE MAH.,410,376,376,105,271
EYUPSULTAN,GUZELTEPE MAH.,398,338,333,180,153
EYUPSULTAN,GUZELTEPE MAH.,397,340,334,155,179
EYUPSULTAN,GUZELTEPE MAH.,398,351,347,148,199
EYUPSULTAN,GUZELTEPE MAH.,398,354,350,178,172
EYUPSULTAN,GUZELTEPE MAH.,400,367,362,175,187
EYUPSULTAN,GUZELTEPE MAH.,398,350,347,187,160
EYUPSULTAN,GUZELTEPE MAH.,398,339,333,165,168
EYUPSULTAN,GUZELTEPE MAH.,397,359,350,158,192
EYUPSULTAN,GUZELTEPE MAH.,398,364,357,172,185
EYUPSULTAN,GUZELTEPE MAH.,398,360,354,175,179
EYUPSULTAN,GUZELTEPE MAH.,396,362,360,192,168
EYUPSULTAN,GUZELTEPE MAH.,398,362,356,182,174
EYUPSULTAN,GUZELTEPE MAH.,397,364,363,208,155
EYUPSULTAN,GUZELTEPE MAH.,397,353,352,162,190
EYUPSULTAN,GUZELTEPE MAH.,398,355,351,189,162
EYUPSULTAN,GUZELTEPE MAH.,397,363,362,203,159
EYUPSULTAN,GUZELTEPE MAH.,397,346,344,179,165
EYUPSULTAN,GUZELTEPE MAH.,397,361,358,158,200
EYUPSULTAN,GUZELTEPE MAH.,398,358,354,152,202
EYUPSULTAN,GUZELTEPE MAH.,398,359,353,191,162
EYUPSULTAN,GUZELTEPE MAH.,398,344,337,170,167
EYUPSULTAN,GUZELTEPE MAH.,397,363,359,167,192
EYUPSULTAN,GUZELTEPE MAH.,385,352,349,37,312
EYUPSULTAN,GUZELTEPE MAH.,389,357,349,35,314
EYUPSULTAN,GUZELTEPE MAH.,386,362,359,54,305
EYUPSULTAN,GUZELTEPE MAH.,386,354,349,52,297
EYUPSULTAN,GUZELTEPE MAH.,387,365,365,52,313
EYUPSULTAN,GUZELTEPE MAH.,386,356,347,47,300
EYUPSULTAN,GUZELTEPE MAH.,386,346,343,49,294
EYUPSULTAN,GUZELTEPE MAH.,387,366,358,45,313
EYUPSULTAN,GUZELTEPE MAH.,387,357,355,47,308
EYUPSULTAN,GUZELTEPE MAH.,385,353,349,48,301
EYUPSULTAN,ISLAMBEY MAH.,403,323,312,156,156
EYUPSULTAN,ISLAMBEY MAH.,403,312,305,167,138
EYUPSULTAN,ISLAMBEY MAH.,403,350,343,204,139
EYUPSULTAN,ISLAMBEY MAH.,403,348,345,200,145
EYUPSULTAN,ISLAMBEY MAH.,403,371,363,245,118
EYUPSULTAN,ISLAMBEY MAH.,402,349,343,184,159
EYUPSULTAN,ISLAMBEY MAH.,402,338,338,215,123
EYUPSULTAN,ISLAMBEY MAH.,403,360,352,212,140
EYUPSULTAN,ISLAMBEY MAH.,403,349,342,202,140
EYUPSULTAN,ISLAMBEY MAH.,403,357,349,197,152
EYUPSULTAN,ISLAMBEY MAH.,403,349,344,180,164
EYUPSULTAN,ISLAMBEY MAH.,403,340,338,161,177
EYUPSULTAN,ISLAMBEY MAH.,402,360,356,194,162
EYUPSULTAN,ISLAMBEY MAH.,402,348,345,194,151
EYUPSULTAN,ISLAMBEY MAH.,403,365,361,200,161
EYUPSULTAN,ISLAMBEY MAH.,403,350,349,212,137
EYUPSULTAN,ISLAMBEY MAH.,415,325,322,152,170
EYUPSULTAN,ISLAMBEY MAH.,415,327,322,143,179
EYUPSULTAN,ISLAMBEY MAH.,415,369,361,192,169
EYUPSULTAN,ISLAMBEY MAH.,412,360,354,183,171
EYUPSULTAN,ISLAMBEY MAH.,415,361,357,184,173
EYUPSULTAN,ISLAMBEY MAH.,413,368,362,195,167
EYUPSULTAN,ISLAMBEY MAH.,413,356,352,186,166
EYUPSULTAN,ISLAMBEY MAH.,412,351,343,188,155
EYUPSULTAN,ISLAMBEY MAH.,415,365,362,174,188
EYUPSULTAN,ISLAMBEY MAH.,412,376,366,172,194
EYUPSULTAN,ISLAMBEY MAH.,412,363,361,180,181
EYUPSULTAN,ISLAMBEY MAH.,412,365,361,202,159
EYUPSULTAN,MERKEZ MAH.,378,305,301,173,128
EYUPSULTAN,MERKEZ MAH.,377,341,335,222,113
EYUPSULTAN,MERKEZ MAH.,378,343,341,214,127
EYUPSULTAN,MERKEZ MAH.,378,345,340,218,122
EYUPSULTAN,MERKEZ MAH.,376,313,311,202,109
EYUPSULTAN,MERKEZ MAH.,378,335,331,211,120
EYUPSULTAN,MERKEZ MAH.,407,315,305,193,112
EYUPSULTAN,MERKEZ MAH.,406,363,359,220,139
EYUPSULTAN,MERKEZ MAH.,406,368,358,238,120
EYUPSULTAN,MERKEZ MAH.,405,362,355,221,134
EYUPSULTAN,MERKEZ MAH.,406,338,332,210,122
EYUPSULTAN,MERKEZ MAH.,405,357,353,225,128
EYUPSULTAN,MERKEZ MAH.,405,355,355,223,132
EYUPSULTAN,MERKEZ MAH.,406,355,350,225,125
EYUPSULTAN,MERKEZ MAH.,405,360,355,209,146
EYUPSULTAN,MERKEZ MAH.,406,356,347,228,119
EYUPSULTAN,MERKEZ MAH.,406,358,352,206,146
EYUPSULTAN,MERKEZ MAH.,314,267,264,134,130
EYUPSULTAN,MERKEZ MAH.,313,268,261,144,117
EYUPSULTAN,MERKEZ MAH.,314,275,271,162,109
EYUPSULTAN,MERKEZ MAH.,314,270,266,175,91
EYUPSULTAN,NISANCI MAH.,401,335,329,206,123
EYUPSULTAN,NISANCI MAH.,401,327,323,210,113
EYUPSULTAN,NISANCI MAH.,403,366,365,215,150
EYUPSULTAN,NISANCI MAH.,404,352,346,208,138
EYUPSULTAN,NISANCI MAH.,400,338,332,213,119
EYUPSULTAN,NISANCI MAH.,401,359,350,216,134
EYUPSULTAN,NISANCI MAH.,402,356,352,251,101
EYUPSULTAN,NISANCI MAH.,402,360,356,221,135
EYUPSULTAN,NISANCI MAH.,400,348,341,223,118
EYUPSULTAN,NISANCI MAH.,401,348,340,192,148
EYUPSULTAN,NISANCI MAH.,400,356,355,223,132
EYUPSULTAN,NISANCI MAH.,401,352,349,205,144
EYUPSULTAN,NISANCI MAH.,403,371,365,237,128
EYUPSULTAN,NISANCI MAH.,401,350,347,238,109
EYUPSULTAN,NISANCI MAH.,400,365,358,224,134
EYUPSULTAN,NISANCI MAH.,401,369,364,249,115
EYUPSULTAN,NISANCI MAH.,401,316,307,167,140
EYUPSULTAN,NISANCI MAH.,402,352,344,196,148
EYUPSULTAN,NISANCI MAH.,399,370,364,195,169
EYUPSULTAN,NISANCI MAH.,400,354,345,181,164
EYUPSULTAN,NISANCI MAH.,400,360,355,227,128
EYUPSULTAN,NISANCI MAH.,401,356,353,176,177
EYUPSULTAN,NISANCI MAH.,401,363,358,219,139
EYUPSULTAN,NISANCI MAH.,401,352,349,183,166
EYUPSULTAN,NISANCI MAH.,379,296,289,176,113
EYUPSULTAN,NISANCI MAH.,378,352,349,199,150
EYUPSULTAN,NISANCI MAH.,378,322,314,203,111
EYUPSULTAN,NISANCI MAH.,377,339,337,217,120
EYUPSULTAN,NISANCI MAH.,378,338,336,215,121
EYUPSULTAN,NISANCI MAH.,378,350,342,219,123
EYUPSULTAN,NISANCI MAH.,379,334,329,199,130
EYUPSULTAN,NISANCI MAH.,379,352,349,228,121
EYUPSULTAN,RAMI CUMA MAH.,366,304,300,128,172
EYUPSULTAN,RAMI CUMA MAH.,367,323,321,150,171
EYUPSULTAN,RAMI CUMA MAH.,367,338,330,149,181
EYUPSULTAN,RAMI CUMA MAH.,367,344,344,168,176
EYUPSULTAN,RAMI CUMA MAH.,367,350,349,149,200
EYUPSULTAN,RAMI CUMA MAH.,370,348,339,159,180
EYUPSULTAN,RAMI CUMA MAH.,367,340,338,138,200
EYUPSULTAN,RAMI CUMA MAH.,366,332,330,139,191
EYUPSULTAN,RAMI CUMA MAH.,390,312,302,129,173
EYUPSULTAN,RAMI CUMA MAH.,388,343,335,165,170
EYUPSULTAN,RAMI CUMA MAH.,390,335,331,169,162
EYUPSULTAN,RAMI CUMA MAH.,389,349,342,180,162
EYUPSULTAN,RAMI CUMA MAH.,391,357,353,167,186
EYUPSULTAN,RAMI CUMA MAH.,388,355,348,152,196
EYUPSULTAN,RAMI CUMA MAH.,388,354,351,165,186
EYUPSULTAN,RAMI CUMA MAH.,389,352,347,152,195
EYUPSULTAN,RAMI CUMA MAH.,388,343,338,145,193
EYUPSULTAN,RAMI CUMA MAH.,389,362,360,187,173
EYUPSULTAN,RAMI CUMA MAH.,389,352,348,174,174
EYUPSULTAN,RAMI CUMA MAH.,389,343,341,162,179
EYUPSULTAN,RAMI CUMA MAH.,388,355,354,166,188
EYUPSULTAN,RAMI CUMA MAH.,376,317,311,128,183
EYUPSULTAN,RAMI CUMA MAH.,376,340,335,151,184
EYUPSULTAN,RAMI CUMA MAH.,376,347,338,159,179
EYUPSULTAN,RAMI CUMA MAH.,379,350,347,157,190
EYUPSULTAN,RAMI CUMA MAH.,376,346,339,124,215
EYUPSULTAN,RAMI CUMA MAH.,378,337,335,154,181
EYUPSULTAN,RAMI CUMA MAH.,375,336,331,148,183
EYUPSULTAN,RAMI CUMA MAH.,375,347,340,139,201
EYUPSULTAN,RAMI YENI MAH.,400,324,318,147,171
EYUPSULTAN,RAMI YENI MAH.,400,337,333,145,188
EYUPSULTAN,RAMI YENI MAH.,400,370,369,176,193
EYUPSULTAN,RAMI YENI MAH.,402,377,374,179,195
EYUPSULTAN,RAMI YENI MAH.,400,372,363,170,193
EYUPSULTAN,RAMI YENI MAH.,399,362,355,178,177
EYUPSULTAN,RAMI YENI MAH.,400,359,357,170,187
EYUPSULTAN,RAMI YENI MAH.,399,366,362,190,172
EYUPSULTAN,RAMI YENI MAH.,400,353,352,162,190
EYUPSULTAN,RAMI YENI MAH.,400,351,348,170,178
EYUPSULTAN,RAMI YENI MAH.,400,362,359,177,182
EYUPSULTAN,RAMI YENI MAH.,400,363,361,166,195
EYUPSULTAN,RAMI YENI MAH.,401,362,357,187,170
EYUPSULTAN,RAMI YENI MAH.,400,350,346,160,186
EYUPSULTAN,RAMI YENI MAH.,400,365,363,193,170
EYUPSULTAN,RAMI YENI MAH.,415,332,327,122,205
EYUPSULTAN,RAMI YENI MAH.,416,356,349,154,195
EYUPSULTAN,RAMI YENI MAH.,415,374,368,185,183
EYUPSULTAN,RAMI YENI MAH.,416,375,374,155,219
EYUPSULTAN,RAMI YENI MAH.,415,377,375,174,201
EYUPSULTAN,RAMI YENI MAH.,415,371,360,154,206
EYUPSULTAN,RAMI YENI MAH.,416,388,381,161,220
EYUPSULTAN,RAMI YENI MAH.,419,380,373,170,203
EYUPSULTAN,RAMI YENI MAH.,415,376,370,178,192
EYUPSULTAN,RAMI YENI MAH.,415,362,357,151,206
EYUPSULTAN,RAMI YENI MAH.,416,371,366,177,189
EYUPSULTAN,SAKARYA MAH.,404,311,307,147,160
EYUPSULTAN,SAKARYA MAH.,406,331,324,148,176
EYUPSULTAN,SAKARYA MAH.,405,348,344,174,170
EYUPSULTAN,SAKARYA MAH.,404,358,355,195,160
EYUPSULTAN,SAKARYA MAH.,405,360,359,205,154
EYUPSULTAN,SAKARYA MAH.,405,344,341,197,144
EYUPSULTAN,SAKARYA MAH.,404,363,351,199,152
EYUPSULTAN,SAKARYA MAH.,405,352,351,174,177
EYUPSULTAN,SAKARYA MAH.,404,353,347,191,156
EYUPSULTAN,SAKARYA MAH.,405,354,344,176,168
EYUPSULTAN,SAKARYA MAH.,406,362,355,176,179
EYUPSULTAN,SAKARYA MAH.,405,371,369,191,178
EYUPSULTAN,SAKARYA MAH.,405,358,349,198,151
EYUPSULTAN,SAKARYA MAH.,404,365,356,174,182
EYUPSULTAN,SAKARYA MAH.,404,353,345,179,166
EYUPSULTAN,SAKARYA MAH.,405,352,349,190,159
EYUPSULTAN,SAKARYA MAH.,405,362,356,199,157
EYUPSULTAN,SAKARYA MAH.,404,346,345,216,129
EYUPSULTAN,SILAHTARAGA MAH.,411,340,331,188,143
EYUPSULTAN,SILAHTARAGA MAH.,411,360,351,164,187
EYUPSULTAN,SILAHTARAGA MAH.,411,382,376,218,158
EYUPSULTAN,SILAHTARAGA MAH.,412,372,369,210,159
EYUPSULTAN,SILAHTARAGA MAH.,411,353,347,173,174
EYUPSULTAN,SILAHTARAGA MAH.,412,362,359,205,154
EYUPSULTAN,SILAHTARAGA MAH.,400,311,303,201,102
EYUPSULTAN,SILAHTARAGA MAH.,399,334,332,199,133
EYUPSULTAN,SILAHTARAGA MAH.,399,353,346,228,118
EYUPSULTAN,SILAHTARAGA MAH.,399,339,337,208,129
EYUPSULTAN,SILAHTARAGA MAH.,399,361,351,209,142
EYUPSULTAN,SILAHTARAGA MAH.,398,356,351,204,147
EYUPSULTAN,SILAHTARAGA MAH.,399,355,349,203,146
EYUPSULTAN,SILAHTARAGA MAH.,399,354,350,225,125
EYUPSULTAN,SILAHTARAGA MAH.,398,350,348,230,118
EYUPSULTAN,SILAHTARAGA MAH.,399,358,354,227,127
EYUPSULTAN,SILAHTARAGA MAH.,399,357,349,217,132
EYUPSULTAN,TOPCULAR MAH.,387,304,298,151,147
EYUPSULTAN,TOPCULAR MAH.,386,333,330,171,159
EYUPSULTAN,TOPCULAR MAH.,386,354,349,178,171
EYUPSULTAN,TOPCULAR MAH.,386,344,334,183,151
EYUPSULTAN,TOPCULAR MAH.,388,347,342,170,172
EYUPSULTAN,TOPCULAR MAH.,386,344,335,172,163
EYUPSULTAN,TOPCULAR MAH.,385,357,351,201,150
EYUPSULTAN,TOPCULAR MAH.,385,353,347,180,167
EYUPSULTAN,TOPCULAR MAH.,385,341,337,187,150
EYUPSULTAN,AGACLI MAH.,224,198,194,112,82
EYUPSULTAN,AGACLI MAH.,117,111,110,43,67
EYUPSULTAN,AKPINAR MAH.,305,275,271,107,164
EYUPSULTAN,AKPINAR MAH.,307,288,282,138,144
EYUPSULTAN,AKPINAR MAH.,307,249,241,131,110
EYUPSULTAN,AKSEMSETTIN MAH.,396,330,318,115,203
EYUPSULTAN,AKSEMSETTIN MAH.,395,343,339,125,214
EYUPSULTAN,AKSEMSETTIN MAH.,394,348,343,110,233
EYUPSULTAN,AKSEMSETTIN MAH.,395,347,343,116,227
EYUPSULTAN,AKSEMSETTIN MAH.,395,354,351,119,232
EYUPSULTAN,AKSEMSETTIN MAH.,395,338,334,127,207
EYUPSULTAN,AKSEMSETTIN MAH.,395,349,347,132,215
EYUPSULTAN,AKSEMSETTIN MAH.,396,356,350,148,202
EYUPSULTAN,AKSEMSETTIN MAH.,399,364,357,120,237
EYUPSULTAN,AKSEMSETTIN MAH.,396,355,350,127,223
EYUPSULTAN,AKSEMSETTIN MAH.,396,366,365,145,220
EYUPSULTAN,AKSEMSETTIN MAH.,395,363,361,150,211
EYUPSULTAN,AKSEMSETTIN MAH.,397,354,350,142,208
EYUPSULTAN,AKSEMSETTIN MAH.,396,345,340,130,210
EYUPSULTAN,AKSEMSETTIN MAH.,396,352,348,134,214
EYUPSULTAN,AKSEMSETTIN MAH.,396,365,358,134,224
EYUPSULTAN,AKSEMSETTIN MAH.,397,361,356,141,215
EYUPSULTAN,AKSEMSETTIN MAH.,396,361,355,139,216
EYUPSULTAN,AKSEMSETTIN MAH.,396,365,358,146,212
EYUPSULTAN,AKSEMSETTIN MAH.,396,360,358,133,225
EYUPSULTAN,AKSEMSETTIN MAH.,398,336,328,120,208
EYUPSULTAN,AKSEMSETTIN MAH.,398,333,326,134,192
EYUPSULTAN,AKSEMSETTIN MAH.,398,369,363,138,225
EYUPSULTAN,AKSEMSETTIN MAH.,398,344,339,136,203
EYUPSULTAN,AKSEMSETTIN MAH.,397,346,342,147,195
EYUPSULTAN,AKSEMSETTIN MAH.,398,365,360,132,228
EYUPSULTAN,AKSEMSETTIN MAH.,398,362,359,134,225
EYUPSULTAN,AKSEMSETTIN MAH.,397,353,346,159,187
EYUPSULTAN,AKSEMSETTIN MAH.,398,367,363,141,222
EYUPSULTAN,AKSEMSETTIN MAH.,396,354,347,147,200
EYUPSULTAN,AKSEMSETTIN MAH.,398,355,352,131,221
EYUPSULTAN,AKSEMSETTIN MAH.,396,348,341,149,192
EYUPSULTAN,AKSEMSETTIN MAH.,397,359,355,144,211
EYUPSULTAN,AKSEMSETTIN MAH.,397,358,354,135,219
EYUPSULTAN,AKSEMSETTIN MAH.,397,372,369,149,220
EYUPSULTAN,AKSEMSETTIN MAH.,398,368,360,138,222
EYUPSULTAN,AKSEMSETTIN MAH.,399,366,359,159,200
EYUPSULTAN,AKSEMSETTIN MAH.,409,336,330,147,183
EYUPSULTAN,AKSEMSETTIN MAH.,409,346,334,161,173
EYUPSULTAN,AKSEMSETTIN MAH.,409,344,336,178,158
EYUPSULTAN,AKSEMSETTIN MAH.,409,377,372,187,185
EYUPSULTAN,AKSEMSETTIN MAH.,409,375,368,202,166
EYUPSULTAN,AKSEMSETTIN MAH.,409,369,366,154,212
EYUPSULTAN,AKSEMSETTIN MAH.,409,382,379,151,228
EYUPSULTAN,AKSEMSETTIN MAH.,409,372,370,157,213
EYUPSULTAN,AKSEMSETTIN MAH.,409,375,369,156,213
EYUPSULTAN,AKSEMSETTIN MAH.,410,379,376,172,204
EYUPSULTAN,AKSEMSETTIN MAH.,408,382,377,187,190
EYUPSULTAN,AKSEMSETTIN MAH.,408,363,357,176,181
EYUPSULTAN,AKSEMSETTIN MAH.,408,365,364,173,191
EYUPSULTAN,AKSEMSETTIN MAH.,409,390,388,182,206
EYUPSULTAN,AKSEMSETTIN MAH.,408,364,358,188,170
EYUPSULTAN,AKSEMSETTIN MAH.,409,368,359,183,176
EYUPSULTAN,AKSEMSETTIN MAH.,408,372,367,169,198
EYUPSULTAN,AKSEMSETTIN MAH.,409,379,370,183,187
EYUPSULTAN,AKSEMSETTIN MAH.,408,375,369,157,212
EYUPSULTAN,AKSEMSETTIN MAH.,408,383,378,173,205
EYUPSULTAN,AKSEMSETTIN MAH.,408,362,359,161,198
EYUPSULTAN,AKSEMSETTIN MAH.,408,374,366,173,193
EYUPSULTAN,AKSEMSETTIN MAH.,409,360,360,175,185
EYUPSULTAN,AKSEMSETTIN MAH.,410,368,362,175,187
EYUPSULTAN,AKSEMSETTIN MAH.,408,359,354,147,207
EYUPSULTAN,AKSEMSETTIN MAH.,409,375,371,169,202
EYUPSULTAN,AKSEMSETTIN MAH.,409,372,370,181,189
EYUPSULTAN,AKSEMSETTIN MAH.,415,380,375,191,184
EYUPSULTAN,AKSEMSETTIN MAH.,409,367,363,183,180
EYUPSULTAN,AKSEMSETTIN MAH.,408,379,376,180,196
EYUPSULTAN,AKSEMSETTIN MAH.,409,371,367,155,212
EYUPSULTAN,AKSEMSETTIN MAH.,408,360,355,165,190
EYUPSULTAN,AKSEMSETTIN MAH.,411,376,373,179,194
EYUPSULTAN,AKSEMSETTIN MAH.,408,367,365,163,202
EYUPSULTAN,AKSEMSETTIN MAH.,408,373,368,184,184
EYUPSULTAN,AKSEMSETTIN MAH.,409,376,371,167,204
EYUPSULTAN,AKSEMSETTIN MAH.,409,385,375,200,175
EYUPSULTAN,AKSEMSETTIN MAH.,408,375,371,206,165
EYUPSULTAN,ALIBEYKOY MAH.,367,284,280,145,135
EYUPSULTAN,ALIBEYKOY MAH.,369,336,331,188,143
EYUPSULTAN,ALIBEYKOY MAH.,367,331,331,204,127
EYUPSULTAN,ALIBEYKOY MAH.,366,311,303,159,144
EYUPSULTAN,ALIBEYKOY MAH.,367,331,320,190,130
EYUPSULTAN,ALIBEYKOY MAH.,366,313,310,190,120
EYUPSULTAN,ALIBEYKOY MAH.,368,330,325,176,149
EYUPSULTAN,ALIBEYKOY MAH.,366,328,326,191,135
EYUPSULTAN,ALIBEYKOY MAH.,373,295,289,154,135
EYUPSULTAN,ALIBEYKOY MAH.,375,307,300,177,123
EYUPSULTAN,ALIBEYKOY MAH.,374,335,334,172,162
EYUPSULTAN,ALIBEYKOY MAH.,373,330,327,182,145
EYUPSULTAN,ALIBEYKOY MAH.,373,318,314,185,129
EYUPSULTAN,ALIBEYKOY MAH.,374,327,321,170,151
EYUPSULTAN,ALIBEYKOY MAH.,373,302,300,152,148
EYUPSULTAN,ALIBEYKOY MAH.,373,334,332,188,144
EYUPSULTAN,ALIBEYKOY MAH.,377,343,338,193,145
EYUPSULTAN,ALIBEYKOY MAH.,373,345,338,196,142
EYUPSULTAN,CIRCIR MAH.,415,344,342,154,188
EYUPSULTAN,CIRCIR MAH.,415,365,360,194,166
EYUPSULTAN,CIRCIR MAH.,415,374,368,202,166
EYUPSULTAN,CIRCIR MAH.,415,360,355,188,167
EYUPSULTAN,CIRCIR MAH.,415,372,366,185,181
EYUPSULTAN,CIRCIR MAH.,414,368,363,195,168
EYUPSULTAN,CIRCIR MAH.,415,368,363,202,161
EYUPSULTAN,CIRCIR MAH.,395,320,309,175,134
EYUPSULTAN,CIRCIR MAH.,393,353,348,198,150
EYUPSULTAN,CIRCIR MAH.,392,352,347,173,174
EYUPSULTAN,CIRCIR MAH.,396,358,355,212,143
EYUPSULTAN,CIRCIR MAH.,393,352,346,185,161
EYUPSULTAN,CIRCIR MAH.,392,361,359,182,177
EYUPSULTAN,CIRCIR MAH.,392,356,350,182,168
EYUPSULTAN,CIRCIR MAH.,393,365,359,183,176
EYUPSULTAN,CIRCIR MAH.,392,358,351,183,168
EYUPSULTAN,CIRCIR MAH.,392,353,348,184,164
EYUPSULTAN,CIRCIR MAH.,393,362,358,186,172
EYUPSULTAN,CIRCIR MAH.,397,319,311,171,140
EYUPSULTAN,CIRCIR MAH.,396,370,365,214,151
EYUPSULTAN,CIRCIR MAH.,398,358,347,181,166
EYUPSULTAN,CIRCIR MAH.,397,364,358,203,155
EYUPSULTAN,CIRCIR MAH.,396,359,354,207,147
EYUPSULTAN,CIRCIR MAH.,397,366,360,201,159
EYUPSULTAN,CIRCIR MAH.,397,368,361,214,147
EYUPSULTAN,CIRCIR MAH.,397,357,351,204,147
EYUPSULTAN,CIRCIR MAH.,397,342,333,186,147
EYUPSULTAN,CIRCIR MAH.,397,366,365,222,143
EYUPSULTAN,CIRCIR MAH.,396,362,358,192,166
EYUPSULTAN,CIRCIR MAH.,396,336,332,197,135
EYUPSULTAN,CIRCIR MAH.,397,361,355,206,149
EYUPSULTAN,CIRCIR MAH.,397,372,365,211,154
EYUPSULTAN,CIRCIR MAH.,396,368,366,208,158
EYUPSULTAN,CIRCIR MAH.,415,367,354,163,191
EYUPSULTAN,CIRCIR MAH.,410,360,359,163,196
EYUPSULTAN,CIRCIR MAH.,409,365,358,143,215
EYUPSULTAN,CIRCIR MAH.,409,370,366,167,199
EYUPSULTAN,CIRCIR MAH.,409,362,356,163,193
EYUPSULTAN,CIRCIR MAH.,410,354,350,160,190
EYUPSULTAN,CIRCIR MAH.,409,374,368,184,184
EYUPSULTAN,CIRCIR MAH.,409,365,364,170,194
EYUPSULTAN,CIRCIR MAH.,409,362,357,153,204
EYUPSULTAN,CIRCIR MAH.,410,380,374,161,213
EYUPSULTAN,CIRCIR MAH.,409,369,363,174,189
EYUPSULTAN,CIRCIR MAH.,409,367,362,166,196
EYUPSULTAN,CIRCIR MAH.,409,367,361,169,192
EYUPSULTAN,CIRCIR MAH.,408,366,362,158,204
EYUPSULTAN,CIRCIR MAH.,409,367,364,155,209
EYUPSULTAN,CIRCIR MAH.,409,371,367,178,189
EYUPSULTAN,CIFTALAN MAH.,125,108,105,61,44
EYUPSULTAN,GOKTURK MERKEZ MAH.,396,339,332,148,184
EYUPSULTAN,GOKTURK MERKEZ MAH.,393,350,345,121,224
EYUPSULTAN,GOKTURK MERKEZ MAH.,393,358,352,147,205
EYUPSULTAN,GOKTURK MERKEZ MAH.,393,346,340,144,196
EYUPSULTAN,GOKTURK MERKEZ MAH.,394,356,355,142,213
EYUPSULTAN,GOKTURK MERKEZ MAH.,394,364,355,144,211
EYUPSULTAN,GOKTURK MERKEZ MAH.,393,366,357,158,199
EYUPSULTAN,GOKTURK MERKEZ MAH.,393,352,348,156,192
EYUPSULTAN,GOKTURK MERKEZ MAH.,393,342,336,141,195
EYUPSULTAN,GOKTURK MERKEZ MAH.,393,353,349,150,199
EYUPSULTAN,GOKTURK MERKEZ MAH.,393,366,357,144,213
EYUPSULTAN,GOKTURK MERKEZ MAH.,415,349,338,101,237
EYUPSULTAN,GOKTURK MERKEZ MAH.,411,383,379,104,275
EYUPSULTAN,GOKTURK MERKEZ MAH.,411,366,362,100,262
EYUPSULTAN,GOKTURK MERKEZ MAH.,411,371,357,82,275
EYUPSULTAN,GOKTURK MERKEZ MAH.,415,388,385,113,272
EYUPSULTAN,GOKTURK MERKEZ MAH.,412,373,373,90,283
EYUPSULTAN,GOKTURK MERKEZ MAH.,411,387,380,113,267
EYUPSULTAN,GOKTURK MERKEZ MAH.,412,385,383,121,262
EYUPSULTAN,GOKTURK MERKEZ MAH.,411,374,372,97,275
EYUPSULTAN,GOKTURK MERKEZ MAH.,410,385,380,102,278
EYUPSULTAN,GOKTURK MERKEZ MAH.,412,362,354,115,239
EYUPSULTAN,GOKTURK MERKEZ MAH.,411,367,362,98,264
EYUPSULTAN,GOKTURK MERKEZ MAH.,411,381,375,90,285
EYUPSULTAN,GOKTURK MERKEZ MAH.,411,363,357,101,256
EYUPSULTAN,GOKTURK MERKEZ MAH.,410,371,366,79,287
EYUPSULTAN,GOKTURK MERKEZ MAH.,410,373,372,92,280
EYUPSULTAN,GOKTURK MERKEZ MAH.,411,377,368,93,275
EYUPSULTAN,GOKTURK MERKEZ MAH.,400,343,338,97,241
EYUPSULTAN,GOKTURK MERKEZ MAH.,400,365,361,92,269
EYUPSULTAN,GOKTURK MERKEZ MAH.,400,357,352,94,258
EYUPSULTAN,GOKTURK MERKEZ MAH.,402,369,364,92,272
EYUPSULTAN,GOKTURK MERKEZ MAH.,400,369,366,87,279
EYUPSULTAN,GOKTURK MERKEZ MAH.,400,352,350,85,265
EYUPSULTAN,GOKTURK MERKEZ MAH.,400,361,358,76,282
EYUPSULTAN,GOKTURK MERKEZ MAH.,401,368,364,100,264
EYUPSULTAN,GOKTURK MERKEZ MAH.,401,366,363,100,263
EYUPSULTAN,GOKTURK MERKEZ MAH.,400,368,365,86,279
EYUPSULTAN,GOKTURK MERKEZ MAH.,400,354,351,99,252
EYUPSULTAN,GOKTURK MERKEZ MAH.,401,361,357,94,263
EYUPSULTAN,GOKTURK MERKEZ MAH.,400,360,359,98,261
EYUPSULTAN,GOKTURK MERKEZ MAH.,401,361,358,98,260
EYUPSULTAN,GOKTURK MERKEZ MAH.,400,377,375,108,267
EYUPSULTAN,GOKTURK MERKEZ MAH.,410,350,342,68,274
EYUPSULTAN,GOKTURK MERKEZ MAH.,410,381,377,81,296
EYUPSULTAN,GOKTURK MERKEZ MAH.,410,389,381,87,294
EYUPSULTAN,GOKTURK MERKEZ MAH.,410,368,366,90,276
EYUPSULTAN,GOKTURK MERKEZ MAH.,411,380,378,75,303
EYUPSULTAN,GOKTURK MERKEZ MAH.,410,376,374,88,286
EYUPSULTAN,GOKTURK MERKEZ MAH.,410,366,362,75,287
EYUPSULTAN,GOKTURK MERKEZ MAH.,410,381,377,62,315
EYUPSULTAN,GOKTURK MERKEZ MAH.,411,377,373,91,282
EYUPSULTAN,GOKTURK MERKEZ MAH.,411,382,377,98,279
EYUPSULTAN,GOKTURK MERKEZ MAH.,415,382,380,79,301
EYUPSULTAN,GOKTURK MERKEZ MAH.,411,378,376,92,284
EYUPSULTAN,GOKTURK MERKEZ MAH.,409,382,381,92,289
EYUPSULTAN,GOKTURK MERKEZ MAH.,409,379,376,79,297
EYUPSULTAN,GOKTURK MERKEZ MAH.,410,380,374,58,316
EYUPSULTAN,GOKTURK MERKEZ MAH.,410,362,360,66,294
EYUPSULTAN,GOKTURK MERKEZ MAH.,410,369,366,85,281
EYUPSULTAN,GOKTURK MERKEZ MAH.,410,377,373,73,300
EYUPSULTAN,ISIKLAR MAH.,214,198,190,128,62
EYUPSULTAN,ISIKLAR MAH.,214,196,192,116,76
EYUPSULTAN,IHSANIYE MAH.,127,116,112,65,47
EYUPSULTAN,KARADOLAP MAH.,388,299,297,152,145
EYUPSULTAN,KARADOLAP MAH.,390,345,340,203,137
EYUPSULTAN,KARADOLAP MAH.,388,351,346,214,132
EYUPSULTAN,KARADOLAP MAH.,388,348,346,200,146
EYUPSULTAN,KARADOLAP MAH.,389,351,345,181,164
EYUPSULTAN,KARADOLAP MAH.,388,357,355,204,151
EYUPSULTAN,KARADOLAP MAH.,388,336,333,207,126
EYUPSULTAN,KARADOLAP MAH.,388,361,357,188,169
EYUPSULTAN,KARADOLAP MAH.,388,346,340,166,174
EYUPSULTAN,KARADOLAP MAH.,389,344,337,195,142
EYUPSULTAN,KARADOLAP MAH.,396,358,354,69,285
EYUPSULTAN,KARADOLAP MAH.,397,363,360,98,262
EYUPSULTAN,KARADOLAP MAH.,394,359,355,71,284
EYUPSULTAN,KARADOLAP MAH.,395,372,366,80,286
EYUPSULTAN,KARADOLAP MAH.,395,369,366,85,281
EYUPSULTAN,KARADOLAP MAH.,394,355,348,86,262
EYUPSULTAN,KARADOLAP MAH.,395,376,372,93,279
EYUPSULTAN,KARADOLAP MAH.,395,362,356,93,263
EYUPSULTAN,KARADOLAP MAH.,394,370,368,110,258
EYUPSULTAN,KARADOLAP MAH.,395,358,357,101,256
EYUPSULTAN,KARADOLAP MAH.,393,339,336,116,220
EYUPSULTAN,KARADOLAP MAH.,393,358,353,124,229
EYUPSULTAN,KARADOLAP MAH.,393,362,357,107,250
EYUPSULTAN,KARADOLAP MAH.,393,363,356,134,222
EYUPSULTAN,KARADOLAP MAH.,394,362,361,109,252
EYUPSULTAN,KARADOLAP MAH.,392,352,351,142,209
EYUPSULTAN,KARADOLAP MAH.,393,362,358,134,224
EYUPSULTAN,KARADOLAP MAH.,392,358,354,107,247
EYUPSULTAN,KARADOLAP MAH.,393,348,342,108,234
EYUPSULTAN,KARADOLAP MAH.,392,365,359,120,239
EYUPSULTAN,KARADOLAP MAH.,393,366,365,127,238
EYUPSULTAN,KARADOLAP MAH.,392,359,355,152,203
EYUPSULTAN,KARADOLAP MAH.,393,367,362,129,233
EYUPSULTAN,KARADOLAP MAH.,401,351,347,97,250
EYUPSULTAN,KARADOLAP MAH.,402,355,351,93,258
EYUPSULTAN,KARADOLAP MAH.,404,346,344,115,229
EYUPSULTAN,KARADOLAP MAH.,405,369,365,108,257
EYUPSULTAN,KARADOLAP MAH.,404,370,367,136,231
EYUPSULTAN,KARADOLAP MAH.,401,359,357,124,233
EYUPSULTAN,KARADOLAP MAH.,402,369,362,120,242
EYUPSULTAN,KARADOLAP MAH.,401,354,353,109,244
EYUPSULTAN,KARADOLAP MAH.,402,359,353,134,219
EYUPSULTAN,KARADOLAP MAH.,402,363,360,135,225
EYUPSULTAN,KARADOLAP MAH.,402,356,352,104,248
EYUPSULTAN,KARADOLAP MAH.,402,370,369,118,251
EYUPSULTAN,KARADOLAP MAH.,401,366,364,121,243
EYUPSULTAN,KARADOLAP MAH.,401,365,361,129,232
EYUPSULTAN,KARADOLAP MAH.,403,363,361,115,246
EYUPSULTAN,KARADOLAP MAH.,401,352,348,114,234
EYUPSULTAN,MIMAR SINAN MAH.,377,314,306,123,183
EYUPSULTAN,MIMAR SINAN MAH.,377,358,357,147,210
EYUPSULTAN,MIMAR SINAN MAH.,375,346,338,137,201
EYUPSULTAN,MIMAR SINAN MAH.,375,346,343,148,195
EYUPSULTAN,MIMAR SINAN MAH.,377,341,333,126,207
EYUPSULTAN,MIMAR SINAN MAH.,376,340,336,125,211
EYUPSULTAN,MIMAR SINAN MAH.,376,335,332,116,216
EYUPSULTAN,MIMAR SINAN MAH.,375,331,322,137,185
EYUPSULTAN,MITHATPASA MAH.,390,318,311,106,205
EYUPSULTAN,MITHATPASA MAH.,389,334,327,115,212
EYUPSULTAN,MITHATPASA MAH.,390,348,347,127,220
EYUPSULTAN,MITHATPASA MAH.,392,351,345,168,177
EYUPSULTAN,MITHATPASA MAH.,390,338,333,141,192
EYUPSULTAN,MITHATPASA MAH.,390,353,347,125,222
EYUPSULTAN,MITHATPASA MAH.,389,340,331,132,199
EYUPSULTAN,MITHATPASA MAH.,391,360,355,134,221
EYUPSULTAN,MITHATPASA MAH.,389,352,344,113,231
EYUPSULTAN,MITHATPASA MAH.,389,360,358,130,228
EYUPSULTAN,ODAYERI MAH.,172,167,162,76,86
EYUPSULTAN,PIRINCCI MAH.,415,366,358,293,65
EYUPSULTAN,PIRINCCI MAH.,411,383,376,327,49
EYUPSULTAN,PIRINCCI MAH.,415,381,375,305,70
EYUPSULTAN,PIRINCCI MAH.,412,382,375,332,43
EYUPSULTAN,PIRINCCI MAH.,412,377,363,312,51
EYUPSULTAN,PIRINCCI MAH.,419,362,359,249,110
EYUPSULTAN,YESILPINAR MAH.,415,363,354,251,103
EYUPSULTAN,YESILPINAR MAH.,415,360,355,223,132
EYUPSULTAN,YESILPINAR MAH.,412,380,371,244,127
EYUPSULTAN,YESILPINAR MAH.,412,368,360,230,130
EYUPSULTAN,YESILPINAR MAH.,415,385,379,269,110
EYUPSULTAN,YESILPINAR MAH.,415,389,384,269,115
EYUPSULTAN,YESILPINAR MAH.,412,370,363,230,133
EYUPSULTAN,YESILPINAR MAH.,412,372,371,237,134
EYUPSULTAN,YESILPINAR MAH.,415,370,367,226,141
EYUPSULTAN,YESILPINAR MAH.,413,357,354,250,104
EYUPSULTAN,YESILPINAR MAH.,412,376,372,254,118
EYUPSULTAN,YESILPINAR MAH.,412,366,359,227,132
EYUPSULTAN,YESILPINAR MAH.,413,372,369,226,143
EYUPSULTAN,YESILPINAR MAH.,413,376,368,262,106
EYUPSULTAN,YESILPINAR MAH.,415,374,367,244,123
EYUPSULTAN,YESILPINAR MAH.,391,331,324,172,152
EYUPSULTAN,YESILPINAR MAH.,391,349,347,197,150
EYUPSULTAN,YESILPINAR MAH.,391,363,355,210,145
EYUPSULTAN,YESILPINAR MAH.,390,349,345,209,136
EYUPSULTAN,YESILPINAR MAH.,391,360,357,187,170
EYUPSULTAN,YESILPINAR MAH.,394,367,364,204,160
EYUPSULTAN,YESILPINAR MAH.,390,351,346,218,128
EYUPSULTAN,YESILPINAR MAH.,390,347,343,192,151
EYUPSULTAN,YESILPINAR MAH.,391,355,348,204,144
EYUPSULTAN,YESILPINAR MAH.,391,350,343,177,166
EYUPSULTAN,YESILPINAR MAH.,390,357,350,192,158
EYUPSULTAN,YESILPINAR MAH.,390,354,348,181,167
EYUPSULTAN,YESILPINAR MAH.,391,366,365,208,157
EYUPSULTAN,YESILPINAR MAH.,390,367,361,184,177
EYUPSULTAN,YESILPINAR MAH.,392,363,360,182,178
EYUPSULTAN,YESILPINAR MAH.,401,332,326,202,124
EYUPSULTAN,YESILPINAR MAH.,406,372,364,240,124
EYUPSULTAN,YESILPINAR MAH.,402,376,372,255,117
EYUPSULTAN,YESILPINAR MAH.,401,360,354,234,120
EYUPSULTAN,YESILPINAR MAH.,400,357,355,216,139
EYUPSULTAN,YESILPINAR MAH.,400,366,359,240,119
EYUPSULTAN,YESILPINAR MAH.,400,356,356,236,120
EYUPSULTAN,YESILPINAR MAH.,400,356,349,233,116
EYUPSULTAN,YESILPINAR MAH.,400,373,366,258,108
EYUPSULTAN,YESILPINAR MAH.,401,374,372,247,125
EYUPSULTAN,YESILPINAR MAH.,400,369,362,222,140
EYUPSULTAN,YESILPINAR MAH.,400,356,352,218,134
EYUPSULTAN,YESILPINAR MAH.,401,368,360,224,136
EYUPSULTAN,YESILPINAR MAH.,401,356,352,195,157
EYUPSULTAN,YESILPINAR MAH.,401,366,363,221,142
EYUPSULTAN,YESILPINAR MAH.,399,357,351,211,140
EYUPSULTAN,YESILPINAR MAH.,401,362,355,224,131
EYUPSULTAN,YESILPINAR MAH.,401,367,362,235,127
EYUPSULTAN,YESILPINAR MAH.,402,348,343,238,105
EYUPSULTAN,YESILPINAR MAH.,399,360,349,234,115
EYUPSULTAN,YESILPINAR MAH.,401,352,349,244,105
EYUPSULTAN,YESILPINAR MAH.,400,358,352,260,92
EYUPSULTAN,YESILPINAR MAH.,399,364,359,236,123
EYUPSULTAN,YESILPINAR MAH.,399,347,340,245,95
EYUPSULTAN,YESILPINAR MAH.,398,350,346,257,89
EYUPSULTAN,YESILPINAR MAH.,400,374,369,251,118
EYUPSULTAN,YESILPINAR MAH.,400,359,355,248,107
EYUPSULTAN,YESILPINAR MAH.,400,353,347,236,111
EYUPSULTAN,YESILPINAR MAH.,401,361,354,272,82
EYUPSULTAN,YESILPINAR MAH.,398,348,345,250,95
EYUPSULTAN,YESILPINAR MAH.,398,347,344,247,97
EYUPSULTAN,YESILPINAR MAH.,399,357,352,230,122
EYUPSULTAN,YESILPINAR MAH.,399,373,368,268,100
EYUPSULTAN,YESILPINAR MAH.,400,350,346,227,119
EYUPSULTAN,YESILPINAR MAH.,400,357,354,261,93
EYUPSULTAN,YESILPINAR MAH.,399,359,356,230,126